id,word,total_count,total_frequency,trump_count,trump_frequency,obama_count,obama_frequency
26,the,25805,0.047389665912496694,21404,0.04876037388116994,4401,0.04168995405674229
12,to,14843,0.027258469720565334,11239,0.025603524670644223,3604,0.034140103253919384
87,and,12534,0.023018100079334764,11043,0.025157017789654252,1491,0.014123999431629801
23,of,10311,0.018935665383598272,8576,0.019536954139642747,1735,0.01643537157201724
38,a,9680,0.01777686363235683,7659,0.017447939803582533,2021,0.019144602851323828
5,http://...,9501,0.017448138571386596,6683,0.015224517783959012,2818,0.026694453654146733
6,in,8180,0.015022184350483355,6550,0.014921530971858676,1630,0.015440723724719368
121,is,7460,0.013699938295184086,6357,0.014481858379863452,1103,0.010448538814948137
4,for,6586,0.012094878500279141,5031,0.011461102644186412,1555,0.014730260976649458
139,on,4856,0.008917815061851733,3742,0.008524636472777888,1114,0.010552740017998389
61,that,4414,0.008106102900126347,3654,0.008324163995598717,760,0.0071993558471084166
194,i,4367,0.00801978961596098,3756,0.008556529821420028,611,0.00578790318760953
312,our,4256,0.007815943349102341,3519,0.008016620990835218,737,0.0069814806043669774
131,will,4243,0.007792069461992772,3838,0.00874333372060971,405,0.0038364988395775115
210,we,4161,0.007641480327917022,3107,0.00707804530222365,1054,0.009984369819542462
15,you,4140,0.007602914817970793,2931,0.0066771003478653095,1209,0.011452659498886941
187,are,4081,0.007494564099550436,3572,0.008137360096409037,509,0.0048216738502344526
53,be,3855,0.007079525754414832,3402,0.007750083720040186,453,0.004291194998342253
9,president,3592,0.0065965386536596836,1325,0.0030184776393454575,2267,0.02147492066499313
36,with,3590,0.006592865747950518,3136,0.007144110095839513,454,0.004300667834983186
208,it,3577,0.006568991860840949,3036,0.006916300462681365,541,0.005124804622744281
105,great,3556,0.00653042635089472,3494,0.007959668582545681,62,0.0005873158717377919
11,this,3277,0.006018056004466254,2355,0.005364916860874379,922,0.008733955382939421
220,have,3169,0.0058197190961713635,2651,0.006039233375022496,518,0.004906929380002842
62,they,3044,0.005590162489348573,2827,0.006440178329380836,217,0.0020556055510822717
3272,&,2824,0.005186142861340464,2719,0.0061941439255700365,105,0.0009946478472978733
86,obama,2460,0.0045176740222725,317,0.0007221565371113283,2143,0.02030028892151755
81,was,2331,0.004280771604031381,2175,0.004954859521189713,156,0.0014777625159854118
378,at,2303,0.004229350924103077,1892,0.004310158259352155,411,0.0038933358594231042
106,has,2254,0.004139364734228543,1997,0.00454935837416821,257,0.0024345190167195567
343,not,2238,0.004109981488555226,1878,0.004278264910710014,360,0.003410221190735566
94,all,2183,0.004008976581553198,1895,0.0043169925483468995,288,0.0027281769525884527
425,he,2166,0.0039777568830252985,2037,0.004640482227431469,129,0.0012219959266802445
166,by,2064,0.0037904386918579027,1754,0.003995780965593911,310,0.0029365793586889595
58,people,2060,0.0037830928804395733,1767,0.00402539621790447,293,0.002775541135793113
389,as,1725,0.0031678811741544972,1349,0.003073151951303413,376,0.0035617865769904796
1281,very,1692,0.0031072782299532806,1670,0.003804420873741067,22,0.0002084024061005068
737,my,1677,0.003079731437134546,1532,0.003490043579982823,145,0.0013735613129351584
68,more,1645,0.0030209649457879116,1165,0.002653982226292421,480,0.004546961587647421
22,no,1632,0.0029970910586783416,1449,0.0033009615844615606,183,0.0017335291052905794
63,who,1626,0.0029860723415508477,1287,0.002931909978745361,339,0.003211291621275991
202,now,1625,0.0029842358886962655,1354,0.00308454243296132,271,0.0025671387296926063
216,just,1595,0.002929142303058796,1359,0.0030959329146192276,236,0.002235589447259982
299,so,1594,0.0029273058502042137,1468,0.0033442454147616088,126,0.001193577416757448
112,your,1578,0.0028979226045308965,927,0.0021117952993760293,651,0.006166816653246815
326,from,1576,0.002894249698821732,1200,0.002733715597897773,376,0.0035617865769904796
176,us,1516,0.0027840625275467926,1223,0.002786111813524147,293,0.002775541135793113
78,do,1504,0.002762025093291805,1232,0.00280661468050838,272,0.0025766115663335386
239,if,1496,0.0027473334704551464,873,0.0019887780974706297,623,0.0059015772273007154
376,thank,1464,0.0026885669791085125,1406,0.003203003442203557,58,0.0005494245251740634
77,but,1372,0.002519613316486939,1214,0.0027656089465399134,158,0.0014967081892672761
254,their,1367,0.0025104310522140274,1115,0.002540077409713347,252,0.002387154833514896
1034,news,1353,0.002484720712249875,1295,0.002950134749398013,58,0.0005494245251740634
180,country,1347,0.0024737019951223812,1162,0.0026471479372976764,185,0.0017524747785724435
24,out,1310,0.0024057532395028356,1053,0.0023988354371552957,257,0.0024345190167195567
51,up,1303,0.0023928980695207594,978,0.0022279782122866846,325,0.0030786719083029414
47,big,1280,0.002350659653865366,1208,0.0027519403685504246,72,0.0006820442381471132
111,get,1273,0.00233780448388329,979,0.0022302563086182663,294,0.0027850139724340454
223,than,1265,0.002323112861046631,959,0.002184694381986637,306,0.002898688012125231
730,his,1247,0.0022900567096641494,1025,0.002335048739871014,222,0.002102969734286932
90,or,1210,0.002222107954044604,1010,0.002300877294897292,200,0.0018945673281864255
904,what,1174,0.0021559956512796404,879,0.0020024466754601186,295,0.0027944868090749777
7902,fake,1172,0.0021523227455704755,1172,0.002669928900613491,0,0
539,democrats,1167,0.0021431404812975643,1151,0.0026220888776502804,16,0.00015156538625491403
242,about,1148,0.0021082478770605,831,0.0018930980515442077,317,0.003002889215175484
5135,-,1133,0.0020807010842417654,1128,0.0025696926620239063,5,4.736418320466063e-05
567,new,1127,0.0020696823671142715,934,0.0021277419736970998,193,0.0018282574716999005
264,would,1122,0.00206050010284136,957,0.002180138189323474,165,0.001563018045753801
133,an,1095,0.0020109158757676375,853,0.001943216170839,242,0.002292426467105575
104,been,1086,0.0019943878000763964,987,0.002248481079270918,99,0.0009378108274522806
225,time,1065,0.0019558222901301676,729,0.001660732225722897,336,0.0031828731113531946
629,should,1050,0.001928275497311433,802,0.0018270332579283447,248,0.0023492634869511676
453,today,1049,0.0019264390444568508,704,0.00160377981743336,345,0.0032681286411215837
205,america,1046,0.0019209296858931039,760,0.0017313532120019227,286,0.002709231279306588
296,many,1037,0.0019044016102018628,991,0.002257593464597244,46,0.00043575048548287785
7928,trump,1025,0.001882364175946875,1025,0.002335048739871014,0,0
142,its,982,0.0018033967031998355,538,0.0012256158263908347,444,0.004205939468573864
548,there,982,0.0018033967031998355,898,0.0020457305057601668,84,0.0007957182778382986
67,make,977,0.0017942144389269238,637,0.001451147363217401,340,0.0032207644579169232
426,never,975,0.0017905415332177593,915,0.0020844581433970516,60,0.0005683701984559276
391,me,968,0.001777686363235683,877,0.0019978904827969556,91,0.0008620281343248235
757,vote,964,0.0017703405518173538,768,0.0017495779826545745,196,0.0018566759816226969
69,one,936,0.0017189198718890488,670,0.0015263245421595897,266,0.002519774546487946
14,want,907,0.0016656627391061617,738,0.0016812350927071303,169,0.0016009093923175296
186,years,891,0.0016362794934328445,717,0.0016333950697439191,174,0.00164827357552219
140,american,889,0.00163260658772368,662,0.001508099771506938,227,0.002150333917491593
17,can,882,0.0016197514177416037,516,0.0011754977070960423,366,0.0034670582105811587
1182,were,879,0.0016142420591778567,696,0.0015855550467807082,183,0.0017335291052905794
2,dont,841,0.0015444568507037286,613,0.0013964730512594455,228,0.002159806754132525
59,states,838,0.0015389474921399817,729,0.001660732225722897,109,0.0010325391938616018
304,back,837,0.0015371110392853994,652,0.0014853188081911232,185,0.0017524747785724435
211,when,834,0.0015316016807216525,645,0.0014693721338700529,189,0.001790366125136172
4399,election,830,0.0015242558693033233,719,0.001637951262407082,111,0.001051484867143466
101,them,818,0.0015022184350483355,674,0.0015354369274859156,144,0.0013640884762942263
794,good,816,0.0014985455293391708,715,0.0016288388770807562,101,0.0009567565007341448
508,much,806,0.0014801810007933477,760,0.0017313532120019227,46,0.00043575048548287785
418,even,796,0.0014618164722475244,748,0.001704016056022945,48,0.0004546961587647421
463,jobs,793,0.0014563071136837775,511,0.001164107225438135,282,0.00267133993274286
43,going,786,0.0014434519437017013,653,0.0014875969045227047,133,0.001259887273243973
231,like,777,0.0014269238680104605,655,0.0014921530971858676,122,0.0011556860701937195
474,job,758,0.0013920312637733963,637,0.001451147363217401,121,0.0011462132335527874
0,,745,0.0013681573766638263,388,0.0008839013766536132,357,0.0033818026808127696
1684,done,743,0.0013644844709546616,662,0.001508099771506938,81,0.0007672997679155023
1220,which,721,0.0013240825081538507,695,0.0015832769504491267,26,0.0002462937526642353
8397,border,716,0.001314900243880939,716,0.0016311169734123377,0,0
238,congress,702,0.0012891899039167867,349,0.0007950556197219356,353,0.003343911334249041
1344,doing,699,0.0012836805453530398,650,0.0014807626155279602,49,0.0004641689954056742
72,state,696,0.0012781711867892928,625,0.0014238102072384232,71,0.000672571401506181
523,house,684,0.001256133752534305,567,0.0012916806200066976,117,0.0011083218869890588
8011,media,684,0.001256133752534305,684,0.0015582178908017305,0,0
25,over,677,0.0012432785825522287,553,0.001259787271364557,124,0.0011746317434755838
420,other,675,0.001239605676843064,631,0.001437478785227912,44,0.0004168048122010136
209,only,671,0.0012322598654247348,589,0.0013417987393014902,82,0.0007767726045564344
497,united,671,0.0012322598654247348,609,0.0013873606659331197,62,0.0005873158717377919
1712,must,661,0.0012138953368789117,625,0.0014238102072384232,36,0.0003410221190735566
54,because,655,0.0012028766197514178,529,0.0012051129594066014,126,0.001193577416757448
1452,china,653,0.001199203714042253,639,0.001455703555880564,14,0.0001326197129730498
375,day,649,0.001191857902623924,425,0.0009681909409221278,224,0.0021219154075687967
154,win,643,0.00118083918549643,574,0.001307627294327768,69,0.0006536257282243168
969,being,635,0.0011661475626597714,600,0.0013668577989488864,35,0.0003315492824326244
708,nothing,634,0.0011643111098051892,597,0.001360023509954142,37,0.0003504949557144887
256,way,624,0.0011459465812593658,550,0.0012529529823698126,74,0.0007009899114289774
1966,had,617,0.0011330914112772897,574,0.001307627294327768,43,0.0004073319755600815
888,again,612,0.001123909147004378,569,0.0012962368126698605,43,0.0004073319755600815
431,first,608,0.0011165633355860489,457,0.0010410900235327352,151,0.0014303983327807511
284,how,596,0.001094525901331061,428,0.0009750252299168722,168,0.0015914365556765973
82,work,592,0.0010871800899127319,373,0.000849729931679891,219,0.0020745512243641358
954,see,588,0.0010798342784944025,496,0.0011299357804644128,92,0.0008715009709657557
1152,am,584,0.0010724884670760733,544,0.0012392844043803237,40,0.00037891346563728506
65,go,579,0.0010633062028031616,425,0.0009681909409221278,154,0.0014588168427035475
406,know,571,0.001048614579966503,392,0.0008930137619799391,179,0.0016956377587268507
3727,military,560,0.0010284135985660977,548,0.0012483967897066496,12,0.00011367403969118553
2939,republican,558,0.001024740692856933,503,0.0011458824547854831,55,0.000521006015251267
417,economy,557,0.0010229042400023507,344,0.0007836651380640282,213,0.002017714204518543
1348,biden,555,0.001019231334293186,519,0.0011823319960907867,36,0.0003410221190735566
19,help,553,0.0010155584285840213,335,0.0007631622710797949,218,0.0020650783877232035
992,him,552,0.001013721975729439,504,0.0011481605511170646,48,0.0004546961587647421
66,last,551,0.0010118855228748568,387,0.0008816232803220316,164,0.0015535452091128689
429,americans,551,0.0010118855228748568,203,0.00046245355531103987,348,0.00329654715104438
405,got,549,0.0010082126171656921,403,0.0009180728216273353,146,0.0013830341495760907
120,into,546,0.0010027032586019452,467,0.0010638709868485499,79,0.0007483540946336381
574,why,546,0.0010027032586019452,428,0.0009750252299168722,118,0.001117794723629991
984,made,545,0.001000866805747363,469,0.0010684271795117128,76,0.0007199355847108417
127,ever,543,0.0009971939000381982,493,0.0011231014914696682,50,0.0004736418320466064
4471,total,543,0.0009971939000381982,538,0.0012256158263908347,5,4.736418320466063e-05
601,bad,541,0.0009935209943290335,530,0.0012073910557381829,11,0.0001042012030502534
2435,tax,534,0.0009806658243469574,313,0.0007130441517850023,221,0.0020934968976460003
29,year,532,0.0009769929186377927,343,0.0007813870417324467,189,0.001790366125136172
30,before,528,0.0009696471072194635,433,0.0009864157115747796,95,0.0008999194808885521
64,down,527,0.0009678106543648811,436,0.000993250000569524,91,0.0008620281343248235
3031,said,526,0.0009659742015102989,447,0.0010183090602169204,79,0.0007483540946336381
395,need,525,0.0009641377486557165,322,0.0007335470187692357,203,0.0019229858381092219
178,after,523,0.0009604648429465519,475,0.0010820957575012017,48,0.0004546961587647421
185,world,516,0.0009476096729644757,433,0.0009864157115747796,83,0.0007862454411973666
1675,did,510,0.0009365909558369818,474,0.0010798176611696202,36,0.0003410221190735566
1149,history,509,0.0009347545029823994,476,0.0010843738538327831,33,0.0003126036091507602
321,strong,506,0.0009292451444186525,462,0.0010524805051906425,44,0.0004168048122010136
490,working,492,0.0009035348044545001,406,0.0009249071106220797,86,0.000814663951120163
1575,joe,489,0.0008980254458907531,477,0.0010866519501643646,12,0.00011367403969118553
483,hard,487,0.0008943525401815884,402,0.0009157947252957538,85,0.0008051911144792308
1619,also,482,0.0008851702759086769,469,0.0010684271795117128,13,0.00012314687633211766
918,most,473,0.000868642200217436,404,0.0009203509179589168,69,0.0006536257282243168
8028,dems,473,0.000868642200217436,473,0.0010775395648380387,0,0
1097,crime,472,0.0008668057473628537,468,0.0010661490831801314,4,3.789134656372851e-05
454,fact,471,0.0008649692945082713,248,0.0005649678902322064,223,0.0021124425709278644
1314,well,467,0.0008576234830899421,404,0.0009203509179589168,63,0.000596788708378724
158,support,466,0.0008557870302353598,271,0.0006173641058585804,195,0.0018472031449817648
542,republicans,462,0.0008484412188170305,402,0.0009157947252957538,60,0.0005683701984559276
1604,she,462,0.0008484412188170305,430,0.0009795814225800352,32,0.00030313077250982806
1139,far,449,0.0008245673317074604,419,0.000954522362932639,30,0.0002841850992279638
893,these,447,0.0008208944259982957,366,0.0008337832573588207,81,0.0007672997679155023
361,health,446,0.0008190579731437135,46,0.00010479243125274796,400,0.003789134656372851
919,right,446,0.0008190579731437135,303,0.0006902631884691876,143,0.001354615639653294
809,against,445,0.0008172215202891311,406,0.0009249071106220797,39,0.00036944062899635295
20,look,437,0.0008025298974524726,361,0.0008223927757009132,76,0.0007199355847108417
286,watch,437,0.0008025298974524726,211,0.0004806783259636917,226,0.0021408610808506608
7940,@foxnews,436,0.0008006934445978903,436,0.000993250000569524,0,0
678,left,435,0.0007988569917433079,381,0.0008679547023325428,54,0.0005115331786103349
348,deal,432,0.000793347633179561,412,0.0009385756886115687,20,0.00018945673281864253
3239,wall,432,0.000793347633179561,406,0.0009249071106220797,26,0.0002462937526642353
403,better,431,0.0007915111803249787,348,0.0007927775233903541,83,0.0007862454411973666
369,security,426,0.0007823289160520671,383,0.0008725108949957058,43,0.0004073319755600815
351,two,424,0.0007786560103429025,358,0.0008155584867061688,66,0.0006252072183015204
115,take,423,0.0007768195574883201,284,0.0006469793581691395,139,0.0013167242930895657
366,care,421,0.0007731466517791555,130,0.00029615252310559204,291,0.002756595462511249
1248,law,419,0.0007694737460699908,340,0.0007745527527377022,79,0.0007483540946336381
413,any,413,0.000758455028942497,368,0.0008383394500219837,45,0.00042627764884194575
2074,her,413,0.000758455028942497,360,0.0008201146793693318,53,0.0005020603419694027
3583,really,413,0.000758455028942497,397,0.0009044042436378465,16,0.00015156538625491403
390,long,412,0.0007566185760879147,350,0.000797333716053517,62,0.0005873158717377919
2938,democrat,410,0.00075294567037875,405,0.0009226290142904983,5,4.736418320466063e-05
122,keep,400,0.0007345811418329269,255,0.0005809145645532767,145,0.0013735613129351584
3421,campaign,397,0.00072907178326918,316,0.0007198784407797468,81,0.0007672997679155023
1453,trade,396,0.0007272353304145976,392,0.0008930137619799391,4,3.789134656372851e-05
1164,where,395,0.0007253988775600153,298,0.0006788727068112803,97,0.0009188651541704163
182,every,389,0.0007143801604325214,201,0.0004578973626478769,188,0.0017808932884952398
4796,endorsement,389,0.0007143801604325214,388,0.0008839013766536132,1,9.472836640932127e-06
3241,party,388,0.0007125437075779391,360,0.0008201146793693318,28,0.0002652394259460996
381,national,385,0.0007070343490141922,347,0.0007904994270587726,38,0.00035996779235542085
4931,russia,384,0.0007051978961596098,382,0.0008702327986641243,2,1.8945673281864254e-05
655,best,383,0.0007033614433050275,311,0.0007084879591218394,72,0.0006820442381471132
184,together,381,0.0006996885375958629,283,0.0006447012618375581,98,0.0009283379908113484
224,act,381,0.0006996885375958629,165,0.00037588589471094374,216,0.0020461327144413394
318,let,380,0.0006978520847412805,276,0.0006287545875164877,104,0.0009851750106569413
32,come,376,0.0006905062733229512,287,0.000653813647163884,89,0.0008430824610429593
1654,senate,374,0.0006868333676137866,295,0.0006720384178165358,79,0.0007483540946336381
808,some,372,0.000683160461904622,297,0.0006765946104796988,75,0.0007104627480699095
714,women,368,0.0006758146504862927,154,0.0003508268350635475,214,0.0020271870411594753
2508,usa,367,0.0006739781976317104,349,0.0007950556197219356,18,0.0001705110595367783
4348,complete,363,0.0006666323862133812,354,0.0008064461013798429,9,8.525552976838915e-05
525,white,362,0.0006647959333587988,317,0.0007221565371113283,45,0.00042627764884194575
8449,witch,360,0.0006611230276496342,360,0.0008201146793693318,0,0
1967,always,359,0.0006592865747950519,324,0.0007381032114323987,35,0.0003315492824326244
55,change,354,0.0006501043105221403,115,0.0002619810781318699,239,0.0022640079571827785
269,forward,353,0.000648267857667558,235,0.0005353526379216472,118,0.001117794723629991
2355,rt,353,0.000648267857667558,133,0.00030298681210033646,220,0.002084024061005068
8445,hunt,353,0.000648267857667558,353,0.0008041680050482615,0,0
4000,north,348,0.0006390855933946464,340,0.0007745527527377022,8,7.578269312745701e-05
10,say,347,0.0006372491405400641,247,0.0005626897939006249,100,0.0009472836640932128
344,cant,347,0.0006372491405400641,207,0.0004715659406373658,140,0.0013261971297304977
1157,congratulations,347,0.0006372491405400641,330,0.0007517717894218875,17,0.00016103822289584616
606,getting,346,0.0006354126876854817,301,0.0006857069958060247,45,0.00042627764884194575
2438,governor,341,0.0006262304234125702,318,0.0007244346334429098,23,0.00021787524274143893
1711,honor,340,0.0006243939705579878,306,0.000697097477463932,34,0.0003220764457916923
697,those,339,0.0006225575177034056,260,0.0005923050462111841,79,0.0007483540946336381
1440,night,338,0.0006207210648488232,286,0.0006515355508323025,52,0.0004925875053284706
198,could,337,0.0006188846119942409,245,0.0005581336012374619,92,0.0008715009709657557
546,million,329,0.0006041929891575824,131,0.0002984306194371735,198,0.0018756216549045612
7898,#maga,329,0.0006041929891575824,329,0.000749493693090306,0,0
2219,money,328,0.000602356536303,296,0.0006743165141481173,32,0.00030313077250982806
88,happy,326,0.0005986836305938354,227,0.0005171278672689954,99,0.0009378108274522806
1266,bill,324,0.0005950107248846707,241,0.000549021215911136,83,0.0007862454411973666
2450,taxes,321,0.0005895013663209238,216,0.0004920688076215991,105,0.0009946478472978733
2670,others,321,0.0005895013663209238,313,0.0007130441517850023,8,7.578269312745701e-05
713,things,320,0.0005876649134663415,293,0.0006674822251533728,27,0.0002557665893051674
830,pay,320,0.0005876649134663415,155,0.00035310493139512896,165,0.001563018045753801
564,federal,318,0.0005839920077571768,269,0.0006128079131954173,49,0.0004641689954056742
874,end,318,0.0005839920077571768,245,0.0005581336012374619,73,0.0006915170747880453
1001,coming,317,0.0005821555549025946,295,0.0006720384178165358,22,0.0002084024061005068
1797,call,313,0.0005748097434842653,251,0.0005718021792269508,62,0.0005873158717377919
57,love,307,0.0005637910263567714,252,0.0005740802755585323,55,0.000521006015251267
579,important,307,0.0005637910263567714,245,0.0005581336012374619,62,0.0005873158717377919
1465,didnt,307,0.0005637910263567714,286,0.0006515355508323025,21,0.00019892956945957466
255,too,305,0.0005601181206476068,226,0.0005148497709374139,79,0.0007483540946336381
592,administration,303,0.0005564452149384421,288,0.0006560917434954654,15,0.0001420925496139819
253,here,302,0.0005546087620838598,153,0.000348548738731966,149,0.001411452659498887
467,another,300,0.0005509358563746951,257,0.0005854707572164397,43,0.0004073319755600815
630,stop,300,0.0005509358563746951,237,0.0005399088305848101,63,0.000596788708378724
306,give,298,0.0005472629506655305,204,0.00046473165164262134,94,0.0008904466442476199
5300,totally,298,0.0005472629506655305,297,0.0006765946104796988,1,9.472836640932127e-06
199,fight,297,0.0005454264978109482,192,0.0004373944956636436,105,0.0009946478472978733
512,dollars,297,0.0005454264978109482,283,0.0006447012618375581,14,0.0001326197129730498
9560,collusion,296,0.0005435900449563659,296,0.0006743165141481173,0,0
193,believe,295,0.0005417535921017836,184,0.00041916972501099183,111,0.001051484867143466
259,families,295,0.0005417535921017836,135,0.00030754300476349946,160,0.0015156538625491402
494,record,295,0.0005417535921017836,262,0.000596861238874347,33,0.0003126036091507602
35,tonight,293,0.0005380806863926189,223,0.0005080154819426694,70,0.0006630985648652489
2330,washington,292,0.0005362442335380366,248,0.0005649678902322064,44,0.0004168048122010136
8085,corrupt,292,0.0005362442335380366,292,0.0006652041288217913,0,0
611,put,290,0.0005325713278288719,220,0.000501181192947925,70,0.0006630985648652489
691,everyone,290,0.0005325713278288719,225,0.0005125716746058324,65,0.0006157343816605883
859,making,289,0.0005307348749742897,211,0.0004806783259636917,78,0.0007388812579927059
8108,fbi,289,0.0005307348749742897,289,0.0006583698398270469,0,0
700,doesnt,288,0.0005288984221197073,233,0.0005307964452584842,55,0.000521006015251267
7992,radical,288,0.0005288984221197073,288,0.0006560917434954654,0,0
189,countries,287,0.000527061969265125,278,0.0006333107801796507,9,8.525552976838915e-05
3441,looking,287,0.000527061969265125,274,0.0006241983948533248,13,0.00012314687633211766
153,stand,286,0.0005252255164105427,155,0.00035310493139512896,131,0.0012409415999621086
357,since,285,0.0005233890635559604,202,0.0004601754589794584,83,0.0007862454411973666
623,thats,285,0.0005233890635559604,170,0.0003872763763688511,115,0.0010893762137071947
1298,court,284,0.000521552610701378,267,0.0006082517205322544,17,0.00016103822289584616
1362,think,284,0.000521552610701378,223,0.0005080154819426694,61,0.0005778430350968597
3116,soon,284,0.000521552610701378,279,0.0006355888765112322,5,4.736418320466063e-05
236,agree,283,0.0005197161578467958,92,0.00020958486250549592,191,0.0018093117984180362
1225,thing,282,0.0005178797049922134,202,0.0004601754589794584,80,0.0007578269312745701
8366,@foxandfriends,282,0.0005178797049922134,282,0.0006424231655059766,0,0
4847,numbers,280,0.0005142067992830488,275,0.0006264764911849063,5,4.736418320466063e-05
908,report,279,0.0005123703464284665,267,0.0006082517205322544,12,0.00011367403969118553
4552,romney,279,0.0005123703464284665,14,3.1893348642140685e-05,265,0.0025103017098470136
519,reform,278,0.0005105338935738841,74,0.00016857912853702933,204,0.001932458674750154
707,government,278,0.0005105338935738841,216,0.0004920688076215991,62,0.0005873158717377919
2247,second,277,0.0005086974407193019,254,0.0005786364682216952,23,0.00021787524274143893
1346,immigration,276,0.0005068609878647195,199,0.000453341169984714,77,0.0007294084213517738
4124,amendment,276,0.0005068609878647195,270,0.0006150860095269989,6,5.6837019845592764e-05
246,nation,275,0.0005050245350101372,172,0.0003918325690320141,103,0.0009757021740160091
1382,story,275,0.0005050245350101372,240,0.0005467431195795545,35,0.0003315492824326244
495,under,274,0.0005031880821555549,231,0.0005262402525953213,43,0.0004073319755600815
1606,then,274,0.0005031880821555549,235,0.0005353526379216472,39,0.00036944062899635295
9294,impeachment,274,0.0005031880821555549,274,0.0006241983948533248,0,0
167,high,272,0.0004995151764463902,242,0.0005512993122427175,30,0.0002841850992279638
736,family,271,0.000497678723591808,170,0.0003872763763688511,101,0.0009567565007341448
141,im,268,0.000492169365028061,130,0.00029615252310559204,138,0.0013072514564486336
1039,order,266,0.0004884964593188963,262,0.000596861238874347,4,3.789134656372851e-05
1247,including,264,0.00048482355360973174,252,0.0005740802755585323,12,0.00011367403969118553
411,wrong,263,0.00048298710075514944,243,0.0005535774085742989,20,0.00018945673281864253
3862,york,260,0.0004774777421914025,249,0.0005672459865637879,11,0.0001042012030502534
6866,vets,260,0.0004774777421914025,258,0.0005877488535480211,2,1.8945673281864254e-05
654,real,259,0.00047564128933682014,198,0.0004510630736531325,61,0.0005778430350968597
9044,hillary,259,0.00047564128933682014,259,0.0005900269498796026,0,0
1289,place,257,0.0004719683836276555,214,0.0004875126149584361,43,0.0004073319755600815
877,illegal,256,0.0004701319307730732,251,0.0005718021792269508,5,4.736418320466063e-05
291,plan,254,0.00046645902506390854,74,0.00016857912853702933,180,0.001705110595367783
10101,mueller,254,0.00046645902506390854,254,0.0005786364682216952,0,0
245,live,253,0.00046462257220932624,104,0.00023692201848447364,149,0.001411452659498887
5691,wonderful,253,0.00046462257220932624,251,0.0005718021792269508,2,1.8945673281864254e-05
1119,same,252,0.00046278611935474394,188,0.0004282821103373177,64,0.0006062615450196561
1490,while,252,0.00046278611935474394,213,0.00048523451862685465,39,0.00036944062899635295
21,next,250,0.0004591132136455793,165,0.00037588589471094374,85,0.0008051911144792308
2624,true,247,0.00045360385508183234,238,0.0005421869269163916,9,8.525552976838915e-05
273,justice,246,0.00045176740222725004,223,0.0005080154819426694,23,0.00021787524274143893
5115,hoax,246,0.00045176740222725004,244,0.0005558555049058804,2,1.8945673281864254e-05
651,meeting,245,0.0004499309493726677,232,0.0005285183489269027,13,0.00012314687633211766
4530,florida,243,0.0004462580436635031,227,0.0005171278672689954,16,0.00015156538625491403
1017,off,241,0.00044258513795433844,173,0.0003941106653635956,68,0.0006441528915833846
1397,john,241,0.00044258513795433844,230,0.0005239621562637398,11,0.0001042012030502534
4533,mexico,240,0.00044074868509975614,237,0.0005399088305848101,3,2.8418509922796382e-05
157,show,239,0.0004389122322451738,190,0.00043283830300048067,49,0.0004641689954056742
1355,incredible,239,0.0004389122322451738,232,0.0005285183489269027,7,6.63098564865249e-05
744,open,238,0.0004370757793905915,209,0.00047612213330052876,29,0.0002747122625870317
2055,votes,235,0.00043156642082684454,213,0.00048523451862685465,22,0.0002084024061005068
3780,korea,235,0.00043156642082684454,234,0.0005330745415900657,1,9.472836640932127e-06
1188,days,234,0.0004297299679722622,132,0.000300708715768755,102,0.000966229337375077
1529,political,232,0.0004260570622630976,221,0.0005034592892795064,11,0.0001042012030502534
1869,through,232,0.0004260570622630976,202,0.0004601754589794584,30,0.0002841850992279638
170,future,231,0.00042422060940851524,144,0.0003280458717477327,87,0.000824136787761095
2060,companies,229,0.00042054770369935065,171,0.00038955447270043263,58,0.0005494245251740634
1512,pm,228,0.0004187112508447683,207,0.0004715659406373658,21,0.00019892956945957466
3501,massive,228,0.0004187112508447683,224,0.000510293578274251,4,3.789134656372851e-05
4535,pennsylvania,228,0.0004187112508447683,223,0.0005080154819426694,5,4.736418320466063e-05
4168,cuts,226,0.0004150383451356037,156,0.00035538302772671044,70,0.0006630985648652489
791,protect,225,0.00041320189228102134,188,0.0004282821103373177,37,0.0003504949557144887
8035,book,224,0.00041136543942643905,224,0.000510293578274251,0,0
484,home,223,0.00040952898657185675,152,0.00034627064240038455,71,0.000672571401506181
261,millions,222,0.0004076925337172744,133,0.00030298681210033646,89,0.0008430824610429593
511,billion,222,0.0004076925337172744,184,0.00041916972501099183,38,0.00035996779235542085
955,such,222,0.0004076925337172744,218,0.000496625000284762,4,3.789134656372851e-05
3948,senator,222,0.0004076925337172744,209,0.00047612213330052876,13,0.00012314687633211766
8304,nancy,222,0.0004076925337172744,222,0.0005057373856110879,0,0
415,cut,221,0.0004058560808626921,131,0.0002984306194371735,90,0.0008525552976838915
1138,does,221,0.0004058560808626921,179,0.0004077792433530844,42,0.0003978591389191493
665,times,220,0.0004040196280081098,191,0.00043511639933206214,29,0.0002747122625870317
712,happen,218,0.00040034672229894515,197,0.00044878497732155103,21,0.00019892956945957466
8166,pelosi,218,0.00040034672229894515,218,0.000496625000284762,0,0
137,fighting,217,0.00039851026944436285,134,0.00030526490843191793,83,0.0007862454411973666
408,tell,216,0.0003966738165897805,88,0.00020047247717917,128,0.0012125230900393122
356,energy,214,0.00039300091088061585,144,0.0003280458717477327,70,0.0006630985648652489
4637,clinton,214,0.00039300091088061585,190,0.00043283830300048067,24,0.00022734807938237106
60,still,213,0.00039116445802603355,112,0.0002551467891371255,101,0.0009567565007341448
79,full,213,0.00039116445802603355,171,0.00038955447270043263,42,0.0003978591389191493
1161,life,212,0.00038932800517145125,150,0.0003417144497372216,62,0.0005873158717377919
192,thanks,211,0.0003874915523168689,111,0.00025286869280554395,100,0.0009472836640932128
1668,presidential,211,0.0003874915523168689,201,0.0004578973626478769,10,9.472836640932126e-05
3709,congressman,211,0.0003874915523168689,208,0.0004738440369689473,3,2.8418509922796382e-05
322,youre,210,0.0003856550994622866,32,7.289908261060727e-05,178,0.0016861649220859187
354,already,210,0.0003856550994622866,181,0.00041233543601624736,29,0.0002747122625870317
1560,economic,210,0.0003856550994622866,146,0.00033260206441089566,64,0.0006062615450196561
320,ready,209,0.0003838186466077043,143,0.00032576777541615124,66,0.0006252072183015204
324,ago,209,0.0003838186466077043,144,0.0003280458717477327,65,0.0006157343816605883
9622,crooked,208,0.00038198219375312195,208,0.0004738440369689473,0,0
71,sure,207,0.00038014574089853965,72,0.00016402293587386636,135,0.0012788329465258372
402,office,207,0.00038014574089853965,158,0.0003599392203898734,49,0.0004641689954056742
2031,both,206,0.00037830928804395735,188,0.0004282821103373177,18,0.0001705110595367783
373,read,205,0.000376472835189375,141,0.0003212115827529883,64,0.0006062615450196561
1243,lost,205,0.000376472835189375,180,0.0004100573396846659,25,0.0002368209160233032
7987,borders,205,0.000376472835189375,205,0.0004670097479742028,0,0
7321,tremendous,204,0.0003746363823347927,203,0.00046245355531103987,1,9.472836640932127e-06
7891,sleepy,204,0.0003746363823347927,204,0.00046473165164262134,0,0
1408,wont,199,0.0003654541180618811,147,0.0003348801607424772,52,0.0004925875053284706
1973,tomorrow,199,0.0003654541180618811,146,0.00033260206441089566,53,0.0005020603419694027
277,remember,198,0.0003636176652072988,181,0.00041233543601624736,17,0.00016103822289584616
371,having,198,0.0003636176652072988,184,0.00041916972501099183,14,0.0001326197129730498
3218,case,198,0.0003636176652072988,176,0.00040094495435834,22,0.0002084024061005068
8532,crazy,198,0.0003636176652072988,198,0.0004510630736531325,0,0
2131,wants,197,0.0003617812123527165,173,0.0003941106653635956,24,0.00022734807938237106
8447,tariffs,197,0.0003617812123527165,197,0.00044878497732155103,0,0
682,away,196,0.00035994475949813415,142,0.00032348967908456976,54,0.0005115331786103349
950,without,196,0.00035994475949813415,149,0.00033943635340564013,47,0.00044522332212380996
1208,middle,196,0.00035994475949813415,63,0.00014352006888963307,133,0.001259887273243973
684,trying,195,0.00035810830664355185,181,0.00041233543601624736,14,0.0001326197129730498
985,taking,194,0.00035627185378896955,150,0.0003417144497372216,44,0.0004168048122010136
1055,yesterday,194,0.00035627185378896955,151,0.00034399254606880307,43,0.0004073319755600815
2489,texas,194,0.00035627185378896955,185,0.0004214478213425733,9,8.525552976838915e-05
853,business,193,0.0003544354009343872,151,0.00034399254606880307,42,0.0003978591389191493
786,workers,192,0.0003525989480798049,133,0.00030298681210033646,59,0.0005588973618149955
1345,everything,192,0.0003525989480798049,164,0.00037360779837936227,28,0.0002652394259460996
2514,won,192,0.0003525989480798049,184,0.00041916972501099183,8,7.578269312745701e-05
1373,run,191,0.00035076249522522255,182,0.0004146135323478289,9,8.525552976838915e-05
1500,general,191,0.00035076249522522255,183,0.00041689162867941036,8,7.578269312745701e-05
143,number,190,0.00034892604237064025,172,0.0003918325690320141,18,0.0001705110595367783
503,insurance,190,0.00034892604237064025,39,8.884575693167761e-05,151,0.0014303983327807511
1352,man,190,0.00034892604237064025,165,0.00037588589471094374,25,0.0002368209160233032
385,rate,189,0.00034708958951605796,120,0.00027337155978977726,69,0.0006536257282243168
1738,yet,189,0.00034708958951605796,163,0.0003713297020477808,26,0.0002462937526642353
3719,market,189,0.00034708958951605796,184,0.00041916972501099183,5,4.736418320466063e-05
400,may,188,0.0003452531366614756,159,0.0003622173167214549,29,0.0002747122625870317
941,proud,188,0.0003452531366614756,150,0.0003417144497372216,38,0.00035996779235542085
693,fast,186,0.000341580230952311,180,0.0004100573396846659,6,5.6837019845592764e-05
924,voting,186,0.000341580230952311,145,0.0003303239680793142,41,0.0003883863022782172
37,2016,183,0.00033607087238856406,172,0.0003918325690320141,11,0.0001042012030502534
1563,anything,183,0.00033607087238856406,165,0.00037588589471094374,18,0.0001705110595367783
1189,fair,182,0.0003342344195339817,110,0.0002505905964739625,72,0.0006820442381471132
1324,carolina,182,0.0003342344195339817,175,0.0003986668580267585,7,6.63098564865249e-05
200,join,181,0.0003323979666793994,109,0.000248312500142381,72,0.0006820442381471132
384,low,181,0.0003323979666793994,169,0.00038499828003726963,12,0.00011367403969118553
1278,supreme,181,0.0003323979666793994,164,0.00037360779837936227,17,0.00016103822289584616
5317,wow,181,0.0003323979666793994,180,0.0004100573396846659,1,9.472836640932127e-06
942,iran,180,0.0003305615138248171,174,0.00039638876169517705,6,5.6837019845592764e-05
1279,friends,180,0.0003305615138248171,98,0.00022325344049498478,82,0.0007767726045564344
355,continue,178,0.00032688860811565246,154,0.0003508268350635475,24,0.00022734807938237106
534,until,178,0.00032688860811565246,135,0.00030754300476349946,43,0.0004073319755600815
589,system,178,0.00032688860811565246,118,0.0002688153671266143,60,0.0005683701984559276
3139,despite,178,0.00032688860811565246,167,0.0003804420873741067,11,0.0001042012030502534
790,lets,177,0.00032505215526107016,59,0.00013440768356330716,118,0.001117794723629991
1546,greatest,177,0.00032505215526107016,166,0.0003781639910425252,11,0.0001042012030502534
91,small,176,0.0003232157024064878,119,0.0002710934634581958,57,0.0005399516885331312
237,close,176,0.0003232157024064878,144,0.0003280458717477327,32,0.00030313077250982806
329,took,176,0.0003232157024064878,130,0.00029615252310559204,46,0.00043575048548287785
1411,tough,176,0.0003232157024064878,156,0.00035538302772671044,20,0.00018945673281864253
664,running,175,0.0003213792495519055,157,0.0003576611240582919,18,0.0001705110595367783
765,paid,175,0.0003213792495519055,142,0.00032348967908456976,33,0.0003126036091507602
4185,enforcement,174,0.0003195427966973232,171,0.00038955447270043263,3,2.8418509922796382e-05
214,almost,173,0.00031770634384274086,157,0.0003576611240582919,16,0.00015156538625491403
1095,own,173,0.00031770634384274086,101,0.0002300877294897292,72,0.0006820442381471132
7672,terrible,173,0.00031770634384274086,172,0.0003918325690320141,1,9.472836640932127e-06
8391,farmers,173,0.00031770634384274086,173,0.0003941106653635956,0,0
313,something,171,0.00031403343813357626,128,0.0002915963304424291,43,0.0004073319755600815
446,find,171,0.00031403343813357626,117,0.00026653727079503284,54,0.0005115331786103349
96,beautiful,170,0.0003121969852789939,163,0.0003713297020477808,7,6.63098564865249e-05
5573,fraud,170,0.0003121969852789939,168,0.00038272018370568816,2,1.8945673281864254e-05
800,during,169,0.0003103605324244116,150,0.0003417144497372216,19,0.00017998389617771042
2225,3,169,0.0003103605324244116,146,0.00033260206441089566,23,0.00021787524274143893
4695,badly,169,0.0003103605324244116,168,0.00038272018370568816,1,9.472836640932127e-06
8077,mike,169,0.0003103605324244116,169,0.00038499828003726963,0,0
1070,lives,168,0.00030852407956982926,132,0.000300708715768755,36,0.0003410221190735566
2015,men,168,0.00030852407956982926,119,0.0002710934634581958,49,0.0004641689954056742
39,action,167,0.00030668762671524696,87,0.00019819438084758853,80,0.0007578269312745701
8618,loves,167,0.00030668762671524696,167,0.0003804420873741067,0,0
113,chance,166,0.00030485117386066466,81,0.00018452580285809966,85,0.0008051911144792308
289,biggest,166,0.00030485117386066466,152,0.00034627064240038455,14,0.0001326197129730498
410,weve,165,0.0003030147210060823,34,7.745527527377023e-05,131,0.0012409415999621086
686,week,165,0.0003030147210060823,109,0.000248312500142381,56,0.0005304788518921992
541,pass,164,0.0003011782681515,77,0.00017541341753177375,87,0.000824136787761095
948,war,164,0.0003011782681515,108,0.00024603440381079953,56,0.0005304788518921992
2091,hes,164,0.0003011782681515,114,0.0002597029818002884,50,0.0004736418320466064
7788,phony,164,0.0003011782681515,163,0.0003713297020477808,1,9.472836640932127e-06
7908,georgia,164,0.0003011782681515,164,0.00037360779837936227,0,0
247,safe,162,0.00029750536244233536,143,0.00032576777541615124,19,0.00017998389617771042
1040,presidents,162,0.00029750536244233536,56,0.00012757339456856274,106,0.0010041206839388054
6390,healthcare,162,0.00029750536244233536,160,0.0003644954130530364,2,1.8945673281864254e-05
7852,2020,162,0.00029750536244233536,161,0.00036677350938461785,1,9.472836640932127e-06
576,poll,161,0.00029566890958775306,159,0.0003622173167214549,2,1.8945673281864254e-05
807,problem,161,0.00029566890958775306,147,0.0003348801607424772,14,0.0001326197129730498
1285,little,160,0.00029383245673317076,143,0.00032576777541615124,17,0.00016103822289584616
1867,start,160,0.00029383245673317076,135,0.00030754300476349946,25,0.0002368209160233032
2051,november,160,0.00029383245673317076,137,0.0003120991974266624,23,0.00021787524274143893
8107,comey,160,0.00029383245673317076,160,0.0003644954130530364,0,0
481,between,159,0.0002919960038785884,126,0.00028704013777926615,33,0.0003126036091507602
983,allowed,159,0.0002919960038785884,155,0.00035310493139512896,4,3.789134656372851e-05
7932,rigged,159,0.0002919960038785884,159,0.0003622173167214549,0,0
126,#actonclimate,158,0.0002901595510240061,0,0,158,0.0014967081892672761
292,power,158,0.0002901595510240061,114,0.0002597029818002884,44,0.0004168048122010136
1206,class,158,0.0002901595510240061,36,8.201146793693318e-05,122,0.0011556860701937195
8235,donald,157,0.0002883230981694238,157,0.0003576611240582919,0,0
9934,schiff,157,0.0002883230981694238,157,0.0003576611240582919,0,0
903,special,156,0.00028648664531484146,134,0.00030526490843191793,22,0.0002084024061005068
2759,called,156,0.00028648664531484146,143,0.00032576777541615124,13,0.00012314687633211766
188,around,155,0.00028465019246025916,121,0.00027564965612135873,34,0.0003220764457916923
540,morning,155,0.00028465019246025916,133,0.00030298681210033646,22,0.0002084024061005068
1104,early,155,0.00028465019246025916,131,0.0002984306194371735,24,0.00022734807938237106
4962,stock,155,0.00028465019246025916,152,0.00034627064240038455,3,2.8418509922796382e-05
675,cannot,154,0.00028281373960567686,117,0.00026653727079503284,37,0.0003504949557144887
723,seen,154,0.00028281373960567686,134,0.00030526490843191793,20,0.00018945673281864253
4459,rally,154,0.00028281373960567686,140,0.0003189334864214068,14,0.0001326197129730498
4464,michigan,154,0.00028281373960567686,149,0.00033943635340564013,5,4.736418320466063e-05
4549,mitt,153,0.0002809772867510945,16,3.644954130530364e-05,137,0.0012977786198077013
401,months,152,0.0002791408338965122,94,0.00021414105516865886,58,0.0005494245251740634
762,free,152,0.0002791408338965122,86,0.00019591628451600705,66,0.0006252072183015204
1610,major,152,0.0002791408338965122,143,0.00032576777541615124,9,8.525552976838915e-05
702,hope,151,0.0002773043810419299,124,0.0002824839451161032,27,0.0002557665893051674
935,leaders,151,0.0002773043810419299,128,0.0002915963304424291,23,0.00021787524274143893
1195,bring,151,0.0002773043810419299,122,0.0002779277524529402,29,0.0002747122625870317
1071,person,150,0.00027546792818734756,123,0.0002802058487845217,27,0.0002557665893051674
2953,fantastic,150,0.00027546792818734756,149,0.00033943635340564013,1,9.472836640932127e-06
4526,polls,150,0.00027546792818734756,139,0.00031665539008982535,11,0.0001042012030502534
8068,ratings,150,0.00027546792818734756,150,0.0003417144497372216,0,0
9945,southern,150,0.00027546792818734756,150,0.0003417144497372216,0,0
1015,sign,149,0.00027363147533276526,82,0.00018680389918968114,67,0.0006346800549424525
2439,ohio,149,0.00027363147533276526,122,0.0002779277524529402,27,0.0002557665893051674
3932,use,149,0.00027363147533276526,126,0.00028704013777926615,23,0.00021787524274143893
535,young,148,0.00027179502247818297,56,0.00012757339456856274,92,0.0008715009709657557
2356,along,148,0.00027179502247818297,137,0.0003120991974266624,11,0.0001042012030502534
3980,@whitehouse,148,0.00027179502247818297,125,0.0002847620414476847,23,0.00021787524274143893
5948,police,148,0.00027179502247818297,140,0.0003189334864214068,8,7.578269312745701e-05
221,nations,147,0.0002699585696236006,131,0.0002984306194371735,16,0.00015156538625491403
387,unemployment,147,0.0002699585696236006,112,0.0002551467891371255,35,0.0003315492824326244
262,obamacare,146,0.0002681221167690183,87,0.00019819438084758853,59,0.0005588973618149955
1277,statement,146,0.0002681221167690183,119,0.0002710934634581958,27,0.0002557665893051674
1741,possible,146,0.0002681221167690183,131,0.0002984306194371735,15,0.0001420925496139819
5098,highly,146,0.0002681221167690183,145,0.0003303239680793142,1,9.472836640932127e-06
1256,lot,145,0.00026628566391443596,116,0.00026425917446345137,29,0.0002747122625870317
1364,thousands,145,0.00026628566391443596,129,0.00029387442677401057,16,0.00015156538625491403
1998,talk,145,0.00026628566391443596,123,0.0002802058487845217,22,0.0002084024061005068
2397,secretary,145,0.00026628566391443596,128,0.0002915963304424291,17,0.00016103822289584616
3452,via,145,0.00026628566391443596,126,0.00028704013777926615,19,0.00017998389617771042
7997,approval,145,0.00026628566391443596,145,0.0003303239680793142,0,0
268,part,144,0.00026444921105985366,105,0.00023920011481605511,39,0.00036944062899635295
669,team,143,0.00026261275820527137,109,0.000248312500142381,34,0.0003220764457916923
1716,given,143,0.00026261275820527137,136,0.00030982110109508093,7,6.63098564865249e-05
2170,actually,143,0.00026261275820527137,130,0.00029615252310559204,13,0.00012314687633211766
56,fired,142,0.000260776305350689,96,0.0002186972478318218,46,0.00043575048548287785
806,longer,142,0.000260776305350689,112,0.0002551467891371255,30,0.0002841850992279638
756,victory,141,0.0002589398524961067,124,0.0002824839451161032,17,0.00016103822289584616
1537,service,141,0.0002589398524961067,114,0.0002597029818002884,27,0.0002557665893051674
7443,ballots,141,0.0002589398524961067,140,0.0003189334864214068,1,9.472836640932127e-06
44,progress,140,0.0002571033996415244,81,0.00018452580285809966,59,0.0005588973618149955
145,reason,140,0.0002571033996415244,113,0.00025742488546870695,27,0.0002557665893051674
213,name,140,0.0002571033996415244,47,0.00010707052758432943,93,0.0008809738076066879
766,heading,140,0.0002571033996415244,132,0.000300708715768755,8,7.578269312745701e-05
1461,hit,140,0.0002571033996415244,130,0.00029615252310559204,10,9.472836640932126e-05
7883,scam,140,0.0002571033996415244,140,0.0003189334864214068,0,0
450,less,139,0.00025526694678694206,85,0.00019363818818442555,54,0.0005115331786103349
959,anyone,139,0.00025526694678694206,120,0.00027337155978977726,19,0.00017998389617771042
1200,raise,137,0.00025159404107777747,61,0.0001389638762264701,76,0.0007199355847108417
2263,minister,137,0.00025159404107777747,135,0.00030754300476349946,2,1.8945673281864254e-05
2707,enjoy,137,0.00025159404107777747,134,0.00030526490843191793,3,2.8418509922796382e-05
2919,ask,137,0.00025159404107777747,86,0.00019591628451600705,51,0.0004831146686875385
4703,disaster,137,0.00025159404107777747,135,0.00030754300476349946,2,1.8945673281864254e-05
365,affordable,136,0.0002497575882231951,8,1.822477065265182e-05,128,0.0012125230900393122
1179,god,136,0.0002497575882231951,130,0.00029615252310559204,6,5.6837019845592764e-05
3014,california,136,0.0002497575882231951,129,0.00029387442677401057,7,6.63098564865249e-05
311,matter,135,0.0002479211353686128,92,0.00020958486250549592,43,0.0004073319755600815
1664,failed,135,0.0002479211353686128,117,0.00026653727079503284,18,0.0001705110595367783
2859,information,135,0.0002479211353686128,131,0.0002984306194371735,4,3.789134656372851e-05
3959,quickly,135,0.0002479211353686128,132,0.000300708715768755,3,2.8418509922796382e-05
432,retweet,134,0.0002460846825140305,0,0,134,0.001269360109884905
1891,truly,134,0.0002460846825140305,128,0.0002915963304424291,6,5.6837019845592764e-05
4439,wisconsin,134,0.0002460846825140305,121,0.00027564965612135873,13,0.00012314687633211766
4508,conference,134,0.0002460846825140305,125,0.0002847620414476847,9,8.525552976838915e-05
8,obamas,133,0.00024424822965944817,15,3.417144497372216e-05,118,0.001117794723629991
460,lower,133,0.00024424822965944817,94,0.00021414105516865886,39,0.00036944062899635295
527,able,133,0.00024424822965944817,94,0.00021414105516865886,39,0.00036944062899635295
1219,told,133,0.00024424822965944817,118,0.0002688153671266143,15,0.0001420925496139819
5310,large,133,0.00024424822965944817,131,0.0002984306194371735,2,1.8945673281864254e-05
607,happening,132,0.00024241177680486587,104,0.00023692201848447364,28,0.0002652394259460996
769,higher,132,0.00024241177680486587,80,0.0001822477065265182,52,0.0004925875053284706
1695,zero,132,0.00024241177680486587,128,0.0002915963304424291,4,3.789134656372851e-05
1060,move,131,0.00024057532395028354,75,0.0001708572248686108,56,0.0005304788518921992
1110,worse,131,0.00024057532395028354,128,0.0002915963304424291,3,2.8418509922796382e-05
1875,used,131,0.00024057532395028354,118,0.0002688153671266143,13,0.00012314687633211766
2264,prime,131,0.00024057532395028354,129,0.00029387442677401057,2,1.8945673281864254e-05
3029,asked,131,0.00024057532395028354,112,0.0002551467891371255,19,0.00017998389617771042
217,signed,130,0.00023873887109570124,91,0.00020730676617391444,39,0.00036944062899635295
760,education,130,0.00023873887109570124,16,3.644954130530364e-05,114,0.0010799033770662624
1306,gone,130,0.00023873887109570124,124,0.0002824839451161032,6,5.6837019845592764e-05
1327,south,130,0.00023873887109570124,127,0.0002893182341108476,3,2.8418509922796382e-05
1532,10,130,0.00023873887109570124,70,0.0001594667432107034,60,0.0005683701984559276
5927,immediately,130,0.00023873887109570124,127,0.0002893182341108476,3,2.8418509922796382e-05
134,become,129,0.00023690241824111892,114,0.0002597029818002884,15,0.0001420925496139819
802,few,129,0.00023690241824111892,73,0.00016630103220544783,56,0.0005304788518921992
988,decision,129,0.00023690241824111892,111,0.00025286869280554395,18,0.0001705110595367783
1901,finally,129,0.00023690241824111892,113,0.00025742488546870695,16,0.00015156538625491403
9923,russian,129,0.00023690241824111892,129,0.00029387442677401057,0,0
1078,drug,128,0.0002350659653865366,122,0.0002779277524529402,6,5.6837019845592764e-05
1402,gave,128,0.0002350659653865366,110,0.0002505905964739625,18,0.0001705110595367783
1770,voted,128,0.0002350659653865366,93,0.0002118629588370774,35,0.0003315492824326244
2396,press,128,0.0002350659653865366,118,0.0002688153671266143,10,9.472836640932126e-05
41,climate,127,0.00023322951253195427,6,1.3668577989488863e-05,121,0.0011462132335527874
342,isnt,127,0.00023322951253195427,78,0.00017769151386335522,49,0.0004641689954056742
971,weak,127,0.00023322951253195427,126,0.00028704013777926615,1,9.472836640932127e-06
1019,businesses,127,0.00023322951253195427,62,0.0001412419725580516,65,0.0006157343816605883
1069,knows,127,0.00023322951253195427,109,0.000248312500142381,18,0.0001705110595367783
524,welcome,125,0.00022955660682278964,101,0.0002300877294897292,24,0.00022734807938237106
1686,else,125,0.00022955660682278964,116,0.00026425917446345137,9,8.525552976838915e-05
2185,moving,125,0.00022955660682278964,84,0.00019136009185284408,41,0.0003883863022782172
5677,guy,125,0.00022955660682278964,123,0.0002802058487845217,2,1.8945673281864254e-05
8133,perhaps,125,0.00022955660682278964,125,0.0002847620414476847,0,0
8476,nice,125,0.00022955660682278964,125,0.0002847620414476847,0,0
473,growth,124,0.00022772015396820732,68,0.00015491055054754046,56,0.0005304788518921992
492,level,124,0.00022772015396820732,111,0.00025286869280554395,13,0.00012314687633211766
1359,words,124,0.00022772015396820732,109,0.000248312500142381,15,0.0001420925496139819
2209,top,124,0.00022772015396820732,85,0.00019363818818442555,39,0.00036944062899635295
3023,please,124,0.00022772015396820732,108,0.00024603440381079953,16,0.00015156538625491403
5440,thought,124,0.00022772015396820732,118,0.0002688153671266143,6,5.6837019845592764e-05
229,gun,123,0.00022588370111362502,25,5.695240828953693e-05,98,0.0009283379908113484
234,safety,123,0.00022588370111362502,116,0.00026425917446345137,7,6.63098564865249e-05
281,build,123,0.00022588370111362502,99,0.00022553153682656625,24,0.00022734807938237106
288,americas,123,0.00022588370111362502,71,0.00016174483954228488,52,0.0004925875053284706
2228,highest,123,0.00022588370111362502,113,0.00025742488546870695,10,9.472836640932126e-05
2395,james,123,0.00022588370111362502,122,0.0002779277524529402,1,9.472836640932127e-06
2787,went,123,0.00022588370111362502,119,0.0002710934634581958,4,3.789134656372851e-05
4382,allow,123,0.00022588370111362502,111,0.00025286869280554395,12,0.00011367403969118553
1102,save,122,0.0002240472482590427,88,0.00020047247717917,34,0.0003220764457916923
1337,100,122,0.0002240472482590427,110,0.0002505905964739625,12,0.00011367403969118553
1631,dc,122,0.0002240472482590427,114,0.0002597029818002884,8,7.578269312745701e-05
2512,built,122,0.0002240472482590427,106,0.0002414782111476366,16,0.00015156538625491403
293,taken,121,0.00022221079540446037,109,0.000248312500142381,12,0.00011367403969118553
643,meet,121,0.00022221079540446037,73,0.00016630103220544783,48,0.0004546961587647421
1193,stronger,121,0.00022221079540446037,100,0.00022780963315814772,21,0.00019892956945957466
1371,friend,121,0.00022221079540446037,104,0.00023692201848447364,17,0.00016103822289584616
163,watching,120,0.00022037434254987807,111,0.00025286869280554395,9,8.525552976838915e-05
610,politics,120,0.00022037434254987807,84,0.00019136009185284408,36,0.0003410221190735566
3539,ridiculous,120,0.00022037434254987807,119,0.0002710934634581958,1,9.472836640932127e-06
3760,voters,120,0.00022037434254987807,87,0.00019819438084758853,33,0.0003126036091507602
3914,failing,120,0.00022037434254987807,119,0.0002710934634581958,1,9.472836640932127e-06
396,stay,119,0.00021853788969529575,91,0.00020730676617391444,28,0.0002652394259460996
1111,smart,119,0.00021853788969529575,109,0.000248312500142381,10,9.472836640932126e-05
2842,agenda,119,0.00021853788969529575,109,0.000248312500142381,10,9.472836640932126e-05
3076,virginia,119,0.00021853788969529575,108,0.00024603440381079953,11,0.0001042012030502534
728,college,118,0.00021670143684071342,22,5.01181192947925e-05,96,0.0009093923175294842
2750,sad,118,0.00021670143684071342,117,0.00026653727079503284,1,9.472836640932127e-06
230,laws,117,0.0002148649839861311,110,0.0002505905964739625,7,6.63098564865249e-05
1242,ive,117,0.0002148649839861311,76,0.00017313532120019227,41,0.0003883863022782172
2583,control,117,0.0002148649839861311,100,0.00022780963315814772,17,0.00016103822289584616
382,veterans,116,0.0002130285311315488,74,0.00016857912853702933,42,0.0003978591389191493
1064,race,116,0.0002130285311315488,103,0.00023464392215289217,13,0.00012314687633211766
1231,past,116,0.0002130285311315488,85,0.00019363818818442555,31,0.00029365793586889595
1363,billions,116,0.0002130285311315488,108,0.00024603440381079953,8,7.578269312745701e-05
2605,interest,116,0.0002130285311315488,85,0.00019363818818442555,31,0.00029365793586889595
2847,winning,116,0.0002130285311315488,112,0.0002551467891371255,4,3.789134656372851e-05
1,#sotu,115,0.00021119207827696647,4,9.11238532632591e-06,111,0.001051484867143466
363,public,115,0.00021119207827696647,98,0.00022325344049498478,17,0.00016103822289584616
493,lowest,115,0.00021119207827696647,100,0.00022780963315814772,15,0.0001420925496139819
516,address,115,0.00021119207827696647,41,9.340194959484057e-05,74,0.0007009899114289774
587,needed,115,0.00021119207827696647,109,0.000248312500142381,6,5.6837019845592764e-05
1032,four,115,0.00021119207827696647,57,0.0001298514909001442,58,0.0005494245251740634
8463,angry,115,0.00021119207827696647,115,0.0002619810781318699,0,0
8615,cnn,115,0.00021119207827696647,115,0.0002619810781318699,0,0
438,worst,114,0.00020935562542238415,109,0.000248312500142381,5,4.736418320466063e-05
456,prices,114,0.00020935562542238415,112,0.0002551467891371255,2,1.8945673281864254e-05
1616,debate,114,0.00020935562542238415,68,0.00015491055054754046,46,0.00043575048548287785
2571,based,114,0.00020935562542238415,111,0.00025286869280554395,3,2.8418509922796382e-05
2623,stories,114,0.00020935562542238415,104,0.00023692201848447364,10,9.472836640932126e-05
3187,leaving,114,0.00020935562542238415,110,0.0002505905964739625,4,3.789134656372851e-05
6573,spoke,114,0.00020935562542238415,109,0.000248312500142381,5,4.736418320466063e-05
8633,bernie,114,0.00020935562542238415,114,0.0002597029818002884,0,0
1004,50,113,0.00020751917256780185,85,0.00019363818818442555,28,0.0002652394259460996
1209,talking,113,0.00020751917256780185,103,0.00023464392215289217,10,9.472836640932126e-05
1652,facts,113,0.00020751917256780185,76,0.00017313532120019227,37,0.0003504949557144887
2464,ukraine,113,0.00020751917256780185,111,0.00025286869280554395,2,1.8945673281864254e-05
3756,@nytimes,113,0.00020751917256780185,108,0.00024603440381079953,5,4.736418320466063e-05
8887,@cnn,113,0.00020751917256780185,113,0.00025742488546870695,0,0
190,leadership,112,0.00020568271971321952,92,0.00020958486250549592,20,0.00018945673281864253
267,historic,112,0.00020568271971321952,87,0.00019819438084758853,25,0.0002368209160233032
1751,happened,112,0.00020568271971321952,105,0.00023920011481605511,7,6.63098564865249e-05
4123,2nd,112,0.00020568271971321952,108,0.00024603440381079953,4,3.789134656372851e-05
6733,process,112,0.00020568271971321952,111,0.00025286869280554395,1,9.472836640932127e-06
250,dangerous,111,0.0002038462668586372,102,0.00023236582582131067,9,8.525552976838915e-05
331,birthday,111,0.0002038462668586372,56,0.00012757339456856274,55,0.000521006015251267
894,three,111,0.0002038462668586372,83,0.0001890819955212626,28,0.0002652394259460996
1880,worked,111,0.0002038462668586372,93,0.0002118629588370774,18,0.0001705110595367783
3879,foreign,111,0.0002038462668586372,92,0.00020958486250549592,19,0.00017998389617771042
4163,choice,111,0.0002038462668586372,81,0.00018452580285809966,30,0.0002841850992279638
84,everybody,110,0.0002020098140040549,68,0.00015491055054754046,42,0.0003978591389191493
1893,send,110,0.0002020098140040549,74,0.00016857912853702933,36,0.0003410221190735566
2080,members,110,0.0002020098140040549,80,0.0001822477065265182,30,0.0002841850992279638
2423,4,110,0.0002020098140040549,83,0.0001890819955212626,27,0.0002557665893051674
4455,caught,110,0.0002020098140040549,109,0.000248312500142381,1,9.472836640932127e-06
8665,investigation,110,0.0002020098140040549,110,0.0002505905964739625,0,0
179,came,109,0.00020017336114947257,96,0.0002186972478318218,13,0.00012314687633211766
773,wage,109,0.00020017336114947257,6,1.3668577989488863e-05,103,0.0009757021740160091
1361,success,109,0.00020017336114947257,89,0.00020275057351075147,20,0.00018945673281864253
1645,amazing,109,0.00020017336114947257,102,0.00023236582582131067,7,6.63098564865249e-05
2394,former,109,0.00020017336114947257,101,0.0002300877294897292,8,7.578269312745701e-05
2451,especially,109,0.00020017336114947257,108,0.00024603440381079953,1,9.472836640932127e-06
2765,saying,109,0.00020017336114947257,102,0.00023236582582131067,7,6.63098564865249e-05
6248,strongly,109,0.00020017336114947257,106,0.0002414782111476366,3,2.8418509922796382e-05
8823,obstruction,109,0.00020017336114947257,109,0.000248312500142381,0,0
1425,try,108,0.00019833690829489025,76,0.00017313532120019227,32,0.00030313077250982806
3134,force,108,0.00019833690829489025,100,0.00022780963315814772,8,7.578269312745701e-05
7607,fully,108,0.00019833690829489025,106,0.0002414782111476366,2,1.8945673281864254e-05
563,violence,107,0.00019650045544030792,35,7.97333716053517e-05,72,0.0006820442381471132
799,check,107,0.00019650045544030792,57,0.0001298514909001442,50,0.0004736418320466064
4374,started,107,0.00019650045544030792,92,0.00020958486250549592,15,0.0001420925496139819
434,add,106,0.00019466400258572562,30,6.834288994744431e-05,76,0.0007199355847108417
441,oil,106,0.00019466400258572562,62,0.0001412419725580516,44,0.0004168048122010136
612,enough,106,0.00019466400258572562,78,0.00017769151386335522,28,0.0002652394259460996
750,mark,106,0.00019466400258572562,97,0.0002209753441634033,9,8.525552976838915e-05
1088,entire,106,0.00019466400258572562,96,0.0002186972478318218,10,9.472836640932126e-05
1722,respect,106,0.00019466400258572562,101,0.0002300877294897292,5,4.736418320466063e-05
5755,respected,106,0.00019466400258572562,104,0.00023692201848447364,2,1.8945673281864254e-05
325,fix,105,0.0001928275497311433,79,0.0001799696101949367,26,0.0002462937526642353
462,create,105,0.0001928275497311433,46,0.00010479243125274796,59,0.0005588973618149955
477,cities,105,0.0001928275497311433,100,0.00022780963315814772,5,4.736418320466063e-05
868,set,105,0.0001928275497311433,72,0.00016402293587386636,33,0.0003126036091507602
1310,game,105,0.0001928275497311433,90,0.00020502866984233294,15,0.0001420925496139819
2160,city,105,0.0001928275497311433,100,0.00022780963315814772,5,4.736418320466063e-05
3082,successful,105,0.0001928275497311433,101,0.0002300877294897292,4,3.789134656372851e-05
4627,candidate,105,0.0001928275497311433,89,0.00020275057351075147,16,0.00015156538625491403
257,across,104,0.00019099109687656097,62,0.0001412419725580516,42,0.0003978591389191493
2203,wanted,104,0.00019099109687656097,97,0.0002209753441634033,7,6.63098564865249e-05
5438,#obama2012,104,0.00019099109687656097,0,0,104,0.0009851750106569413
6672,unfair,104,0.00019099109687656097,103,0.00023464392215289217,1,9.472836640932127e-06
8506,coronavirus,104,0.00019099109687656097,104,0.00023692201848447364,0,0
297,post,103,0.00018915464402197868,97,0.0002209753441634033,6,5.6837019845592764e-05
8223,reporting,103,0.00018915464402197868,103,0.00023464392215289217,0,0
8328,schumer,103,0.00018915464402197868,103,0.00023464392215289217,0,0
443,2,102,0.00018731819116739635,79,0.0001799696101949367,23,0.00021787524274143893
555,coverage,102,0.00018731819116739635,41,9.340194959484057e-05,61,0.0005778430350968597
1374,means,102,0.00018731819116739635,64,0.00014579816522121455,38,0.00035996779235542085
4164,false,102,0.00018731819116739635,98,0.00022325344049498478,4,3.789134656372851e-05
5465,mayor,102,0.00018731819116739635,101,0.0002300877294897292,1,9.472836640932127e-06
8070,@seanhannity,102,0.00018731819116739635,102,0.00023236582582131067,0,0
260,helping,101,0.00018548173831281402,69,0.00015718864687912194,32,0.00030313077250982806
771,minimum,101,0.00018548173831281402,5,1.1390481657907387e-05,96,0.0009093923175294842
3336,beginning,101,0.00018548173831281402,93,0.0002118629588370774,8,7.578269312745701e-05
270,step,100,0.00018364528545823173,50,0.00011390481657907386,50,0.0004736418320466064
1544,says,100,0.00018364528545823173,73,0.00016630103220544783,27,0.0002557665893051674
196,point,99,0.0001818088326036494,91,0.00020730676617391444,8,7.578269312745701e-05
290,clean,99,0.0001818088326036494,40,9.11238532632591e-05,59,0.0005588973618149955
608,asking,99,0.0001818088326036494,72,0.00016402293587386636,27,0.0002557665893051674
3438,speech,99,0.0001818088326036494,72,0.00016402293587386636,27,0.0002557665893051674
5607,attack,99,0.0001818088326036494,94,0.00021414105516865886,5,4.736418320466063e-05
7972,@breitbartnews,99,0.0001818088326036494,99,0.00022553153682656625,0,0
8080,chuck,99,0.0001818088326036494,99,0.00022553153682656625,0,0
8162,stated,99,0.0001818088326036494,99,0.00022553153682656625,0,0
80,theres,98,0.00017997237974906708,40,9.11238532632591e-05,58,0.0005494245251740634
251,easy,98,0.00017997237974906708,87,0.00019819438084758853,11,0.0001042012030502534
582,5,98,0.00017997237974906708,52,0.00011846100924223682,46,0.00043575048548287785
2004,1,98,0.00017997237974906708,57,0.0001298514909001442,41,0.0003883863022782172
2634,crowd,98,0.00017997237974906708,87,0.00019819438084758853,11,0.0001042012030502534
8227,illegally,98,0.00017997237974906708,98,0.00022325344049498478,0,0
9902,whistleblower,98,0.00017997237974906708,98,0.00022325344049498478,0,0
1375,share,97,0.00017813592689448478,15,3.417144497372216e-05,82,0.0007767726045564344
3902,arizona,97,0.00017813592689448478,88,0.00020047247717917,9,8.525552976838915e-05
5173,leader,97,0.00017813592689448478,92,0.00020958486250549592,5,4.736418320466063e-05
533,turn,96,0.00017629947403990245,62,0.0001412419725580516,34,0.0003220764457916923
2295,student,96,0.00017629947403990245,11,2.505905964739625e-05,85,0.0008051911144792308
2377,michael,96,0.00017629947403990245,93,0.0002118629588370774,3,2.8418509922796382e-05
2629,brave,96,0.00017629947403990245,90,0.00020502866984233294,6,5.6837019845592764e-05
8367,interviewed,96,0.00017629947403990245,96,0.0002186972478318218,0,0
8700,rating,96,0.00017629947403990245,96,0.0002186972478318218,0,0
11891,kim,96,0.00017629947403990245,96,0.0002186972478318218,0,0
619,leave,95,0.00017446302118532013,61,0.0001389638762264701,34,0.0003220764457916923
913,rates,95,0.00017446302118532013,56,0.00012757339456856274,39,0.00036944062899635295
936,peace,95,0.00017446302118532013,81,0.00018452580285809966,14,0.0001326197129730498
1073,opportunity,95,0.00017446302118532013,38,8.656766060009614e-05,57,0.0005399516885331312
1863,senators,95,0.00017446302118532013,77,0.00017541341753177375,18,0.0001705110595367783
2672,giving,95,0.00017446302118532013,70,0.0001594667432107034,25,0.0002368209160233032
2708,knew,95,0.00017446302118532013,90,0.00020502866984233294,5,4.736418320466063e-05
2971,japan,95,0.00017446302118532013,90,0.00020502866984233294,5,4.736418320466063e-05
3209,starting,95,0.00017446302118532013,72,0.00016402293587386636,23,0.00021787524274143893
3706,drugs,95,0.00017446302118532013,89,0.00020275057351075147,6,5.6837019845592764e-05
8284,lamestream,95,0.00017446302118532013,95,0.00021641915150024033,0,0
241,needs,94,0.0001726265683307378,53,0.0001207391055738183,41,0.0003883863022782172
1569,play,94,0.0001726265683307378,73,0.00016630103220544783,21,0.00019892956945957466
7971,dishonest,94,0.0001726265683307378,94,0.00021414105516865886,0,0
10205,deals,94,0.0001726265683307378,94,0.00021414105516865886,0,0
11710,isis,94,0.0001726265683307378,94,0.00021414105516865886,0,0
578,shows,93,0.0001707901154761555,72,0.00016402293587386636,21,0.00019892956945957466
828,equal,93,0.0001707901154761555,7,1.5946674321070342e-05,86,0.000814663951120163
1239,sources,93,0.0001707901154761555,87,0.00019819438084758853,6,5.6837019845592764e-05
1262,cost,93,0.0001707901154761555,69,0.00015718864687912194,24,0.00022734807938237106
1446,policies,93,0.0001707901154761555,55,0.00012529529823698124,38,0.00035996779235542085
1450,nobody,93,0.0001707901154761555,81,0.00018452580285809966,12,0.00011367403969118553
183,nearly,92,0.00016895366262157318,28,6.378669728428137e-05,64,0.0006062615450196561
522,children,92,0.00016895366262157318,49,0.00011162672024749239,43,0.0004073319755600815
2037,plus,92,0.00016895366262157318,89,0.00020275057351075147,3,2.8418509922796382e-05
2121,building,92,0.00016895366262157318,77,0.00017541341753177375,15,0.0001420925496139819
2126,west,92,0.00016895366262157318,83,0.0001890819955212626,9,8.525552976838915e-05
2581,once,92,0.00016895366262157318,77,0.00017541341753177375,15,0.0001420925496139819
3476,enemy,92,0.00016895366262157318,90,0.00020502866984233294,2,1.8945673281864254e-05
4436,iowa,92,0.00016895366262157318,68,0.00015491055054754046,24,0.00022734807938237106
4930,potus,92,0.00016895366262157318,2,4.556192663162955e-06,90,0.0008525552976838915
770,local,91,0.00016711720976699085,77,0.00017541341753177375,14,0.0001326197129730498
1174,whole,91,0.00016711720976699085,76,0.00017313532120019227,15,0.0001420925496139819
1198,#raisethewage,91,0.00016711720976699085,0,0,91,0.0008620281343248235
1661,announced,91,0.00016711720976699085,78,0.00017769151386335522,13,0.00012314687633211766
1785,department,91,0.00016711720976699085,87,0.00019819438084758853,4,3.789134656372851e-05
2817,spending,91,0.00016711720976699085,71,0.00016174483954228488,20,0.00018945673281864253
3546,twitter,91,0.00016711720976699085,57,0.0001298514909001442,34,0.0003220764457916923
352,weeks,90,0.00016528075691240855,61,0.0001389638762264701,29,0.0002747122625870317
902,makes,90,0.00016528075691240855,58,0.00013212958723172568,32,0.00030313077250982806
1186,middle-class,90,0.00016528075691240855,1,2.2780963315814773e-06,89,0.0008430824610429593
1222,freedom,90,0.00016528075691240855,75,0.0001708572248686108,15,0.0001420925496139819
1451,playing,90,0.00016528075691240855,80,0.0001822477065265182,10,9.472836640932126e-05
1482,students,90,0.00016528075691240855,23,5.239621562637398e-05,67,0.0006346800549424525
1495,community,90,0.00016528075691240855,55,0.00012529529823698124,35,0.0003315492824326244
2338,looks,90,0.00016528075691240855,72,0.00016402293587386636,18,0.0001705110595367783
2417,paying,90,0.00016528075691240855,75,0.0001708572248686108,15,0.0001420925496139819
3532,forced,90,0.00016528075691240855,85,0.00019363818818442555,5,4.736418320466063e-05
4616,romneys,90,0.00016528075691240855,3,6.8342889947444315e-06,87,0.000824136787761095
7032,minnesota,90,0.00016528075691240855,89,0.00020275057351075147,1,9.472836640932127e-06
9903,adam,90,0.00016528075691240855,90,0.00020502866984233294,0,0
1137,cases,88,0.0001616078512032439,80,0.0001822477065265182,8,7.578269312745701e-05
1812,lose,88,0.0001616078512032439,75,0.0001708572248686108,13,0.00012314687633211766
5285,released,88,0.0001616078512032439,81,0.00018452580285809966,7,6.63098564865249e-05
8071,corruption,88,0.0001616078512032439,88,0.00020047247717917,0,0
409,theyre,87,0.0001597713983486616,54,0.00012301720190539977,33,0.0003126036091507602
518,criminal,87,0.0001597713983486616,81,0.00018452580285809966,6,5.6837019845592764e-05
658,interview,87,0.0001597713983486616,81,0.00018452580285809966,6,5.6837019845592764e-05
2044,evidence,87,0.0001597713983486616,84,0.00019136009185284408,3,2.8418509922796382e-05
2649,brought,87,0.0001597713983486616,80,0.0001822477065265182,7,6.63098564865249e-05
3696,daca,87,0.0001597713983486616,86,0.00019591628451600705,1,9.472836640932127e-06
7854,testing,87,0.0001597713983486616,86,0.00019591628451600705,1,9.472836640932127e-06
8495,horrible,87,0.0001597713983486616,87,0.00019819438084758853,0,0
13103,melania,87,0.0001597713983486616,87,0.00019819438084758853,0,0
549,word,86,0.00015793494549407928,52,0.00011846100924223682,34,0.0003220764457916923
683,shutdown,86,0.00015793494549407928,57,0.0001298514909001442,29,0.0002747122625870317
825,lead,86,0.00015793494549407928,66,0.0001503543578843775,20,0.00018945673281864253
1386,side,86,0.00015793494549407928,74,0.00016857912853702933,12,0.00011367403969118553
2526,passed,86,0.00015793494549407928,55,0.00012529529823698124,31,0.00029365793586889595
3018,truth,86,0.00015793494549407928,71,0.00016174483954228488,15,0.0001420925496139819
3609,evening,86,0.00015793494549407928,83,0.0001890819955212626,3,2.8418509922796382e-05
489,sick,85,0.00015609849263949695,61,0.0001389638762264701,24,0.00022734807938237106
666,hear,85,0.00015609849263949695,66,0.0001503543578843775,19,0.00017998389617771042
1030,decades,85,0.00015609849263949695,78,0.00017769151386335522,7,6.63098564865249e-05
3479,fed,85,0.00015609849263949695,84,0.00019136009185284408,1,9.472836640932127e-06
7472,wins,85,0.00015609849263949695,84,0.00019136009185284408,1,9.472836640932127e-06
11306,intelligence,85,0.00015609849263949695,85,0.00019363818818442555,0,0
1050,citizens,84,0.00015426203978491463,65,0.00014807626155279602,19,0.00017998389617771042
1783,rather,84,0.00015426203978491463,78,0.00017769151386335522,6,5.6837019845592764e-05
2028,bigger,84,0.00015426203978491463,77,0.00017541341753177375,7,6.63098564865249e-05
2339,reported,84,0.00015426203978491463,82,0.00018680389918968114,2,1.8945673281864254e-05
2689,paul,84,0.00015426203978491463,50,0.00011390481657907386,34,0.0003220764457916923
3136,judge,84,0.00015426203978491463,82,0.00018680389918968114,2,1.8945673281864254e-05
4310,lies,84,0.00015426203978491463,82,0.00018680389918968114,2,1.8945673281864254e-05
4898,jim,84,0.00015426203978491463,80,0.0001822477065265182,4,3.789134656372851e-05
8007,@oann,84,0.00015426203978491463,84,0.00019136009185284408,0,0
437,late,83,0.00015242558693033233,71,0.00016174483954228488,12,0.00011367403969118553
449,least,83,0.00015242558693033233,66,0.0001503543578843775,17,0.00016103822289584616
1205,works,83,0.00015242558693033233,49,0.00011162672024749239,34,0.0003220764457916923
1241,wasnt,83,0.00015242558693033233,74,0.00016857912853702933,9,8.525552976838915e-05
1621,gets,83,0.00015242558693033233,62,0.0001412419725580516,21,0.00019892956945957466
3471,different,83,0.00015242558693033233,66,0.0001503543578843775,17,0.00016103822289584616
10458,alabama,83,0.00015242558693033233,83,0.0001890819955212626,0,0
581,25,82,0.00015058913407575,63,0.00014352006888963307,19,0.00017998389617771042
787,hurt,82,0.00015058913407575,75,0.0001708572248686108,7,6.63098564865249e-05
1178,bless,82,0.00015058913407575,78,0.00017769151386335522,4,3.789134656372851e-05
1294,treated,82,0.00015058913407575,73,0.00016630103220544783,9,8.525552976838915e-05
1444,deserve,82,0.00015058913407575,33,7.517717894218875e-05,49,0.0004641689954056742
2347,heroes,82,0.00015058913407575,77,0.00017541341753177375,5,4.736418320466063e-05
4786,steve,82,0.00015058913407575,77,0.00017541341753177375,5,4.736418320466063e-05
6456,bob,82,0.00015058913407575,81,0.00018452580285809966,1,9.472836640932127e-06
8298,easily,82,0.00015058913407575,82,0.00018680389918968114,0,0
1510,et,81,0.00014875268122116768,3,6.8342889947444315e-06,78,0.0007388812579927059
1579,supports,81,0.00014875268122116768,62,0.0001412419725580516,19,0.00017998389617771042
1910,crisis,81,0.00014875268122116768,60,0.00013668577989488863,21,0.00019892956945957466
2491,legal,81,0.00014875268122116768,72,0.00016402293587386636,9,8.525552976838915e-05
4444,dnc,81,0.00014875268122116768,78,0.00017769151386335522,3,2.8418509922796382e-05
4639,israel,81,0.00014875268122116768,79,0.0001799696101949367,2,1.8945673281864254e-05
3,final,80,0.00014691622836658538,47,0.00010707052758432943,33,0.0003126036091507602
536,agreement,80,0.00014691622836658538,63,0.00014352006888963307,17,0.00016103822289584616
816,heard,80,0.00014691622836658538,52,0.00011846100924223682,28,0.0002652394259460996
1884,defend,80,0.00014691622836658538,76,0.00017313532120019227,4,3.789134656372851e-05
3790,phone,80,0.00014691622836658538,64,0.00014579816522121455,16,0.00015156538625491403
7982,hopefully,80,0.00014691622836658538,80,0.0001822477065265182,0,0
440,increase,79,0.00014507977551200306,62,0.0001412419725580516,17,0.00016103822289584616
613,prayers,79,0.00014507977551200306,64,0.00014579816522121455,15,0.0001420925496139819
990,iraq,79,0.00014507977551200306,33,7.517717894218875e-05,46,0.00043575048548287785
1656,potential,79,0.00014507977551200306,73,0.00016630103220544783,6,5.6837019845592764e-05
2535,primary,79,0.00014507977551200306,74,0.00016857912853702933,5,4.736418320466063e-05
2773,understand,79,0.00014507977551200306,67,0.00015263245421595896,12,0.00011367403969118553
2805,saved,79,0.00014507977551200306,64,0.00014579816522121455,15,0.0001420925496139819
4544,ballot,79,0.00014507977551200306,71,0.00016174483954228488,8,7.578269312745701e-05
5406,dead,79,0.00014507977551200306,76,0.00017313532120019227,3,2.8418509922796382e-05
9681,meetings,79,0.00014507977551200306,79,0.0001799696101949367,0,0
11293,dossier,79,0.00014507977551200306,79,0.0001799696101949367,0,0
118,ahead,78,0.00014324332265742073,57,0.0001298514909001442,21,0.00019892956945957466
866,month,78,0.00014324332265742073,41,9.340194959484057e-05,37,0.0003504949557144887
1468,david,78,0.00014324332265742073,73,0.00016630103220544783,5,4.736418320466063e-05
1760,funding,78,0.00014324332265742073,67,0.00015263245421595896,11,0.0001042012030502534
2738,voter,78,0.00014324332265742073,69,0.00015718864687912194,9,8.525552976838915e-05
3084,powerful,78,0.00014324332265742073,63,0.00014352006888963307,15,0.0001420925496139819
3544,tuesday,78,0.00014324332265742073,72,0.00016402293587386636,6,5.6837019845592764e-05
3608,syria,78,0.00014324332265742073,76,0.00017313532120019227,2,1.8945673281864254e-05
5255,opponent,78,0.00014324332265742073,74,0.00016857912853702933,4,3.789134656372851e-05
8698,jeff,78,0.00014324332265742073,78,0.00017769151386335522,0,0
9460,relationship,78,0.00014324332265742073,78,0.00017769151386335522,0,0
488,shouldnt,77,0.00014140686980283843,33,7.517717894218875e-05,44,0.0004168048122010136
491,#obamacare,77,0.00014140686980283843,5,1.1390481657907387e-05,72,0.0006820442381471132
900,single,77,0.00014140686980283843,32,7.289908261060727e-05,45,0.00042627764884194575
1007,old,77,0.00014140686980283843,67,0.00015263245421595896,10,9.472836640932126e-05
1433,comes,77,0.00014140686980283843,47,0.00010707052758432943,30,0.0002841850992279638
1499,attorney,77,0.00014140686980283843,75,0.0001708572248686108,2,1.8945673281864254e-05
1987,lady,77,0.00014140686980283843,43,9.795814225800353e-05,34,0.0003220764457916923
2963,couldnt,77,0.00014140686980283843,68,0.00015491055054754046,9,8.525552976838915e-05
7235,so-called,77,0.00014140686980283843,76,0.00017313532120019227,1,9.472836640932127e-06
8050,andrew,77,0.00014140686980283843,77,0.00017541341753177375,0,0
8826,lawyer,77,0.00014140686980283843,77,0.00017541341753177375,0,0
74,union,76,0.0001395704169482561,55,0.00012529529823698124,21,0.00019892956945957466
517,calls,76,0.0001395704169482561,44,0.000100236238589585,32,0.00030313077250982806
733,school,76,0.0001395704169482561,54,0.00012301720190539977,22,0.0002084024061005068
1098,dollar,76,0.0001395704169482561,68,0.00015491055054754046,8,7.578269312745701e-05
3374,policy,76,0.0001395704169482561,62,0.0001412419725580516,14,0.0001326197129730498
3443,hurricane,76,0.0001395704169482561,68,0.00015491055054754046,8,7.578269312745701e-05
4862,mess,76,0.0001395704169482561,68,0.00015491055054754046,8,7.578269312745701e-05
191,standing,75,0.00013773396409367378,45,0.00010251433492116647,30,0.0002841850992279638
670,todays,75,0.00013773396409367378,37,8.428956426851466e-05,38,0.00035996779235542085
914,seeing,75,0.00013773396409367378,69,0.00015718864687912194,6,5.6837019845592764e-05
2662,favorite,75,0.00013773396409367378,42,9.568004592642204e-05,33,0.0003126036091507602
5481,results,75,0.00013773396409367378,72,0.00016402293587386636,3,2.8418509922796382e-05
7341,robert,75,0.00013773396409367378,73,0.00016630103220544783,2,1.8945673281864254e-05
114,heres,74,0.00013589751123909148,7,1.5946674321070342e-05,67,0.0006346800549424525
266,conversation,74,0.00013589751123909148,65,0.00014807626155279602,9,8.525552976838915e-05
430,covered,74,0.00013589751123909148,27,6.150860095269988e-05,47,0.00044522332212380996
943,nuclear,74,0.00013589751123909148,68,0.00015491055054754046,6,5.6837019845592764e-05
2875,price,74,0.00013589751123909148,66,0.0001503543578843775,8,7.578269312745701e-05
3328,putting,74,0.00013589751123909148,64,0.00014579816522121455,10,9.472836640932126e-05
3701,using,74,0.00013589751123909148,61,0.0001389638762264701,13,0.00012314687633211766
6466,director,74,0.00013589751123909148,71,0.00016174483954228488,3,2.8418509922796382e-05
8091,@loudobbs,74,0.00013589751123909148,74,0.00016857912853702933,0,0
8125,destroy,74,0.00013589751123909148,74,0.00016857912853702933,0,0
8135,guard,74,0.00013589751123909148,74,0.00016857912853702933,0,0
8225,virus,74,0.00013589751123909148,74,0.00016857912853702933,0,0
558,air,73,0.00013406105838450916,58,0.00013212958723172568,15,0.0001420925496139819
933,youve,73,0.00013406105838450916,21,4.784002296321102e-05,52,0.0004925875053284706
1196,helped,73,0.00013406105838450916,47,0.00010707052758432943,26,0.0002462937526642353
2111,agreed,73,0.00013406105838450916,69,0.00015718864687912194,4,3.789134656372851e-05
2376,death,73,0.00013406105838450916,70,0.0001594667432107034,3,2.8418509922796382e-05
2422,speak,73,0.00013406105838450916,56,0.00012757339456856274,17,0.00016103822289584616
2469,infrastructure,73,0.00013406105838450916,66,0.0001503543578843775,7,6.63098564865249e-05
2587,continues,73,0.00013406105838450916,67,0.00015263245421595896,6,5.6837019845592764e-05
3964,except,73,0.00013406105838450916,72,0.00016402293587386636,1,9.472836640932127e-06
602,idea,72,0.00013222460552992683,55,0.00012529529823698124,17,0.00016103822289584616
999,speaking,72,0.00013222460552992683,45,0.00010251433492116647,27,0.0002557665893051674
1245,though,72,0.00013222460552992683,69,0.00015718864687912194,3,2.8418509922796382e-05
1457,elected,72,0.00013222460552992683,64,0.00014579816522121455,8,7.578269312745701e-05
1882,someone,72,0.00013222460552992683,52,0.00011846100924223682,20,0.00018945673281864253
2400,face,72,0.00013222460552992683,44,0.000100236238589585,28,0.0002652394259460996
4383,absolutely,72,0.00013222460552992683,68,0.00015491055054754046,4,3.789134656372851e-05
4602,lie,72,0.00013222460552992683,69,0.00015718864687912194,3,2.8418509922796382e-05
8025,closely,72,0.00013222460552992683,72,0.00016402293587386636,0,0
8286,committee,72,0.00013222460552992683,72,0.00016402293587386636,0,0
8996,france,72,0.00013222460552992683,72,0.00016402293587386636,0,0
9367,disgrace,72,0.00013222460552992683,72,0.00016402293587386636,0,0
305,forget,71,0.0001303881526753445,61,0.0001389638762264701,10,9.472836640932126e-05
677,issue,71,0.0001303881526753445,46,0.00010479243125274796,25,0.0002368209160233032
1517,supporters,71,0.0001303881526753445,43,9.795814225800353e-05,28,0.0002652394259460996
2381,kind,71,0.0001303881526753445,61,0.0001389638762264701,10,9.472836640932126e-05
2785,killed,71,0.0001303881526753445,67,0.00015263245421595896,4,3.789134656372851e-05
3345,turkey,71,0.0001303881526753445,67,0.00015263245421595896,4,3.789134656372851e-05
6128,steel,71,0.0001303881526753445,67,0.00015263245421595896,4,3.789134656372851e-05
10011,canada,71,0.0001303881526753445,71,0.00016174483954228488,0,0
1436,whats,70,0.0001285516998207622,49,0.00011162672024749239,21,0.00019892956945957466
1773,congressional,70,0.0001285516998207622,57,0.0001298514909001442,13,0.00012314687633211766
3417,bringing,70,0.0001285516998207622,58,0.00013212958723172568,12,0.00011367403969118553
3737,street,70,0.0001285516998207622,47,0.00010707052758432943,23,0.00021787524274143893
8084,correct,70,0.0001285516998207622,70,0.0001594667432107034,0,0
394,involved,69,0.00012671524696617988,54,0.00012301720190539977,15,0.0001420925496139819
575,majority,69,0.00012671524696617988,50,0.00011390481657907386,19,0.00017998389617771042
637,each,69,0.00012671524696617988,38,8.656766060009614e-05,31,0.00029365793586889595
1077,crimes,69,0.00012671524696617988,68,0.00015491055054754046,1,9.472836640932127e-06
1099,found,69,0.00012671524696617988,65,0.00014807626155279602,4,3.789134656372851e-05
1212,teachers,69,0.00012671524696617988,17,3.8727637636885116e-05,52,0.0004925875053284706
1691,afford,69,0.00012671524696617988,2,4.556192663162955e-06,67,0.0006346800549424525
1740,hate,69,0.00012671524696617988,65,0.00014807626155279602,4,3.789134656372851e-05
1885,dream,69,0.00012671524696617988,40,9.11238532632591e-05,29,0.0002747122625870317
1929,instead,69,0.00012671524696617988,51,0.00011618291291065533,18,0.0001705110595367783
3582,points,69,0.00012671524696617988,67,0.00015263245421595896,2,1.8945673281864254e-05
4229,defense,69,0.00012671524696617988,64,0.00014579816522121455,5,4.736418320466063e-05
5334,maybe,69,0.00012671524696617988,68,0.00015491055054754046,1,9.472836640932127e-06
7172,louisiana,69,0.00012671524696617988,67,0.00015263245421595896,2,1.8945673281864254e-05
8933,mini,69,0.00012671524696617988,69,0.00015718864687912194,0,0
339,fought,68,0.00012487879411159756,48,0.0001093486239159109,20,0.00018945673281864253
1028,reduce,68,0.00012487879411159756,22,5.01181192947925e-05,46,0.00043575048548287785
1265,12,68,0.00012487879411159756,57,0.0001298514909001442,11,0.0001042012030502534
1435,politician,68,0.00012487879411159756,65,0.00014807626155279602,3,2.8418509922796382e-05
1982,question,68,0.00012487879411159756,53,0.0001207391055738183,15,0.0001420925496139819
2019,troops,68,0.00012487879411159756,49,0.00011162672024749239,19,0.00017998389617771042
3733,page,68,0.00012487879411159756,63,0.00014352006888963307,5,4.736418320466063e-05
8450,etc,68,0.00012487879411159756,68,0.00015491055054754046,0,0
11384,xi,68,0.00012487879411159756,68,0.00015491055054754046,0,0
920,rights,67,0.00012304234125701526,35,7.97333716053517e-05,32,0.00030313077250982806
997,wish,67,0.00012304234125701526,40,9.11238532632591e-05,27,0.0002557665893051674
1229,created,67,0.00012304234125701526,41,9.340194959484057e-05,26,0.0002462937526642353
2163,tom,67,0.00012304234125701526,61,0.0001389638762264701,6,5.6837019845592764e-05
3092,wouldnt,67,0.00012304234125701526,60,0.00013668577989488863,7,6.63098564865249e-05
3346,representatives,67,0.00012304234125701526,53,0.0001207391055738183,14,0.0001326197129730498
7679,w,67,0.00012304234125701526,64,0.00014579816522121455,3,2.8418509922796382e-05
471,added,66,0.00012120588840243293,20,4.556192663162955e-05,46,0.00043575048548287785
593,deficit,66,0.00012120588840243293,16,3.644954130530364e-05,50,0.0004736418320466064
761,willing,66,0.00012120588840243293,41,9.340194959484057e-05,25,0.0002368209160233032
1838,met,66,0.00012120588840243293,59,0.00013440768356330716,7,6.63098564865249e-05
2370,situation,66,0.00012120588840243293,62,0.0001412419725580516,4,3.789134656372851e-05
3003,hundreds,66,0.00012120588840243293,58,0.00013212958723172568,8,7.578269312745701e-05
3270,spent,66,0.00012120588840243293,61,0.0001389638762264701,5,4.736418320466063e-05
3801,rest,66,0.00012120588840243293,60,0.00013668577989488863,6,5.6837019845592764e-05
4372,term,66,0.00012120588840243293,51,0.00011618291291065533,15,0.0001420925496139819
8116,dan,66,0.00012120588840243293,66,0.0001503543578843775,0,0
486,mean,65,0.00011936943554785062,38,8.656766060009614e-05,27,0.0002557665893051674
538,budget,65,0.00011936943554785062,28,6.378669728428137e-05,37,0.0003504949557144887
1259,broken,65,0.00011936943554785062,40,9.11238532632591e-05,25,0.0002368209160233032
1459,officials,65,0.00011936943554785062,59,0.00013440768356330716,6,5.6837019845592764e-05
1835,january,65,0.00011936943554785062,39,8.884575693167761e-05,26,0.0002462937526642353
2414,probably,65,0.00011936943554785062,64,0.00014579816522121455,1,9.472836640932127e-06
3874,social,65,0.00011936943554785062,58,0.00013212958723172568,7,6.63098564865249e-05
4763,written,65,0.00011936943554785062,57,0.0001298514909001442,8,7.578269312745701e-05
5962,responders,65,0.00011936943554785062,61,0.0001389638762264701,4,3.789134656372851e-05
7798,un,65,0.00011936943554785062,64,0.00014579816522121455,1,9.472836640932127e-06
7920,fraudulent,65,0.00011936943554785062,65,0.00014807626155279602,0,0
11555,nato,65,0.00011936943554785062,65,0.00014807626155279602,0,0
274,later,64,0.0001175329826932683,56,0.00012757339456856274,8,7.578269312745701e-05
521,@flotus,64,0.0001175329826932683,59,0.00013440768356330716,5,4.736418320466063e-05
742,clear,64,0.0001175329826932683,38,8.656766060009614e-05,26,0.0002462937526642353
804,negative,64,0.0001175329826932683,62,0.0001412419725580516,2,1.8945673281864254e-05
1330,industry,64,0.0001175329826932683,42,9.568004592642204e-05,22,0.0002084024061005068
1391,focus,64,0.0001175329826932683,54,0.00012301720190539977,10,9.472836640932126e-05
2018,serve,64,0.0001175329826932683,45,0.00010251433492116647,19,0.00017998389617771042
2216,fox,64,0.0001175329826932683,61,0.0001389638762264701,3,2.8418509922796382e-05
2741,follow,64,0.0001175329826932683,46,0.00010479243125274796,18,0.0001705110595367783
3280,charge,64,0.0001175329826932683,56,0.00012757339456856274,8,7.578269312745701e-05
3549,credit,64,0.0001175329826932683,48,0.0001093486239159109,16,0.00015156538625491403
4912,east,64,0.0001175329826932683,62,0.0001412419725580516,2,1.8945673281864254e-05
878,immigrants,63,0.00011569652983868599,33,7.517717894218875e-05,30,0.0002841850992279638
1168,costs,63,0.00011569652983868599,31,7.06209862790258e-05,32,0.00030313077250982806
1317,debt,63,0.00011569652983868599,18,4.100573396846659e-05,45,0.00042627764884194575
1383,courage,63,0.00011569652983868599,47,0.00010707052758432943,16,0.00015156538625491403
1476,within,63,0.00011569652983868599,53,0.0001207391055738183,10,9.472836640932126e-05
1577,ban,63,0.00011569652983868599,52,0.00011846100924223682,11,0.0001042012030502534
2090,announce,63,0.00011569652983868599,59,0.00013440768356330716,4,3.789134656372851e-05
2181,7,63,0.00011569652983868599,45,0.00010251433492116647,18,0.0001705110595367783
2683,either,63,0.00011569652983868599,53,0.0001207391055738183,10,9.472836640932126e-05
2719,weekend,63,0.00011569652983868599,40,9.11238532632591e-05,23,0.00021787524274143893
3078,losing,63,0.00011569652983868599,59,0.00013440768356330716,4,3.789134656372851e-05
4227,necessary,63,0.00011569652983868599,60,0.00013668577989488863,3,2.8418509922796382e-05
4625,#progress,63,0.00011569652983868599,0,0,63,0.000596788708378724
4674,trumps,63,0.00011569652983868599,62,0.0001412419725580516,1,9.472836640932127e-06
4793,ryan,63,0.00011569652983868599,25,5.695240828953693e-05,38,0.00035996779235542085
5249,certain,63,0.00011569652983868599,59,0.00013440768356330716,4,3.789134656372851e-05
7951,approved,63,0.00011569652983868599,63,0.00014352006888963307,0,0
12777,puerto,63,0.00011569652983868599,63,0.00014352006888963307,0,0
614,thoughts,62,0.00011386007698410366,50,0.00011390481657907386,12,0.00011367403969118553
1106,kids,62,0.00011386007698410366,9,2.0502866984233294e-05,53,0.0005020603419694027
1414,15,62,0.00011386007698410366,42,9.568004592642204e-05,20,0.00018945673281864253
1791,grow,62,0.00011386007698410366,20,4.556192663162955e-05,42,0.0003978591389191493
2553,arent,62,0.00011386007698410366,44,0.000100236238589585,18,0.0001705110595367783
3093,buy,62,0.00011386007698410366,52,0.00011846100924223682,10,9.472836640932126e-05
3117,staff,62,0.00011386007698410366,54,0.00012301720190539977,8,7.578269312745701e-05
3851,fire,62,0.00011386007698410366,59,0.00013440768356330716,3,2.8418509922796382e-05
4162,3rd,62,0.00011386007698410366,60,0.00013668577989488863,2,1.8945673281864254e-05
4218,13,62,0.00011386007698410366,55,0.00012529529823698124,7,6.63098564865249e-05
5342,release,62,0.00011386007698410366,55,0.00012529529823698124,7,6.63098564865249e-05
419,growing,61,0.00011202362412952135,18,4.100573396846659e-05,43,0.0004073319755600815
561,calling,61,0.00011202362412952135,44,0.000100236238589585,17,0.00016103822289584616
1203,line,61,0.00011202362412952135,37,8.428956426851466e-05,24,0.00022734807938237106
1424,promise,61,0.00011202362412952135,27,6.150860095269988e-05,34,0.0003220764457916923
1508,8,61,0.00011202362412952135,46,0.00010479243125274796,15,0.0001420925496139819
1566,changed,61,0.00011202362412952135,48,0.0001093486239159109,13,0.00012314687633211766
1576,talks,61,0.00011202362412952135,50,0.00011390481657907386,11,0.0001042012030502534
1687,happens,61,0.00011202362412952135,46,0.00010479243125274796,15,0.0001420925496139819
2186,cutting,61,0.00011202362412952135,41,9.340194959484057e-05,20,0.00018945673281864253
2251,reserve,61,0.00011202362412952135,60,0.00013668577989488863,1,9.472836640932127e-06
2440,tried,61,0.00011202362412952135,49,0.00011162672024749239,12,0.00011367403969118553
2651,repeal,61,0.00011202362412952135,42,9.568004592642204e-05,19,0.00017998389617771042
2684,difference,61,0.00011202362412952135,31,7.06209862790258e-05,30,0.0002841850992279638
2746,victims,61,0.00011202362412952135,44,0.000100236238589585,17,0.00016103822289584616
4970,judges,61,0.00011202362412952135,60,0.00013668577989488863,1,9.472836640932127e-06
12778,rico,61,0.00011202362412952135,61,0.0001389638762264701,0,0
854,five,60,0.00011018717127493904,21,4.784002296321102e-05,39,0.00036944062899635295
1067,hand,60,0.00011018717127493904,50,0.00011390481657907386,10,9.472836640932126e-05
1975,scott,60,0.00011018717127493904,57,0.0001298514909001442,3,2.8418509922796382e-05
2297,#opportunityforall,60,0.00011018717127493904,0,0,60,0.0005683701984559276
2970,germany,60,0.00011018717127493904,59,0.00013440768356330716,1,9.472836640932127e-06
3454,whether,60,0.00011018717127493904,46,0.00010479243125274796,14,0.0001326197129730498
5228,event,60,0.00011018717127493904,46,0.00010479243125274796,14,0.0001326197129730498
8051,mccabe,60,0.00011018717127493904,60,0.00013668577989488863,0,0
8179,chris,60,0.00011018717127493904,60,0.00013668577989488863,0,0
8185,chairman,60,0.00011018717127493904,60,0.00013668577989488863,0,0
219,committed,59,0.00010835071842035671,54,0.00012301720190539977,5,4.736418320466063e-05
1269,trillion,59,0.00010835071842035671,44,0.000100236238589585,15,0.0001420925496139819
1504,woman,59,0.00010835071842035671,26,5.923050462111841e-05,33,0.0003126036091507602
1694,sent,59,0.00010835071842035671,51,0.00011618291291065533,8,7.578269312745701e-05
1917,900,59,0.00010835071842035671,54,0.00012301720190539977,5,4.736418320466063e-05
2628,patriots,59,0.00010835071842035671,56,0.00012757339456856274,3,2.8418509922796382e-05
5048,recent,59,0.00010835071842035671,53,0.0001207391055738183,6,5.6837019845592764e-05
161,list,58,0.0001065142655657744,42,9.568004592642204e-05,16,0.00015156538625491403
660,beat,58,0.0001065142655657744,54,0.00012301720190539977,4,3.789134656372851e-05
688,celebrate,58,0.0001065142655657744,41,9.340194959484057e-05,17,0.00016103822289584616
820,voice,58,0.0001065142655657744,22,5.01181192947925e-05,36,0.0003410221190735566
889,flag,58,0.0001065142655657744,55,0.00012529529823698124,3,2.8418509922796382e-05
1336,communities,58,0.0001065142655657744,43,9.795814225800353e-05,15,0.0001420925496139819
1430,passing,58,0.0001065142655657744,26,5.923050462111841e-05,32,0.00030313077250982806
1485,group,58,0.0001065142655657744,48,0.0001093486239159109,10,9.472836640932126e-05
1762,hours,58,0.0001065142655657744,43,9.795814225800353e-05,15,0.0001420925496139819
1759,bipartisan,58,0.0001065142655657744,36,8.201146793693318e-05,22,0.0002084024061005068
1840,whose,58,0.0001065142655657744,48,0.0001093486239159109,10,9.472836640932126e-05
2169,wait,58,0.0001065142655657744,29,6.606479361586284e-05,29,0.0002747122625870317
2406,countrys,58,0.0001065142655657744,49,0.00011162672024749239,9,8.525552976838915e-05
2771,missed,58,0.0001065142655657744,29,6.606479361586284e-05,29,0.0002747122625870317
4896,chief,58,0.0001065142655657744,50,0.00011390481657907386,8,7.578269312745701e-05
5711,liberal,58,0.0001065142655657744,57,0.0001298514909001442,1,9.472836640932127e-06
7935,likewise,58,0.0001065142655657744,58,0.00013212958723172568,0,0
9096,europe,58,0.0001065142655657744,58,0.00013212958723172568,0,0
9563,peter,58,0.0001065142655657744,58,0.00013212958723172568,0,0
650,fall,57,0.00010467781271119207,31,7.06209862790258e-05,26,0.0002462937526642353
776,leading,57,0.00010467781271119207,52,0.00011846100924223682,5,4.736418320466063e-05
922,anniversary,57,0.00010467781271119207,24,5.467431195795545e-05,33,0.0003126036091507602
1006,medicare,57,0.00010467781271119207,22,5.01181192947925e-05,35,0.0003315492824326244
1094,deserves,57,0.00010467781271119207,19,4.328383030004807e-05,38,0.00035996779235542085
1128,30,57,0.00010467781271119207,40,9.11238532632591e-05,17,0.00016103822289584616
1558,raising,57,0.00010467781271119207,14,3.1893348642140685e-05,43,0.0004073319755600815
1570,shot,57,0.00010467781271119207,34,7.745527527377023e-05,23,0.00021787524274143893
2071,answer,57,0.00010467781271119207,47,0.00010707052758432943,10,9.472836640932126e-05
2302,20,57,0.00010467781271119207,46,0.00010479243125274796,11,0.0001042012030502534
3176,manufacturing,57,0.00010467781271119207,43,9.795814225800353e-05,14,0.0001326197129730498
3195,course,57,0.00010467781271119207,51,0.00011618291291065533,6,5.6837019845592764e-05
4525,nevada,57,0.00010467781271119207,52,0.00011846100924223682,5,4.736418320466063e-05
4660,confidence,57,0.00010467781271119207,53,0.0001207391055738183,4,3.789134656372851e-05
5509,questions,57,0.00010467781271119207,50,0.00011390481657907386,7,6.63098564865249e-05
5765,hearing,57,0.00010467781271119207,55,0.00012529529823698124,2,1.8945673281864254e-05
8639,anarchists,57,0.00010467781271119207,57,0.0001298514909001442,0,0
11890,jong,57,0.00010467781271119207,57,0.0001298514909001442,0,0
835,greater,56,0.00010284135985660976,49,0.00011162672024749239,7,6.63098564865249e-05
1045,human,56,0.00010284135985660976,50,0.00011390481657907386,6,5.6837019845592764e-05
1054,visit,56,0.00010284135985660976,44,0.000100236238589585,12,0.00011367403969118553
1911,financial,56,0.00010284135985660976,38,8.656766060009614e-05,18,0.0001705110595367783
2647,ill,56,0.00010284135985660976,33,7.517717894218875e-05,23,0.00021787524274143893
3127,deliver,56,0.00010284135985660976,48,0.0001093486239159109,8,7.578269312745701e-05
3181,recovery,56,0.00010284135985660976,45,0.00010251433492116647,11,0.0001042012030502534
3382,legislation,56,0.00010284135985660976,44,0.000100236238589585,12,0.00011367403969118553
3839,pleased,56,0.00010284135985660976,53,0.0001207391055738183,3,2.8418509922796382e-05
4727,eastern,56,0.00010284135985660976,54,0.00012301720190539977,2,1.8945673281864254e-05
7260,sorry,56,0.00010284135985660976,55,0.00012529529823698124,1,9.472836640932127e-06
7886,request,56,0.00010284135985660976,56,0.00012757339456856274,0,0
8147,clue,56,0.00010284135985660976,56,0.00012757339456856274,0,0
9167,greatly,56,0.00010284135985660976,56,0.00012757339456856274,0,0
18,further,55,0.00010100490700202745,49,0.00011162672024749239,6,5.6837019845592764e-05
195,moment,55,0.00010100490700202745,18,4.100573396846659e-05,37,0.0003504949557144887
695,michelle,55,0.00010100490700202745,15,3.417144497372216e-05,40,0.00037891346563728506
1008,turned,55,0.00010100490700202745,47,0.00010707052758432943,8,7.578269312745701e-05
1061,perfect,55,0.00010100490700202745,40,9.11238532632591e-05,15,0.0001420925496139819
1063,problems,55,0.00010100490700202745,48,0.0001093486239159109,7,6.63098564865249e-05
1688,itself,55,0.00010100490700202745,52,0.00011846100924223682,3,2.8418509922796382e-05
1858,mr,55,0.00010100490700202745,47,0.00010707052758432943,8,7.578269312745701e-05
2816,havent,55,0.00010100490700202745,42,9.568004592642204e-05,13,0.00012314687633211766
2996,car,55,0.00010100490700202745,39,8.884575693167761e-05,16,0.00015156538625491403
6180,kentucky,55,0.00010100490700202745,54,0.00012301720190539977,1,9.472836640932127e-06
6928,pressure,55,0.00010100490700202745,54,0.00012301720190539977,1,9.472836640932127e-06
8112,bidens,55,0.00010100490700202745,55,0.00012529529823698124,0,0
8320,disgraceful,55,0.00010100490700202745,55,0.00012529529823698124,0,0
10021,impeach,55,0.00010100490700202745,55,0.00012529529823698124,0,0
244,keeping,54,9.916845414744512e-05,41,9.340194959484057e-05,13,0.00012314687633211766
399,hold,54,9.916845414744512e-05,43,9.795814225800353e-05,11,0.0001042012030502534
427,yes,54,9.916845414744512e-05,41,9.340194959484057e-05,13,0.00012314687633211766
789,simple,54,9.916845414744512e-05,40,9.11238532632591e-05,14,0.0001326197129730498
1405,themselves,54,9.916845414744512e-05,43,9.795814225800353e-05,11,0.0001042012030502534
2224,setting,54,9.916845414744512e-05,50,0.00011390481657907386,4,3.789134656372851e-05
2241,shut,54,9.916845414744512e-05,38,8.656766060009614e-05,16,0.00015156538625491403
4784,rep,54,9.916845414744512e-05,46,0.00010479243125274796,8,7.578269312745701e-05
5259,outstanding,54,9.916845414744512e-05,50,0.00011390481657907386,4,3.789134656372851e-05
5475,watched,54,9.916845414744512e-05,52,0.00011846100924223682,2,1.8945673281864254e-05
6123,received,54,9.916845414744512e-05,47,0.00010707052758432943,7,6.63098564865249e-05
7285,interesting,54,9.916845414744512e-05,53,0.0001207391055738183,1,9.472836640932127e-06
8008,lawyers,54,9.916845414744512e-05,54,0.00012301720190539977,0,0
8055,governors,54,9.916845414744512e-05,54,0.00012301720190539977,0,0
9293,ag,54,9.916845414744512e-05,54,0.00012301720190539977,0,0
543,responsible,53,9.733200129286281e-05,36,8.201146793693318e-05,17,0.00016103822289584616
687,womens,53,9.733200129286281e-05,17,3.8727637636885116e-05,36,0.0003410221190735566
1507,dinner,53,9.733200129286281e-05,26,5.923050462111841e-05,27,0.0002557665893051674
2273,video,53,9.733200129286281e-05,14,3.1893348642140685e-05,39,0.00036944062899635295
2434,loopholes,53,9.733200129286281e-05,34,7.745527527377023e-05,19,0.00017998389617771042
2937,black,53,9.733200129286281e-05,50,0.00011390481657907386,3,2.8418509922796382e-05
3051,17,53,9.733200129286281e-05,47,0.00010707052758432943,6,5.6837019845592764e-05
3145,district,53,9.733200129286281e-05,50,0.00011390481657907386,3,2.8418509922796382e-05
3511,credibility,53,9.733200129286281e-05,51,0.00011618291291065533,2,1.8945673281864254e-05
4165,gop,53,9.733200129286281e-05,24,5.467431195795545e-05,29,0.0002747122625870317
4306,minutes,53,9.733200129286281e-05,34,7.745527527377023e-05,19,0.00017998389617771042
5014,importantly,53,9.733200129286281e-05,52,0.00011846100924223682,1,9.472836640932127e-06
6895,kevin,53,9.733200129286281e-05,52,0.00011846100924223682,1,9.472836640932127e-06
7881,#kag2020,53,9.733200129286281e-05,53,0.0001207391055738183,0,0
7996,@mariabartiromo,53,9.733200129286281e-05,53,0.0001207391055738183,0,0
8312,@usdot,53,9.733200129286281e-05,53,0.0001207391055738183,0,0
8394,swamp,53,9.733200129286281e-05,53,0.0001207391055738183,0,0
9929,patrol,53,9.733200129286281e-05,53,0.0001207391055738183,0,0
10828,ukrainian,53,9.733200129286281e-05,53,0.0001207391055738183,0,0
207,demand,52,9.549554843828049e-05,39,8.884575693167761e-05,13,0.00012314687633211766
398,anywhere,52,9.549554843828049e-05,50,0.00011390481657907386,2,1.8945673281864254e-05
514,spend,52,9.549554843828049e-05,37,8.428956426851466e-05,15,0.0001420925496139819
818,rules,52,9.549554843828049e-05,36,8.201146793693318e-05,16,0.00015156538625491403
1147,schools,52,9.549554843828049e-05,37,8.428956426851466e-05,15,0.0001420925496139819
1384,takes,52,9.549554843828049e-05,31,7.06209862790258e-05,21,0.00019892956945957466
1659,18,52,9.549554843828049e-05,40,9.11238532632591e-05,12,0.00011367403969118553
1807,expensive,52,9.549554843828049e-05,47,0.00010707052758432943,5,4.736418320466063e-05
2411,company,52,9.549554843828049e-05,36,8.201146793693318e-05,16,0.00015156538625491403
2772,reasons,52,9.549554843828049e-05,38,8.656766060009614e-05,14,0.0001326197129730498
3228,conditions,52,9.549554843828049e-05,37,8.428956426851466e-05,15,0.0001420925496139819
7925,enthusiasm,52,9.549554843828049e-05,52,0.00011846100924223682,0,0
8265,dem,52,9.549554843828049e-05,52,0.00011846100924223682,0,0
8709,shortly,52,9.549554843828049e-05,52,0.00011846100924223682,0,0
571,led,51,9.365909558369818e-05,44,0.000100236238589585,7,6.63098564865249e-05
852,behind,51,9.365909558369818e-05,30,6.834288994744431e-05,21,0.00019892956945957466
884,killing,51,9.365909558369818e-05,50,0.00011390481657907386,1,9.472836640932127e-06
934,message,51,9.365909558369818e-05,25,5.695240828953693e-05,26,0.0002462937526642353
1084,criminals,51,9.365909558369818e-05,48,0.0001093486239159109,3,2.8418509922796382e-05
1258,acting,51,9.365909558369818e-05,49,0.00011162672024749239,2,1.8945673281864254e-05
2309,stands,51,9.365909558369818e-05,42,9.568004592642204e-05,9,8.525552976838915e-05
2575,emergency,51,9.365909558369818e-05,44,0.000100236238589585,7,6.63098564865249e-05
2607,whatever,51,9.365909558369818e-05,41,9.340194959484057e-05,10,9.472836640932126e-05
2763,exist,51,9.365909558369818e-05,46,0.00010479243125274796,5,4.736418320466063e-05
3166,aid,51,9.365909558369818e-05,38,8.656766060009614e-05,13,0.00012314687633211766
3343,behalf,51,9.365909558369818e-05,43,9.795814225800353e-05,8,7.578269312745701e-05
3833,center,51,9.365909558369818e-05,47,0.00010707052758432943,4,3.789134656372851e-05
4557,wife,51,9.365909558369818e-05,48,0.0001093486239159109,3,2.8418509922796382e-05
5028,47,51,9.365909558369818e-05,39,8.884575693167761e-05,12,0.00011367403969118553
8638,sanders,51,9.365909558369818e-05,51,0.00011618291291065533,0,0
8787,sanctuary,51,9.365909558369818e-05,51,0.00011618291291065533,0,0
8866,@tuckercarlson,51,9.365909558369818e-05,51,0.00011618291291065533,0,0
9213,anyway,51,9.365909558369818e-05,51,0.00011618291291065533,0,0
10024,trial,51,9.365909558369818e-05,51,0.00011618291291065533,0,0
11392,transcript,51,9.365909558369818e-05,51,0.00011618291291065533,0,0
40,became,50,9.182264272911586e-05,38,8.656766060009614e-05,12,0.00011367403969118553
416,earth,50,9.182264272911586e-05,30,6.834288994744431e-05,20,0.00018945673281864253
547,spread,50,9.182264272911586e-05,18,4.100573396846659e-05,32,0.00030313077250982806
680,access,50,9.182264272911586e-05,25,5.695240828953693e-05,25,0.0002368209160233032
1025,advantage,50,9.182264272911586e-05,47,0.00010707052758432943,3,2.8418509922796382e-05
1477,commitment,50,9.182264272911586e-05,25,5.695240828953693e-05,25,0.0002368209160233032
1993,third,50,9.182264272911586e-05,44,0.000100236238589585,6,5.6837019845592764e-05
2268,ending,50,9.182264272911586e-05,31,7.06209862790258e-05,19,0.00017998389617771042
2294,loan,50,9.182264272911586e-05,5,1.1390481657907387e-05,45,0.00042627764884194575
3047,cold,50,9.182264272911586e-05,46,0.00010479243125274796,4,3.789134656372851e-05
3152,honored,50,9.182264272911586e-05,47,0.00010707052758432943,3,2.8418509922796382e-05
3191,gotten,50,9.182264272911586e-05,49,0.00011162672024749239,1,9.472836640932127e-06
3675,died,50,9.182264272911586e-05,43,9.795814225800353e-05,7,6.63098564865249e-05
4345,monday,50,9.182264272911586e-05,45,0.00010251433492116647,5,4.736418320466063e-05
4539,polling,50,9.182264272911586e-05,42,9.568004592642204e-05,8,7.578269312745701e-05
5382,saturday,50,9.182264272911586e-05,46,0.00010479243125274796,4,3.789134656372851e-05
6227,additional,50,9.182264272911586e-05,45,0.00010251433492116647,5,4.736418320466063e-05
7950,proven,50,9.182264272911586e-05,50,0.00011390481657907386,0,0
8377,cuomo,50,9.182264272911586e-05,50,0.00011390481657907386,0,0
8392,fighter,50,9.182264272911586e-05,50,0.00011390481657907386,0,0
8739,scandal,50,9.182264272911586e-05,50,0.00011390481657907386,0,0
9710,incompetent,50,9.182264272911586e-05,50,0.00011390481657907386,0,0
10104,emails,50,9.182264272911586e-05,50,0.00011390481657907386,0,0
10207,usmca,50,9.182264272911586e-05,50,0.00011390481657907386,0,0
135,champion,49,8.998618987453354e-05,42,9.568004592642204e-05,7,6.63098564865249e-05
172,gives,49,8.998618987453354e-05,37,8.428956426851466e-05,12,0.00011367403969118553
175,secure,49,8.998618987453354e-05,39,8.884575693167761e-05,10,9.472836640932126e-05
520,weekly,49,8.998618987453354e-05,12,2.7337155978977726e-05,37,0.0003504949557144887
711,extraordinary,49,8.998618987453354e-05,40,9.11238532632591e-05,9,8.525552976838915e-05
1889,sending,49,8.998618987453354e-05,41,9.340194959484057e-05,8,7.578269312745701e-05
1907,served,49,8.998618987453354e-05,37,8.428956426851466e-05,12,0.00011367403969118553
1961,auto,49,8.998618987453354e-05,29,6.606479361586284e-05,20,0.00018945673281864253
2361,decisions,49,8.998618987453354e-05,24,5.467431195795545e-05,25,0.0002368209160233032
2402,half,49,8.998618987453354e-05,25,5.695240828953693e-05,24,0.00022734807938237106
2860,finish,49,8.998618987453354e-05,24,5.467431195795545e-05,25,0.0002368209160233032
3767,tennessee,49,8.998618987453354e-05,47,0.00010707052758432943,2,1.8945673281864254e-05
3857,head,49,8.998618987453354e-05,39,8.884575693167761e-05,10,9.472836640932126e-05
4151,known,49,8.998618987453354e-05,47,0.00010707052758432943,2,1.8945673281864254e-05
4760,va,49,8.998618987453354e-05,43,9.795814225800353e-05,6,5.6837019845592764e-05
4996,chinese,49,8.998618987453354e-05,47,0.00010707052758432943,2,1.8945673281864254e-05
6396,dirty,49,8.998618987453354e-05,48,0.0001093486239159109,1,9.472836640932127e-06
8039,mail-in,49,8.998618987453354e-05,49,0.00011162672024749239,0,0
8239,poorly,49,8.998618987453354e-05,49,0.00011162672024749239,0,0
9850,desperately,49,8.998618987453354e-05,49,0.00011162672024749239,0,0
9948,nbc,49,8.998618987453354e-05,49,0.00011162672024749239,0,0
10190,shifty,49,8.998618987453354e-05,49,0.00011162672024749239,0,0
10648,replace,49,8.998618987453354e-05,49,0.00011162672024749239,0,0
98,huge,48,8.814973701995123e-05,30,6.834288994744431e-05,18,0.0001705110595367783
330,@vp,48,8.814973701995123e-05,37,8.428956426851466e-05,11,0.0001042012030502534
448,gas,48,8.814973701995123e-05,34,7.745527527377023e-05,14,0.0001326197129730498
634,straight,48,8.814973701995123e-05,20,4.556192663162955e-05,28,0.0002652394259460996
803,impact,48,8.814973701995123e-05,36,8.201146793693318e-05,12,0.00011367403969118553
1037,executive,48,8.814973701995123e-05,43,9.795814225800353e-05,5,4.736418320466063e-05
1776,500,48,8.814973701995123e-05,45,0.00010251433492116647,3,2.8418509922796382e-05
1828,private,48,8.814973701995123e-05,22,5.01181192947925e-05,26,0.0002462937526642353
2200,supporter,48,8.814973701995123e-05,46,0.00010479243125274796,2,1.8945673281864254e-05
2354,completely,48,8.814973701995123e-05,44,0.000100236238589585,4,3.789134656372851e-05
3168,goes,48,8.814973701995123e-05,41,9.340194959484057e-05,7,6.63098564865249e-05
3284,due,48,8.814973701995123e-05,41,9.340194959484057e-05,7,6.63098564865249e-05
3535,mistake,48,8.814973701995123e-05,45,0.00010251433492116647,3,2.8418509922796382e-05
3575,1000,48,8.814973701995123e-05,38,8.656766060009614e-05,10,9.472836640932126e-05
4113,oval,48,8.814973701995123e-05,38,8.656766060009614e-05,10,9.472836640932126e-05
4707,elections,48,8.814973701995123e-05,40,9.11238532632591e-05,8,7.578269312745701e-05
4855,himself,48,8.814973701995123e-05,44,0.000100236238589585,4,3.789134656372851e-05
5412,convention,48,8.814973701995123e-05,39,8.884575693167761e-05,9,8.525552976838915e-05
5819,ice,48,8.814973701995123e-05,46,0.00010479243125274796,2,1.8945673281864254e-05
6322,records,48,8.814973701995123e-05,46,0.00010479243125274796,2,1.8945673281864254e-05
6933,kelly,48,8.814973701995123e-05,47,0.00010707052758432943,1,9.472836640932127e-06
8010,covid,48,8.814973701995123e-05,48,0.0001093486239159109,0,0
8224,sadly,48,8.814973701995123e-05,48,0.0001093486239159109,0,0
12913,mainstream,48,8.814973701995123e-05,48,0.0001093486239159109,0,0
464,serious,47,8.63132841653689e-05,35,7.97333716053517e-05,12,0.00011367403969118553
617,beyond,47,8.63132841653689e-05,43,9.795814225800353e-05,4,3.789134656372851e-05
753,spirit,47,8.63132841653689e-05,39,8.884575693167761e-05,8,7.578269312745701e-05
1290,write,47,8.63132841653689e-05,33,7.517717894218875e-05,14,0.0001326197129730498
1734,strength,47,8.63132841653689e-05,40,9.11238532632591e-05,7,6.63098564865249e-05
2480,poor,47,8.63132841653689e-05,43,9.795814225800353e-05,4,3.789134656372851e-05
2515,forever,47,8.63132841653689e-05,43,9.795814225800353e-05,4,3.789134656372851e-05
2826,6,47,8.63132841653689e-05,32,7.289908261060727e-05,15,0.0001420925496139819
3157,king,47,8.63132841653689e-05,37,8.428956426851466e-05,10,9.472836640932126e-05
3332,players,47,8.63132841653689e-05,46,0.00010479243125274796,1,9.472836640932127e-06
3495,9,47,8.63132841653689e-05,32,7.289908261060727e-05,15,0.0001420925496139819
3875,politicians,47,8.63132841653689e-05,38,8.656766060009614e-05,9,8.525552976838915e-05
4186,officers,47,8.63132841653689e-05,42,9.568004592642204e-05,5,4.736418320466063e-05
4267,star,47,8.63132841653689e-05,41,9.340194959484057e-05,6,5.6837019845592764e-05
4598,gov,47,8.63132841653689e-05,13,2.9615252310559205e-05,34,0.0003220764457916923
4661,consumer,47,8.63132841653689e-05,39,8.884575693167761e-05,8,7.578269312745701e-05
5139,vietnam,47,8.63132841653689e-05,46,0.00010479243125274796,1,9.472836640932127e-06
5565,statements,47,8.63132841653689e-05,45,0.00010251433492116647,2,1.8945673281864254e-05
5920,innocent,47,8.63132841653689e-05,44,0.000100236238589585,3,2.8418509922796382e-05
5977,exciting,47,8.63132841653689e-05,44,0.000100236238589585,3,2.8418509922796382e-05
6458,mitch,47,8.63132841653689e-05,46,0.00010479243125274796,1,9.472836640932127e-06
6631,matt,47,8.63132841653689e-05,46,0.00010479243125274796,1,9.472836640932127e-06
8151,pathetic,47,8.63132841653689e-05,47,0.00010707052758432943,0,0
8167,puppet,47,8.63132841653689e-05,47,0.00010707052758432943,0,0
8196,documents,47,8.63132841653689e-05,47,0.00010707052758432943,0,0
10266,fine,47,8.63132841653689e-05,47,0.00010707052758432943,0,0
10689,fisa,47,8.63132841653689e-05,47,0.00010707052758432943,0,0
28,ways,46,8.447683131078659e-05,27,6.150860095269988e-05,19,0.00017998389617771042
83,christmas,46,8.447683131078659e-05,26,5.923050462111841e-05,20,0.00018945673281864253
150,enter,46,8.447683131078659e-05,23,5.239621562637398e-05,23,0.00021787524274143893
181,effort,46,8.447683131078659e-05,35,7.97333716053517e-05,11,0.0001042012030502534
319,prevent,46,8.447683131078659e-05,10,2.2780963315814774e-05,36,0.0003410221190735566
1133,double,46,8.447683131078659e-05,23,5.239621562637398e-05,23,0.00021787524274143893
1162,often,46,8.447683131078659e-05,39,8.884575693167761e-05,7,6.63098564865249e-05
1518,income,46,8.447683131078659e-05,20,4.556192663162955e-05,26,0.0002462937526642353
1520,presidency,46,8.447683131078659e-05,43,9.795814225800353e-05,3,2.8418509922796382e-05
1920,dr,46,8.447683131078659e-05,34,7.745527527377023e-05,12,0.00011367403969118553
2312,remarks,46,8.447683131078659e-05,39,8.884575693167761e-05,7,6.63098564865249e-05
2517,held,46,8.447683131078659e-05,40,9.11238532632591e-05,6,5.6837019845592764e-05
2795,arrived,46,8.447683131078659e-05,44,0.000100236238589585,2,1.8945673281864254e-05
2997,cars,46,8.447683131078659e-05,34,7.745527527377023e-05,12,0.00011367403969118553
3229,pre-existing,46,8.447683131078659e-05,21,4.784002296321102e-05,25,0.0002368209160233032
3679,hero,46,8.447683131078659e-05,41,9.340194959484057e-05,5,4.736418320466063e-05
3683,background,46,8.447683131078659e-05,10,2.2780963315814774e-05,36,0.0003410221190735566
3923,#dontdoublemyrate,46,8.447683131078659e-05,0,0,46,0.00043575048548287785
4175,wars,46,8.447683131078659e-05,41,9.340194959484057e-05,5,4.736418320466063e-05
4222,abuse,46,8.447683131078659e-05,45,0.00010251433492116647,1,9.472836640932127e-06
4529,closed,46,8.447683131078659e-05,44,0.000100236238589585,2,1.8945673281864254e-05
8205,therefore,46,8.447683131078659e-05,46,0.00010479243125274796,0,0
8264,concerning,46,8.447683131078659e-05,46,0.00010479243125274796,0,0
9401,lying,46,8.447683131078659e-05,46,0.00010479243125274796,0,0
124,movement,45,8.264037845620428e-05,22,5.01181192947925e-05,23,0.00021787524274143893
679,#enoughalready,45,8.264037845620428e-05,0,0,45,0.00042627764884194575
1082,rid,45,8.264037845620428e-05,39,8.884575693167761e-05,6,5.6837019845592764e-05
1117,african,45,8.264037845620428e-05,40,9.11238532632591e-05,5,4.736418320466063e-05
1603,letter,45,8.264037845620428e-05,33,7.517717894218875e-05,12,0.00011367403969118553
1660,40,45,8.264037845620428e-05,25,5.695240828953693e-05,20,0.00018945673281864253
1865,begin,45,8.264037845620428e-05,35,7.97333716053517e-05,10,9.472836640932126e-05
2471,protection,45,8.264037845620428e-05,42,9.568004592642204e-05,3,2.8418509922796382e-05
2956,rebuilding,45,8.264037845620428e-05,37,8.428956426851466e-05,8,7.578269312745701e-05
3037,relief,45,8.264037845620428e-05,36,8.201146793693318e-05,9,8.525552976838915e-05
3506,program,45,8.264037845620428e-05,32,7.289908261060727e-05,13,0.00012314687633211766
4958,justices,45,8.264037845620428e-05,42,9.568004592642204e-05,3,2.8418509922796382e-05
5149,recently,45,8.264037845620428e-05,43,9.795814225800353e-05,2,1.8945673281864254e-05
5788,products,45,8.264037845620428e-05,42,9.568004592642204e-05,3,2.8418509922796382e-05
6838,wonder,45,8.264037845620428e-05,44,0.000100236238589585,1,9.472836640932127e-06
8745,j,45,8.264037845620428e-05,45,0.00010251433492116647,0,0
9054,portland,45,8.264037845620428e-05,45,0.00010251433492116647,0,0
7,miss,44,8.080392560162195e-05,16,3.644954130530364e-05,28,0.0002652394259460996
34,deadline,44,8.080392560162195e-05,6,1.3668577989488863e-05,38,0.00035996779235542085
772,pushing,44,8.080392560162195e-05,37,8.428956426851466e-05,7,6.63098564865249e-05
1009,worth,44,8.080392560162195e-05,25,5.695240828953693e-05,19,0.00017998389617771042
1093,child,44,8.080392560162195e-05,13,2.9615252310559205e-05,31,0.00029365793586889595
1127,stopped,44,8.080392560162195e-05,38,8.656766060009614e-05,6,5.6837019845592764e-05
1191,harder,44,8.080392560162195e-05,34,7.745527527377023e-05,10,9.472836640932126e-05
1351,loved,44,8.080392560162195e-05,32,7.289908261060727e-05,12,0.00011367403969118553
1369,partisan,44,8.080392560162195e-05,35,7.97333716053517e-05,9,8.525552976838915e-05
1407,tv,44,8.080392560162195e-05,38,8.656766060009614e-05,6,5.6837019845592764e-05
1458,holding,44,8.080392560162195e-05,31,7.06209862790258e-05,13,0.00012314687633211766
1597,march,44,8.080392560162195e-05,31,7.06209862790258e-05,13,0.00012314687633211766
1831,2014,44,8.080392560162195e-05,6,1.3668577989488863e-05,38,0.00035996779235542085
1922,promised,44,8.080392560162195e-05,26,5.923050462111841e-05,18,0.0001705110595367783
2392,condolences,44,8.080392560162195e-05,39,8.884575693167761e-05,5,4.736418320466063e-05
2558,protecting,44,8.080392560162195e-05,35,7.97333716053517e-05,9,8.525552976838915e-05
2655,memorial,44,8.080392560162195e-05,30,6.834288994744431e-05,14,0.0001326197129730498
4719,red,44,8.080392560162195e-05,36,8.201146793693318e-05,8,7.578269312745701e-05
4795,candidates,44,8.080392560162195e-05,35,7.97333716053517e-05,9,8.525552976838915e-05
5019,hell,44,8.080392560162195e-05,41,9.340194959484057e-05,3,2.8418509922796382e-05
5111,warren,44,8.080392560162195e-05,34,7.745527527377023e-05,10,9.472836640932126e-05
5805,pouring,44,8.080392560162195e-05,43,9.795814225800353e-05,1,9.472836640932127e-06
5804,outside,44,8.080392560162195e-05,42,9.568004592642204e-05,2,1.8945673281864254e-05
6334,rule,44,8.080392560162195e-05,36,8.201146793693318e-05,8,7.578269312745701e-05
7039,loser,44,8.080392560162195e-05,43,9.795814225800353e-05,1,9.472836640932127e-06
7288,landed,44,8.080392560162195e-05,43,9.795814225800353e-05,1,9.472836640932127e-06
8222,european,44,8.080392560162195e-05,44,0.000100236238589585,0,0
8503,witnesses,44,8.080392560162195e-05,44,0.000100236238589585,0,0
8797,testimony,44,8.080392560162195e-05,44,0.000100236238589585,0,0
8867,positive,44,8.080392560162195e-05,44,0.000100236238589585,0,0
9308,lisa,44,8.080392560162195e-05,44,0.000100236238589585,0,0
10183,amazon,44,8.080392560162195e-05,44,0.000100236238589585,0,0
49,fights,43,7.896747274703964e-05,34,7.745527527377023e-05,9,8.525552976838915e-05
249,threat,43,7.896747274703964e-05,21,4.784002296321102e-05,22,0.0002084024061005068
981,sanctions,43,7.896747274703964e-05,40,9.11238532632591e-05,3,2.8418509922796382e-05
1029,claims,43,7.896747274703964e-05,29,6.606479361586284e-05,14,0.0001326197129730498
1400,water,43,7.896747274703964e-05,37,8.428956426851466e-05,6,5.6837019845592764e-05
1696,loans,43,7.896747274703964e-05,3,6.8342889947444315e-06,40,0.00037891346563728506
1750,dropped,43,7.896747274703964e-05,39,8.884575693167761e-05,4,3.789134656372851e-05
2589,51,43,7.896747274703964e-05,37,8.428956426851466e-05,6,5.6837019845592764e-05
2784,afghanistan,43,7.896747274703964e-05,24,5.467431195795545e-05,19,0.00017998389617771042
2923,theyve,43,7.896747274703964e-05,36,8.201146793693318e-05,7,6.63098564865249e-05
3061,anymore,43,7.896747274703964e-05,39,8.884575693167761e-05,4,3.789134656372851e-05
3300,period,43,7.896747274703964e-05,37,8.428956426851466e-05,6,5.6837019845592764e-05
3592,navy,43,7.896747274703964e-05,41,9.340194959484057e-05,2,1.8945673281864254e-05
4195,millionaires,43,7.896747274703964e-05,0,0,43,0.0004073319755600815
4938,kept,43,7.896747274703964e-05,27,6.150860095269988e-05,16,0.00015156538625491403
5163,television,43,7.896747274703964e-05,41,9.340194959484057e-05,2,1.8945673281864254e-05
5351,nyc,43,7.896747274703964e-05,40,9.11238532632591e-05,3,2.8418509922796382e-05
5747,summit,43,7.896747274703964e-05,40,9.11238532632591e-05,3,2.8418509922796382e-05
6584,reports,43,7.896747274703964e-05,42,9.568004592642204e-05,1,9.472836640932127e-06
7074,wh,43,7.896747274703964e-05,41,9.340194959484057e-05,2,1.8945673281864254e-05
7953,prior,43,7.896747274703964e-05,43,9.795814225800353e-05,0,0
8469,product,43,7.896747274703964e-05,43,9.795814225800353e-05,0,0
11111,testify,43,7.896747274703964e-05,43,9.795814225800353e-05,0,0
13989,kavanaugh,43,7.896747274703964e-05,43,9.795814225800353e-05,0,0
162,travel,42,7.713101989245731e-05,38,8.656766060009614e-05,4,3.789134656372851e-05
203,trip,42,7.713101989245731e-05,30,6.834288994744431e-05,12,0.00011367403969118553
271,equality,42,7.713101989245731e-05,5,1.1390481657907387e-05,37,0.0003504949557144887
531,plans,42,7.713101989245731e-05,19,4.328383030004807e-05,23,0.00021787524274143893
642,joke,42,7.713101989245731e-05,38,8.656766060009614e-05,4,3.789134656372851e-05
1214,feel,42,7.713101989245731e-05,32,7.289908261060727e-05,10,9.472836640932126e-05
1530,solve,42,7.713101989245731e-05,31,7.06209862790258e-05,11,0.0001042012030502534
1705,anybody,42,7.713101989245731e-05,35,7.97333716053517e-05,7,6.63098564865249e-05
1736,form,42,7.713101989245731e-05,36,8.201146793693318e-05,6,5.6837019845592764e-05
1952,average,42,7.713101989245731e-05,15,3.417144497372216e-05,27,0.0002557665893051674
2484,myself,42,7.713101989245731e-05,39,8.884575693167761e-05,3,2.8418509922796382e-05
2494,wrote,42,7.713101989245731e-05,37,8.428956426851466e-05,5,4.736418320466063e-05
2680,member,42,7.713101989245731e-05,31,7.06209862790258e-05,11,0.0001042012030502534
2717,friday,42,7.713101989245731e-05,28,6.378669728428137e-05,14,0.0001326197129730498
2758,son,42,7.713101989245731e-05,35,7.97333716053517e-05,7,6.63098564865249e-05
4244,refuses,42,7.713101989245731e-05,37,8.428956426851466e-05,5,4.736418320466063e-05
4344,photo,42,7.713101989245731e-05,7,1.5946674321070342e-05,35,0.0003315492824326244
4371,barack,42,7.713101989245731e-05,17,3.8727637636885116e-05,25,0.0002368209160233032
4531,waiting,42,7.713101989245731e-05,39,8.884575693167761e-05,3,2.8418509922796382e-05
4950,promises,42,7.713101989245731e-05,36,8.201146793693318e-05,6,5.6837019845592764e-05
4998,subject,42,7.713101989245731e-05,40,9.11238532632591e-05,2,1.8945673281864254e-05
7926,lied,42,7.713101989245731e-05,42,9.568004592642204e-05,0,0
8005,section,42,7.713101989245731e-05,42,9.568004592642204e-05,0,0
8331,terrific,42,7.713101989245731e-05,42,9.568004592642204e-05,0,0
8654,gdp,42,7.713101989245731e-05,42,9.568004592642204e-05,0,0
8915,regulations,42,7.713101989245731e-05,42,9.568004592642204e-05,0,0
8944,ventilators,42,7.713101989245731e-05,42,9.568004592642204e-05,0,0
9925,@realdonaldtrump,42,7.713101989245731e-05,42,9.568004592642204e-05,0,0
9941,2018,42,7.713101989245731e-05,42,9.568004592642204e-05,0,0
27,thinking,41,7.5294567037875e-05,37,8.428956426851466e-05,4,3.789134656372851e-05
197,turning,41,7.5294567037875e-05,31,7.06209862790258e-05,10,9.472836640932126e-05
317,efforts,41,7.5294567037875e-05,25,5.695240828953693e-05,16,0.00015156538625491403
892,raised,41,7.5294567037875e-05,22,5.01181192947925e-05,19,0.00017998389617771042
1412,slow,41,7.5294567037875e-05,38,8.656766060009614e-05,3,2.8418509922796382e-05
1933,saw,41,7.5294567037875e-05,34,7.745527527377023e-05,7,6.63098564865249e-05
1997,ones,41,7.5294567037875e-05,30,6.834288994744431e-05,11,0.0001042012030502534
3248,#immigration,41,7.5294567037875e-05,0,0,41,0.0003883863022782172
3510,ended,41,7.5294567037875e-05,35,7.97333716053517e-05,6,5.6837019845592764e-05
3973,anthem,41,7.5294567037875e-05,40,9.11238532632591e-05,1,9.472836640932127e-06
6481,standard,41,7.5294567037875e-05,39,8.884575693167761e-05,2,1.8945673281864254e-05
6997,mention,41,7.5294567037875e-05,40,9.11238532632591e-05,1,9.472836640932127e-06
7890,county,41,7.5294567037875e-05,41,9.340194959484057e-05,0,0
7916,amounts,41,7.5294567037875e-05,41,9.340194959484057e-05,0,0
8474,played,41,7.5294567037875e-05,41,9.340194959484057e-05,0,0
8616,msdnc,41,7.5294567037875e-05,41,9.340194959484057e-05,0,0
9399,harassment,41,7.5294567037875e-05,41,9.340194959484057e-05,0,0
9785,brian,41,7.5294567037875e-05,41,9.340194959484057e-05,0,0
9949,negotiations,41,7.5294567037875e-05,41,9.340194959484057e-05,0,0
10759,transcripts,41,7.5294567037875e-05,41,9.340194959484057e-05,0,0
13239,russians,41,7.5294567037875e-05,41,9.340194959484057e-05,0,0
573,matters,40,7.345811418329269e-05,17,3.8727637636885116e-05,23,0.00021787524274143893
1268,path,40,7.345811418329269e-05,30,6.834288994744431e-05,10,9.472836640932126e-05
1469,discussed,40,7.345811418329269e-05,39,8.884575693167761e-05,1,9.472836640932127e-06
1757,throughout,40,7.345811418329269e-05,38,8.656766060009614e-05,2,1.8945673281864254e-05
1848,speaks,40,7.345811418329269e-05,10,2.2780963315814774e-05,30,0.0002841850992279638
1853,95,40,7.345811418329269e-05,36,8.201146793693318e-05,4,3.789134656372851e-05
2000,source,40,7.345811418329269e-05,34,7.745527527377023e-05,6,5.6837019845592764e-05
2591,payments,40,7.345811418329269e-05,36,8.201146793693318e-05,4,3.789134656372851e-05
2819,medical,40,7.345811418329269e-05,34,7.745527527377023e-05,6,5.6837019845592764e-05
3663,provide,40,7.345811418329269e-05,28,6.378669728428137e-05,12,0.00011367403969118553
3841,barriers,40,7.345811418329269e-05,38,8.656766060009614e-05,2,1.8945673281864254e-05
5190,area,40,7.345811418329269e-05,38,8.656766060009614e-05,2,1.8945673281864254e-05
5976,afternoon,40,7.345811418329269e-05,35,7.97333716053517e-05,5,4.736418320466063e-05
6545,miles,40,7.345811418329269e-05,39,8.884575693167761e-05,1,9.472836640932127e-06
7025,fema,40,7.345811418329269e-05,37,8.428956426851466e-05,3,2.8418509922796382e-05
7405,result,40,7.345811418329269e-05,39,8.884575693167761e-05,1,9.472836640932127e-06
7986,#2a,40,7.345811418329269e-05,40,9.11238532632591e-05,0,0
8001,@senatemajldr,40,7.345811418329269e-05,40,9.11238532632591e-05,0,0
8169,spied,40,7.345811418329269e-05,40,9.11238532632591e-05,0,0
8327,cryin,40,7.345811418329269e-05,40,9.11238532632591e-05,0,0
8365,800,40,7.345811418329269e-05,40,9.11238532632591e-05,0,0
8880,classified,40,7.345811418329269e-05,40,9.11238532632591e-05,0,0
9344,@ingrahamangle,40,7.345811418329269e-05,40,9.11238532632591e-05,0,0
9564,strzok,40,7.345811418329269e-05,40,9.11238532632591e-05,0,0
9684,short,40,7.345811418329269e-05,40,9.11238532632591e-05,0,0
10255,minneapolis,40,7.345811418329269e-05,40,9.11238532632591e-05,0,0
11239,putin,40,7.345811418329269e-05,40,9.11238532632591e-05,0,0
752,september,39,7.162166132871037e-05,30,6.834288994744431e-05,9,8.525552976838915e-05
747,11,39,7.162166132871037e-05,25,5.695240828953693e-05,14,0.0001326197129730498
768,toward,39,7.162166132871037e-05,25,5.695240828953693e-05,14,0.0001326197129730498
1005,celebrating,39,7.162166132871037e-05,18,4.100573396846659e-05,21,0.00019892956945957466
1166,land,39,7.162166132871037e-05,35,7.97333716053517e-05,4,3.789134656372851e-05
1210,all-time,39,7.162166132871037e-05,37,8.428956426851466e-05,2,1.8945673281864254e-05
1354,return,39,7.162166132871037e-05,33,7.517717894218875e-05,6,5.6837019845592764e-05
1682,supporting,39,7.162166132871037e-05,20,4.556192663162955e-05,19,0.00017998389617771042
1780,speaker,39,7.162166132871037e-05,36,8.201146793693318e-05,3,2.8418509922796382e-05
1793,opening,39,7.162166132871037e-05,34,7.745527527377023e-05,5,4.736418320466063e-05
2501,june,39,7.162166132871037e-05,33,7.517717894218875e-05,6,5.6837019845592764e-05
2510,apologize,39,7.162166132871037e-05,38,8.656766060009614e-05,1,9.472836640932127e-06
3126,showing,39,7.162166132871037e-05,36,8.201146793693318e-05,3,2.8418509922796382e-05
3264,prescription,39,7.162166132871037e-05,29,6.606479361586284e-05,10,9.472836640932126e-05
3393,learn,39,7.162166132871037e-05,24,5.467431195795545e-05,15,0.0001420925496139819
3690,services,39,7.162166132871037e-05,20,4.556192663162955e-05,19,0.00017998389617771042
4112,roger,39,7.162166132871037e-05,38,8.656766060009614e-05,1,9.472836640932127e-06
4311,s,39,7.162166132871037e-05,36,8.201146793693318e-05,3,2.8418509922796382e-05
4373,-bo,39,7.162166132871037e-05,0,0,39,0.00036944062899635295
4392,vp,39,7.162166132871037e-05,24,5.467431195795545e-05,15,0.0001420925496139819
4632,hampshire,39,7.162166132871037e-05,35,7.97333716053517e-05,4,3.789134656372851e-05
4775,conservative,39,7.162166132871037e-05,33,7.517717894218875e-05,6,5.6837019845592764e-05
5160,missing,39,7.162166132871037e-05,37,8.428956426851466e-05,2,1.8945673281864254e-05
5236,soldiers,39,7.162166132871037e-05,38,8.656766060009614e-05,1,9.472836640932127e-06
5444,elizabeth,39,7.162166132871037e-05,35,7.97333716053517e-05,4,3.789134656372851e-05
5916,talented,39,7.162166132871037e-05,37,8.428956426851466e-05,2,1.8945673281864254e-05
6889,informed,39,7.162166132871037e-05,38,8.656766060009614e-05,1,9.472836640932127e-06
7645,allowing,39,7.162166132871037e-05,37,8.428956426851466e-05,2,1.8945673281864254e-05
7681,unable,39,7.162166132871037e-05,38,8.656766060009614e-05,1,9.472836640932127e-06
7768,terrorist,39,7.162166132871037e-05,38,8.656766060009614e-05,1,9.472836640932127e-06
7936,vaccine,39,7.162166132871037e-05,39,8.884575693167761e-05,0,0
8027,@briankempga,39,7.162166132871037e-05,39,8.884575693167761e-05,0,0
8088,pence,39,7.162166132871037e-05,39,8.884575693167761e-05,0,0
8390,drain,39,7.162166132871037e-05,39,8.884575693167761e-05,0,0
8490,gang,39,7.162166132871037e-05,39,8.884575693167761e-05,0,0
8846,numerous,39,7.162166132871037e-05,39,8.884575693167761e-05,0,0
9635,disgusting,39,7.162166132871037e-05,39,8.884575693167761e-05,0,0
9679,vicious,39,7.162166132871037e-05,39,8.884575693167761e-05,0,0
9940,2017,39,7.162166132871037e-05,39,8.884575693167761e-05,0,0
10615,golf,39,7.162166132871037e-05,39,8.884575693167761e-05,0,0
10825,sessions,39,7.162166132871037e-05,39,8.884575693167761e-05,0,0
11022,ambassador,39,7.162166132871037e-05,39,8.884575693167761e-05,0,0
327,hasnt,38,6.978520847412805e-05,29,6.606479361586284e-05,9,8.525552976838915e-05
532,remain,38,6.978520847412805e-05,33,7.517717894218875e-05,5,4.736418320466063e-05
621,refuse,38,6.978520847412805e-05,30,6.834288994744431e-05,8,7.578269312745701e-05
731,listen,38,6.978520847412805e-05,26,5.923050462111841e-05,12,0.00011367403969118553
876,favor,38,6.978520847412805e-05,31,7.06209862790258e-05,7,6.63098564865249e-05
1043,fairly,38,6.978520847412805e-05,34,7.745527527377023e-05,4,3.789134656372851e-05
1085,reach,38,6.978520847412805e-05,15,3.417144497372216e-05,23,0.00021787524274143893
1274,courts,38,6.978520847412805e-05,34,7.745527527377023e-05,4,3.789134656372851e-05
1307,doubt,38,6.978520847412805e-05,34,7.745527527377023e-05,4,3.789134656372851e-05
1486,near,38,6.978520847412805e-05,26,5.923050462111841e-05,12,0.00011367403969118553
1521,16,38,6.978520847412805e-05,29,6.606479361586284e-05,9,8.525552976838915e-05
1763,six,38,6.978520847412805e-05,22,5.01181192947925e-05,16,0.00015156538625491403
2097,rick,38,6.978520847412805e-05,37,8.428956426851466e-05,1,9.472836640932127e-06
2285,current,38,6.978520847412805e-05,31,7.06209862790258e-05,7,6.63098564865249e-05
2306,break,38,6.978520847412805e-05,29,6.606479361586284e-05,9,8.525552976838915e-05
2917,signing,38,6.978520847412805e-05,31,7.06209862790258e-05,7,6.63098564865249e-05
3118,2012,38,6.978520847412805e-05,1,2.2780963315814773e-06,37,0.0003504949557144887
3158,luther,38,6.978520847412805e-05,33,7.517717894218875e-05,5,4.736418320466063e-05
3317,#abetterbargain,38,6.978520847412805e-05,0,0,38,0.00035996779235542085
4013,tweet,38,6.978520847412805e-05,11,2.505905964739625e-05,27,0.0002557665893051674
4272,inflation,38,6.978520847412805e-05,37,8.428956426851466e-05,1,9.472836640932127e-06
4509,bush,38,6.978520847412805e-05,34,7.745527527377023e-05,4,3.789134656372851e-05
5409,prosperity,38,6.978520847412805e-05,33,7.517717894218875e-05,5,4.736418320466063e-05
7613,destroyed,38,6.978520847412805e-05,37,8.428956426851466e-05,1,9.472836640932127e-06
7818,usual,38,6.978520847412805e-05,37,8.428956426851466e-05,1,9.472836640932127e-06
8129,#maga🇺🇸,38,6.978520847412805e-05,38,8.656766060009614e-05,0,0
8194,scale,38,6.978520847412805e-05,38,8.656766060009614e-05,0,0
8899,protesters,38,6.978520847412805e-05,38,8.656766060009614e-05,0,0
9280,doj,38,6.978520847412805e-05,38,8.656766060009614e-05,0,0
9650,con,38,6.978520847412805e-05,38,8.656766060009614e-05,0,0
9874,hits,38,6.978520847412805e-05,38,8.656766060009614e-05,0,0
252,hands,37,6.794875561954574e-05,28,6.378669728428137e-05,9,8.525552976838915e-05
865,july,37,6.794875561954574e-05,25,5.695240828953693e-05,12,0.00011367403969118553
1020,largest,37,6.794875561954574e-05,30,6.834288994744431e-05,7,6.63098564865249e-05
1227,2000,37,6.794875561954574e-05,25,5.695240828953693e-05,12,0.00011367403969118553
1238,ideas,37,6.794875561954574e-05,18,4.100573396846659e-05,19,0.00017998389617771042
1257,#immigrationaction,37,6.794875561954574e-05,0,0,37,0.0003504949557144887
1894,worker,37,6.794875561954574e-05,28,6.378669728428137e-05,9,8.525552976838915e-05
3057,george,37,6.794875561954574e-05,30,6.834288994744431e-05,7,6.63098564865249e-05
3183,room,37,6.794875561954574e-05,32,7.289908261060727e-05,5,4.736418320466063e-05
3256,expected,37,6.794875561954574e-05,35,7.97333716053517e-05,2,1.8945673281864254e-05
3556,broke,37,6.794875561954574e-05,32,7.289908261060727e-05,5,4.736418320466063e-05
3684,checks,37,6.794875561954574e-05,11,2.505905964739625e-05,26,0.0002462937526642353
3848,difficult,37,6.794875561954574e-05,35,7.97333716053517e-05,2,1.8945673281864254e-05
4148,popular,37,6.794875561954574e-05,35,7.97333716053517e-05,2,1.8945673281864254e-05
4268,spy,37,6.794875561954574e-05,35,7.97333716053517e-05,2,1.8945673281864254e-05
4542,jay,37,6.794875561954574e-05,32,7.289908261060727e-05,5,4.736418320466063e-05
5275,nfl,37,6.794875561954574e-05,36,8.201146793693318e-05,1,9.472836640932127e-06
5378,likes,37,6.794875561954574e-05,36,8.201146793693318e-05,1,9.472836640932127e-06
5781,blame,37,6.794875561954574e-05,36,8.201146793693318e-05,1,9.472836640932127e-06
6169,regulation,37,6.794875561954574e-05,35,7.97333716053517e-05,2,1.8945673281864254e-05
6343,named,37,6.794875561954574e-05,36,8.201146793693318e-05,1,9.472836640932127e-06
7168,mississippi,37,6.794875561954574e-05,36,8.201146793693318e-05,1,9.472836640932127e-06
9478,mcconnell,37,6.794875561954574e-05,37,8.428956426851466e-05,0,0
9654,counsel,37,6.794875561954574e-05,37,8.428956426851466e-05,0,0
10403,don,37,6.794875561954574e-05,37,8.428956426851466e-05,0,0
468,breaking,36,6.611230276496342e-05,32,7.289908261060727e-05,4,3.789134656372851e-05
758,#collegeopportunity,36,6.611230276496342e-05,0,0,36,0.0003410221190735566
774,among,36,6.611230276496342e-05,31,7.06209862790258e-05,5,4.736418320466063e-05
879,living,36,6.611230276496342e-05,18,4.100573396846659e-05,18,0.0001705110595367783
1052,prison,36,6.611230276496342e-05,32,7.289908261060727e-05,4,3.789134656372851e-05
1129,60,36,6.611230276496342e-05,26,5.923050462111841e-05,10,9.472836640932126e-05
1176,luck,36,6.611230276496342e-05,30,6.834288994744431e-05,6,5.6837019845592764e-05
1180,faster,36,6.611230276496342e-05,29,6.606479361586284e-05,7,6.63098564865249e-05
1232,strongest,36,6.611230276496342e-05,30,6.834288994744431e-05,6,5.6837019845592764e-05
1260,comprehensive,36,6.611230276496342e-05,11,2.505905964739625e-05,25,0.0002368209160233032
1297,constitution,36,6.611230276496342e-05,33,7.517717894218875e-05,3,2.8418509922796382e-05
1326,shooting,36,6.611230276496342e-05,32,7.289908261060727e-05,4,3.789134656372851e-05
1449,field,36,6.611230276496342e-05,26,5.923050462111841e-05,10,9.472836640932126e-05
1640,accomplished,36,6.611230276496342e-05,32,7.289908261060727e-05,4,3.789134656372851e-05
1802,century,36,6.611230276496342e-05,18,4.100573396846659e-05,18,0.0001705110595367783
1900,restore,36,6.611230276496342e-05,21,4.784002296321102e-05,15,0.0001420925496139819
2079,values,36,6.611230276496342e-05,25,5.695240828953693e-05,11,0.0001042012030502534
2427,imagine,36,6.611230276496342e-05,29,6.606479361586284e-05,7,6.63098564865249e-05
2525,count,36,6.611230276496342e-05,28,6.378669728428137e-05,8,7.578269312745701e-05
3016,heart,36,6.611230276496342e-05,28,6.378669728428137e-05,8,7.578269312745701e-05
3085,simply,36,6.611230276496342e-05,27,6.150860095269988e-05,9,8.525552976838915e-05
3670,football,36,6.611230276496342e-05,33,7.517717894218875e-05,3,2.8418509922796382e-05
3968,forgotten,36,6.611230276496342e-05,29,6.606479361586284e-05,7,6.63098564865249e-05
4118,weapons,36,6.611230276496342e-05,30,6.834288994744431e-05,6,5.6837019845592764e-05
4380,vice,36,6.611230276496342e-05,27,6.150860095269988e-05,9,8.525552976838915e-05
4670,green,36,6.611230276496342e-05,27,6.150860095269988e-05,9,8.525552976838915e-05
4802,crowds,36,6.611230276496342e-05,35,7.97333716053517e-05,1,9.472836640932127e-06
5078,winner,36,6.611230276496342e-05,34,7.745527527377023e-05,2,1.8945673281864254e-05
5237,payroll,36,6.611230276496342e-05,15,3.417144497372216e-05,21,0.00019892956945957466
6647,response,36,6.611230276496342e-05,31,7.06209862790258e-05,5,4.736418320466063e-05
6674,headed,36,6.611230276496342e-05,31,7.06209862790258e-05,5,4.736418320466063e-05
7942,inaccurate,36,6.611230276496342e-05,36,8.201146793693318e-05,0,0
10289,saudi,36,6.611230276496342e-05,36,8.201146793693318e-05,0,0
10307,funds,36,6.611230276496342e-05,36,8.201146793693318e-05,0,0
10395,abe,36,6.611230276496342e-05,36,8.201146793693318e-05,0,0
16,youll,35,6.42758499103811e-05,10,2.2780963315814774e-05,25,0.0002368209160233032
465,wanting,35,6.42758499103811e-05,32,7.289908261060727e-05,3,2.8418509922796382e-05
840,counting,35,6.42758499103811e-05,19,4.328383030004807e-05,16,0.00015156538625491403
860,voices,35,6.42758499103811e-05,13,2.9615252310559205e-05,22,0.0002084024061005068
1090,sense,35,6.42758499103811e-05,21,4.784002296321102e-05,14,0.0001326197129730498
1311,benefits,35,6.42758499103811e-05,17,3.8727637636885116e-05,18,0.0001705110595367783
1368,lgbt,35,6.42758499103811e-05,3,6.8342889947444315e-06,32,0.00030313077250982806
1528,impossible,35,6.42758499103811e-05,33,7.517717894218875e-05,2,1.8945673281864254e-05
1548,actions,35,6.42758499103811e-05,28,6.378669728428137e-05,7,6.63098564865249e-05
1692,board,35,6.42758499103811e-05,31,7.06209862790258e-05,4,3.789134656372851e-05
1792,markets,35,6.42758499103811e-05,31,7.06209862790258e-05,4,3.789134656372851e-05
1868,fellow,35,6.42758499103811e-05,18,4.100573396846659e-05,17,0.00016103822289584616
1883,veteran,35,6.42758499103811e-05,24,5.467431195795545e-05,11,0.0001042012030502534
1914,creating,35,6.42758499103811e-05,19,4.328383030004807e-05,16,0.00015156538625491403
2272,unprecedented,35,6.42758499103811e-05,32,7.289908261060727e-05,3,2.8418509922796382e-05
2325,explain,35,6.42758499103811e-05,30,6.834288994744431e-05,5,4.736418320466063e-05
2521,chicago,35,6.42758499103811e-05,23,5.239621562637398e-05,12,0.00011367403969118553
2631,currently,35,6.42758499103811e-05,30,6.834288994744431e-05,5,4.736418320466063e-05
2799,coast,35,6.42758499103811e-05,29,6.606479361586284e-05,6,5.6837019845592764e-05
3688,receive,35,6.42758499103811e-05,25,5.695240828953693e-05,10,9.472836640932126e-05
4054,tech,35,6.42758499103811e-05,34,7.745527527377023e-05,1,9.472836640932127e-06
4161,#aca,35,6.42758499103811e-05,0,0,35,0.0003315492824326244
4447,deep,35,6.42758499103811e-05,32,7.289908261060727e-05,3,2.8418509922796382e-05
4665,powell,35,6.42758499103811e-05,32,7.289908261060727e-05,3,2.8418509922796382e-05
4675,bloomberg,35,6.42758499103811e-05,34,7.745527527377023e-05,1,9.472836640932127e-06
4782,partner,35,6.42758499103811e-05,32,7.289908261060727e-05,3,2.8418509922796382e-05
4805,richard,35,6.42758499103811e-05,29,6.606479361586284e-05,6,5.6837019845592764e-05
4858,exactly,35,6.42758499103811e-05,30,6.834288994744431e-05,5,4.736418320466063e-05
4907,tonights,35,6.42758499103811e-05,8,1.822477065265182e-05,27,0.0002557665893051674
5304,returned,35,6.42758499103811e-05,33,7.517717894218875e-05,2,1.8945673281864254e-05
5778,transparency,35,6.42758499103811e-05,32,7.289908261060727e-05,3,2.8418509922796382e-05
5891,opposite,35,6.42758499103811e-05,33,7.517717894218875e-05,2,1.8945673281864254e-05
7414,approve,35,6.42758499103811e-05,34,7.745527527377023e-05,1,9.472836640932127e-06
8240,swing,35,6.42758499103811e-05,35,7.97333716053517e-05,0,0
8346,seems,35,6.42758499103811e-05,35,7.97333716053517e-05,0,0
8720,properly,35,6.42758499103811e-05,35,7.97333716053517e-05,0,0
8956,rapidly,35,6.42758499103811e-05,35,7.97333716053517e-05,0,0
9126,nafta,35,6.42758499103811e-05,35,7.97333716053517e-05,0,0
9221,substantially,35,6.42758499103811e-05,35,7.97333716053517e-05,0,0
9371,according,35,6.42758499103811e-05,35,7.97333716053517e-05,0,0
10158,lou,35,6.42758499103811e-05,35,7.97333716053517e-05,0,0
11329,jerry,35,6.42758499103811e-05,35,7.97333716053517e-05,0,0
11363,pro,35,6.42758499103811e-05,35,7.97333716053517e-05,0,0
12188,haters,35,6.42758499103811e-05,35,7.97333716053517e-05,0,0
414,carbon,34,6.243939705579878e-05,5,1.1390481657907387e-05,29,0.0002747122625870317
421,pollution,34,6.243939705579878e-05,2,4.556192663162955e-06,32,0.00030313077250982806
577,sales,34,6.243939705579878e-05,10,2.2780963315814774e-05,24,0.00022734807938237106
740,yours,34,6.243939705579878e-05,7,1.5946674321070342e-05,27,0.0002557665893051674
812,front,34,6.243939705579878e-05,26,5.923050462111841e-05,8,7.578269312745701e-05
873,safer,34,6.243939705579878e-05,21,4.784002296321102e-05,13,0.00012314687633211766
1190,fairness,34,6.243939705579878e-05,22,5.01181192947925e-05,12,0.00011367403969118553
1291,alone,34,6.243939705579878e-05,25,5.695240828953693e-05,9,8.525552976838915e-05
1315,19,34,6.243939705579878e-05,28,6.378669728428137e-05,6,5.6837019845592764e-05
1557,choose,34,6.243939705579878e-05,12,2.7337155978977726e-05,22,0.0002084024061005068
1745,places,34,6.243939705579878e-05,33,7.517717894218875e-05,1,9.472836640932127e-06
1962,tougher,34,6.243939705579878e-05,31,7.06209862790258e-05,3,2.8418509922796382e-05
1995,pick,34,6.243939705579878e-05,15,3.417144497372216e-05,19,0.00017998389617771042
2113,joint,34,6.243939705579878e-05,32,7.289908261060727e-05,2,1.8945673281864254e-05
2346,somebody,34,6.243939705579878e-05,29,6.606479361586284e-05,5,4.736418320466063e-05
2410,areas,34,6.243939705579878e-05,31,7.06209862790258e-05,3,2.8418509922796382e-05
2594,position,34,6.243939705579878e-05,32,7.289908261060727e-05,2,1.8945673281864254e-05
2992,super,34,6.243939705579878e-05,31,7.06209862790258e-05,3,2.8418509922796382e-05
3231,missouri,34,6.243939705579878e-05,29,6.606479361586284e-05,5,4.736418320466063e-05
3455,delay,34,6.243939705579878e-05,30,6.834288994744431e-05,4,3.789134656372851e-05
3468,jersey,34,6.243939705579878e-05,31,7.06209862790258e-05,3,2.8418509922796382e-05
3541,unless,34,6.243939705579878e-05,28,6.378669728428137e-05,6,5.6837019845592764e-05
3676,guns,34,6.243939705579878e-05,25,5.695240828953693e-05,9,8.525552976838915e-05
4046,stuff,34,6.243939705579878e-05,32,7.289908261060727e-05,2,1.8945673281864254e-05
4097,loss,34,6.243939705579878e-05,30,6.834288994744431e-05,4,3.789134656372851e-05
4275,cover,34,6.243939705579878e-05,27,6.150860095269988e-05,7,6.63098564865249e-05
4759,oh,34,6.243939705579878e-05,31,7.06209862790258e-05,3,2.8418509922796382e-05
6611,host,34,6.243939705579878e-05,31,7.06209862790258e-05,3,2.8418509922796382e-05
7399,giant,34,6.243939705579878e-05,32,7.289908261060727e-05,2,1.8945673281864254e-05
8168,sean,34,6.243939705579878e-05,34,7.745527527377023e-05,0,0
8488,hearings,34,6.243939705579878e-05,34,7.745527527377023e-05,0,0
8968,meantime,34,6.243939705579878e-05,34,7.745527527377023e-05,0,0
8994,journal,34,6.243939705579878e-05,34,7.745527527377023e-05,0,0
11509,discredited,34,6.243939705579878e-05,34,7.745527527377023e-05,0,0
42,global,33,6.060294420121647e-05,13,2.9615252310559205e-05,20,0.00018945673281864253
248,terrorism,33,6.060294420121647e-05,29,6.606479361586284e-05,4,3.789134656372851e-05
282,discuss,33,6.060294420121647e-05,28,6.378669728428137e-05,5,4.736418320466063e-05
287,international,33,6.060294420121647e-05,27,6.150860095269988e-05,6,5.6837019845592764e-05
300,thanksgiving,33,6.060294420121647e-05,23,5.239621562637398e-05,10,9.472836640932126e-05
294,#getcovered,33,6.060294420121647e-05,0,0,33,0.0003126036091507602
368,might,33,6.060294420121647e-05,14,3.1893348642140685e-05,19,0.00017998389617771042
428,90,33,6.060294420121647e-05,22,5.01181192947925e-05,11,0.0001042012030502534
530,parents,33,6.060294420121647e-05,10,2.2780963315814774e-05,23,0.00021787524274143893
588,steps,33,6.060294420121647e-05,8,1.822477065265182e-05,25,0.0002368209160233032
692,extend,33,6.060294420121647e-05,6,1.3668577989488863e-05,27,0.0002557665893051674
824,official,33,6.060294420121647e-05,25,5.695240828953693e-05,8,7.578269312745701e-05
845,easier,33,6.060294420121647e-05,26,5.923050462111841e-05,7,6.63098564865249e-05
916,democracy,33,6.060294420121647e-05,22,5.01181192947925e-05,11,0.0001042012030502534
1136,folks,33,6.060294420121647e-05,6,1.3668577989488863e-05,27,0.0002557665893051674
1761,homeland,33,6.060294420121647e-05,29,6.606479361586284e-05,4,3.789134656372851e-05
1810,premiums,33,6.060294420121647e-05,21,4.784002296321102e-05,12,0.00011367403969118553
1971,changes,33,6.060294420121647e-05,28,6.378669728428137e-05,5,4.736418320466063e-05
2021,starts,33,6.060294420121647e-05,19,4.328383030004807e-05,14,0.0001326197129730498
2053,games,33,6.060294420121647e-05,23,5.239621562637398e-05,10,9.472836640932126e-05
2150,ensure,33,6.060294420121647e-05,22,5.01181192947925e-05,11,0.0001042012030502534
3048,refused,33,6.060294420121647e-05,27,6.150860095269988e-05,6,5.6837019845592764e-05
3259,democratic,33,6.060294420121647e-05,27,6.150860095269988e-05,6,5.6837019845592764e-05
3450,hardworking,33,6.060294420121647e-05,31,7.06209862790258e-05,2,1.8945673281864254e-05
3524,caused,33,6.060294420121647e-05,30,6.834288994744431e-05,3,2.8418509922796382e-05
3634,wealth,33,6.060294420121647e-05,31,7.06209862790258e-05,2,1.8945673281864254e-05
3776,august,33,6.060294420121647e-05,29,6.606479361586284e-05,4,3.789134656372851e-05
3950,attacks,33,6.060294420121647e-05,25,5.695240828953693e-05,8,7.578269312745701e-05
4230,dumb,33,6.060294420121647e-05,32,7.289908261060727e-05,1,9.472836640932127e-06
4279,honest,33,6.060294420121647e-05,31,7.06209862790258e-05,2,1.8945673281864254e-05
4446,excuse,33,6.060294420121647e-05,29,6.606479361586284e-05,4,3.789134656372851e-05
4532,colorado,33,6.060294420121647e-05,27,6.150860095269988e-05,6,5.6837019845592764e-05
4652,ads,33,6.060294420121647e-05,31,7.06209862790258e-05,2,1.8945673281864254e-05
4997,firm,33,6.060294420121647e-05,14,3.1893348642140685e-05,19,0.00017998389617771042
5404,nomination,33,6.060294420121647e-05,31,7.06209862790258e-05,2,1.8945673281864254e-05
5761,council,33,6.060294420121647e-05,30,6.834288994744431e-05,3,2.8418509922796382e-05
6266,#dinnerwithbarack,33,6.060294420121647e-05,0,0,33,0.0003126036091507602
7396,patriot,33,6.060294420121647e-05,32,7.289908261060727e-05,1,9.472836640932127e-06
8089,230,33,6.060294420121647e-05,33,7.517717894218875e-05,0,0
8170,sooo,33,6.060294420121647e-05,33,7.517717894218875e-05,0,0
8209,fracking,33,6.060294420121647e-05,33,7.517717894218875e-05,0,0
9108,@marklevinshow,33,6.060294420121647e-05,33,7.517717894218875e-05,0,0
10451,hatred,33,6.060294420121647e-05,33,7.517717894218875e-05,0,0
10613,dow,33,6.060294420121647e-05,33,7.517717894218875e-05,0,0
10979,charges,33,6.060294420121647e-05,33,7.517717894218875e-05,0,0
11914,ig,33,6.060294420121647e-05,33,7.517717894218875e-05,0,0
15811,conflicted,33,6.060294420121647e-05,33,7.517717894218875e-05,0,0
171,generation,32,5.876649134663415e-05,5,1.1390481657907387e-05,27,0.0002557665893051674
698,wishes,32,5.876649134663415e-05,18,4.100573396846659e-05,14,0.0001326197129730498
704,@washingtonpost,32,5.876649134663415e-05,27,6.150860095269988e-05,5,4.736418320466063e-05
716,becoming,32,5.876649134663415e-05,29,6.606479361586284e-05,3,2.8418509922796382e-05
759,available,32,5.876649134663415e-05,25,5.695240828953693e-05,7,6.63098564865249e-05
967,none,32,5.876649134663415e-05,28,6.378669728428137e-05,4,3.789134656372851e-05
1023,study,32,5.876649134663415e-05,27,6.150860095269988e-05,5,4.736418320466063e-05
1132,percent,32,5.876649134663415e-05,14,3.1893348642140685e-05,18,0.0001705110595367783
1151,privilege,32,5.876649134663415e-05,21,4.784002296321102e-05,11,0.0001042012030502534
1387,pride,32,5.876649134663415e-05,19,4.328383030004807e-05,13,0.00012314687633211766
1423,account,32,5.876649134663415e-05,25,5.695240828953693e-05,7,6.63098564865249e-05
2069,prepared,32,5.876649134663415e-05,26,5.923050462111841e-05,6,5.6837019845592764e-05
2229,reading,32,5.876649134663415e-05,28,6.378669728428137e-05,4,3.789134656372851e-05
2270,changing,32,5.876649134663415e-05,22,5.01181192947925e-05,10,9.472836640932126e-05
2318,rose,32,5.876649134663415e-05,28,6.378669728428137e-05,4,3.789134656372851e-05
2362,rebuild,32,5.876649134663415e-05,25,5.695240828953693e-05,7,6.63098564865249e-05
2424,increased,32,5.876649134663415e-05,19,4.328383030004807e-05,13,0.00012314687633211766
2537,brilliant,32,5.876649134663415e-05,30,6.834288994744431e-05,2,1.8945673281864254e-05
2756,talent,32,5.876649134663415e-05,27,6.150860095269988e-05,5,4.736418320466063e-05
2945,trouble,32,5.876649134663415e-05,31,7.06209862790258e-05,1,9.472836640932127e-06
3265,seniors,32,5.876649134663415e-05,15,3.417144497372216e-05,17,0.00016103822289584616
3406,continuing,32,5.876649134663415e-05,29,6.606479361586284e-05,3,2.8418509922796382e-05
4477,henry,32,5.876649134663415e-05,31,7.06209862790258e-05,1,9.472836640932127e-06
4848,unlike,32,5.876649134663415e-05,29,6.606479361586284e-05,3,2.8418509922796382e-05
4873,looked,32,5.876649134663415e-05,30,6.834288994744431e-05,2,1.8945673281864254e-05
5439,biased,32,5.876649134663415e-05,31,7.06209862790258e-05,1,9.472836640932127e-06
6057,previous,32,5.876649134663415e-05,30,6.834288994744431e-05,2,1.8945673281864254e-05
6876,construction,32,5.876649134663415e-05,30,6.834288994744431e-05,2,1.8945673281864254e-05
7601,damage,32,5.876649134663415e-05,31,7.06209862790258e-05,1,9.472836640932127e-06
7882,thrilled,32,5.876649134663415e-05,32,7.289908261060727e-05,0,0
8215,hunter,32,5.876649134663415e-05,32,7.289908261060727e-05,0,0
8281,steal,32,5.876649134663415e-05,32,7.289908261060727e-05,0,0
8801,parts,32,5.876649134663415e-05,32,7.289908261060727e-05,0,0
9014,venezuela,32,5.876649134663415e-05,32,7.289908261060727e-05,0,0
9352,careful,32,5.876649134663415e-05,32,7.289908261060727e-05,0,0
9558,jail,32,5.876649134663415e-05,32,7.289908261060727e-05,0,0
10063,aliens,32,5.876649134663415e-05,32,7.289908261060727e-05,0,0
10186,tariff,32,5.876649134663415e-05,32,7.289908261060727e-05,0,0
10448,agents,32,5.876649134663415e-05,32,7.289908261060727e-05,0,0
11242,investigate,32,5.876649134663415e-05,32,7.289908261060727e-05,0,0
14054,el,32,5.876649134663415e-05,32,7.289908261060727e-05,0,0
310,grateful,31,5.693003849205183e-05,22,5.01181192947925e-05,9,8.525552976838915e-05
362,improve,31,5.693003849205183e-05,18,4.100573396846659e-05,13,0.00012314687633211766
628,road,31,5.693003849205183e-05,7,1.5946674321070342e-05,24,0.00022734807938237106
668,issues,31,5.693003849205183e-05,13,2.9615252310559205e-05,18,0.0001705110595367783
1013,card,31,5.693003849205183e-05,7,1.5946674321070342e-05,24,0.00022734807938237106
1325,delivering,31,5.693003849205183e-05,20,4.556192663162955e-05,11,0.0001042012030502534
1905,sacrifice,31,5.693003849205183e-05,18,4.100573396846659e-05,13,0.00012314687633211766
1989,delivered,31,5.693003849205183e-05,24,5.467431195795545e-05,7,6.63098564865249e-05
2117,appreciate,31,5.693003849205183e-05,30,6.834288994744431e-05,1,9.472836640932127e-06
2149,benefit,31,5.693003849205183e-05,20,4.556192663162955e-05,11,0.0001042012030502534
2243,common,31,5.693003849205183e-05,16,3.644954130530364e-05,15,0.0001420925496139819
2386,hour,31,5.693003849205183e-05,18,4.100573396846659e-05,13,0.00012314687633211766
2441,bank,31,5.693003849205183e-05,22,5.01181192947925e-05,9,8.525552976838915e-05
2802,eyes,31,5.693003849205183e-05,25,5.695240828953693e-05,6,5.6837019845592764e-05
2943,father,31,5.693003849205183e-05,21,4.784002296321102e-05,10,9.472836640932126e-05
3213,faith,31,5.693003849205183e-05,25,5.695240828953693e-05,6,5.6837019845592764e-05
3361,cause,31,5.693003849205183e-05,21,4.784002296321102e-05,10,9.472836640932126e-05
3383,remains,31,5.693003849205183e-05,25,5.695240828953693e-05,6,5.6837019845592764e-05
3577,fortune,31,5.693003849205183e-05,29,6.606479361586284e-05,2,1.8945673281864254e-05
3666,bus,31,5.693003849205183e-05,26,5.923050462111841e-05,5,4.736418320466063e-05
3700,site,31,5.693003849205183e-05,27,6.150860095269988e-05,4,3.789134656372851e-05
3761,waste,31,5.693003849205183e-05,24,5.467431195795545e-05,7,6.63098564865249e-05
3956,date,31,5.693003849205183e-05,27,6.150860095269988e-05,4,3.789134656372851e-05
3977,san,31,5.693003849205183e-05,28,6.378669728428137e-05,3,2.8418509922796382e-05
4059,--,31,5.693003849205183e-05,18,4.100573396846659e-05,13,0.00012314687633211766
4256,kill,31,5.693003849205183e-05,28,6.378669728428137e-05,3,2.8418509922796382e-05
4313,individual,31,5.693003849205183e-05,28,6.378669728428137e-05,3,2.8418509922796382e-05
4418,politically,31,5.693003849205183e-05,29,6.606479361586284e-05,2,1.8945673281864254e-05
4545,cast,31,5.693003849205183e-05,23,5.239621562637398e-05,8,7.578269312745701e-05
4688,ran,31,5.693003849205183e-05,30,6.834288994744431e-05,1,9.472836640932127e-06
4978,opposition,31,5.693003849205183e-05,30,6.834288994744431e-05,1,9.472836640932127e-06
5445,schedule,31,5.693003849205183e-05,29,6.606479361586284e-05,2,1.8945673281864254e-05
5505,earlier,31,5.693003849205183e-05,26,5.923050462111841e-05,5,4.736418320466063e-05
5757,defeat,31,5.693003849205183e-05,29,6.606479361586284e-05,2,1.8945673281864254e-05
6994,present,31,5.693003849205183e-05,30,6.834288994744431e-05,1,9.472836640932127e-06
7075,administrations,31,5.693003849205183e-05,29,6.606479361586284e-05,2,1.8945673281864254e-05
8024,antifa,31,5.693003849205183e-05,31,7.06209862790258e-05,0,0
8290,handling,31,5.693003849205183e-05,31,7.06209862790258e-05,0,0
8570,absentee,31,5.693003849205183e-05,31,7.06209862790258e-05,0,0
8761,maga,31,5.693003849205183e-05,31,7.06209862790258e-05,0,0
8907,montana,31,5.693003849205183e-05,31,7.06209862790258e-05,0,0
9273,kingdom,31,5.693003849205183e-05,31,7.06209862790258e-05,0,0
9585,paris,31,5.693003849205183e-05,31,7.06209862790258e-05,0,0
9928,ms-13,31,5.693003849205183e-05,31,7.06209862790258e-05,0,0
10005,@judgejeanine,31,5.693003849205183e-05,31,7.06209862790258e-05,0,0
18894,kurds,31,5.693003849205183e-05,31,7.06209862790258e-05,0,0
227,closing,30,5.509358563746952e-05,17,3.8727637636885116e-05,13,0.00012314687633211766
364,vital,30,5.509358563746952e-05,18,4.100573396846659e-05,12,0.00011367403969118553
831,succeed,30,5.509358563746952e-05,8,1.822477065265182e-05,22,0.0002084024061005068
1018,booming,30,5.509358563746952e-05,29,6.606479361586284e-05,1,9.472836640932127e-06
1170,saving,30,5.509358563746952e-05,18,4.100573396846659e-05,12,0.00011367403969118553
1516,guys,30,5.509358563746952e-05,20,4.556192663162955e-05,10,9.472836640932126e-05
1608,deaths,30,5.509358563746952e-05,28,6.378669728428137e-05,2,1.8945673281864254e-05
1735,finished,30,5.509358563746952e-05,23,5.239621562637398e-05,7,6.63098564865249e-05
1829,sector,30,5.509358563746952e-05,9,2.0502866984233294e-05,21,0.00019892956945957466
1986,season,30,5.509358563746952e-05,20,4.556192663162955e-05,10,9.472836640932126e-05
2054,tired,30,5.509358563746952e-05,21,4.784002296321102e-05,9,8.525552976838915e-05
2093,strengthen,30,5.509358563746952e-05,14,3.1893348642140685e-05,16,0.00015156538625491403
2146,poverty,30,5.509358563746952e-05,13,2.9615252310559205e-05,17,0.00016103822289584616
2211,greatness,30,5.509358563746952e-05,27,6.150860095269988e-05,3,2.8418509922796382e-05
2365,production,30,5.509358563746952e-05,20,4.556192663162955e-05,10,9.472836640932126e-05
2443,rise,30,5.509358563746952e-05,18,4.100573396846659e-05,12,0.00011367403969118553
2493,summer,30,5.509358563746952e-05,7,1.5946674321070342e-05,23,0.00021787524274143893
2674,600,30,5.509358563746952e-05,27,6.150860095269988e-05,3,2.8418509922796382e-05
2779,funny,30,5.509358563746952e-05,29,6.606479361586284e-05,1,9.472836640932127e-06
2893,sunday,30,5.509358563746952e-05,26,5.923050462111841e-05,4,3.789134656372851e-05
2909,obviously,30,5.509358563746952e-05,29,6.606479361586284e-05,1,9.472836640932127e-06
2920,id,30,5.509358563746952e-05,22,5.01181192947925e-05,8,7.578269312745701e-05
3046,joining,30,5.509358563746952e-05,23,5.239621562637398e-05,7,6.63098564865249e-05
3283,vaccines,30,5.509358563746952e-05,29,6.606479361586284e-05,1,9.472836640932127e-06
3531,planned,30,5.509358563746952e-05,22,5.01181192947925e-05,8,7.578269312745701e-05
3982,effective,30,5.509358563746952e-05,25,5.695240828953693e-05,5,4.736418320466063e-05
3986,tuned,30,5.509358563746952e-05,28,6.378669728428137e-05,2,1.8945673281864254e-05
4042,oklahoma,30,5.509358563746952e-05,27,6.150860095269988e-05,3,2.8418509922796382e-05
4351,debates,30,5.509358563746952e-05,29,6.606479361586284e-05,1,9.472836640932127e-06
4423,reached,30,5.509358563746952e-05,26,5.923050462111841e-05,4,3.789134656372851e-05
4512,serving,30,5.509358563746952e-05,24,5.467431195795545e-05,6,5.6837019845592764e-05
4516,stone,30,5.509358563746952e-05,28,6.378669728428137e-05,2,1.8945673281864254e-05
4622,banks,30,5.509358563746952e-05,22,5.01181192947925e-05,8,7.578269312745701e-05
4881,telling,30,5.509358563746952e-05,24,5.467431195795545e-05,6,5.6837019845592764e-05
4918,talked,30,5.509358563746952e-05,27,6.150860095269988e-05,3,2.8418509922796382e-05
5279,endless,30,5.509358563746952e-05,29,6.606479361586284e-05,1,9.472836640932127e-06
5922,seat,30,5.509358563746952e-05,23,5.239621562637398e-05,7,6.63098564865249e-05
6144,plant,30,5.509358563746952e-05,28,6.378669728428137e-05,2,1.8945673281864254e-05
6167,rallies,30,5.509358563746952e-05,28,6.378669728428137e-05,2,1.8945673281864254e-05
6346,google,30,5.509358563746952e-05,26,5.923050462111841e-05,4,3.789134656372851e-05
6551,proudly,30,5.509358563746952e-05,29,6.606479361586284e-05,1,9.472836640932127e-06
6803,lots,30,5.509358563746952e-05,28,6.378669728428137e-05,2,1.8945673281864254e-05
6871,showed,30,5.509358563746952e-05,28,6.378669728428137e-05,2,1.8945673281864254e-05
7003,reporters,30,5.509358563746952e-05,29,6.606479361586284e-05,1,9.472836640932127e-06
7977,exposed,30,5.509358563746952e-05,30,6.834288994744431e-05,0,0
8275,flynn,30,5.509358563746952e-05,30,6.834288994744431e-05,0,0
8350,terror,30,5.509358563746952e-05,30,6.834288994744431e-05,0,0
8704,stupid,30,5.509358563746952e-05,30,6.834288994744431e-05,0,0
9598,christopher,30,5.509358563746952e-05,30,6.834288994744431e-05,0,0
9605,@fema,30,5.509358563746952e-05,30,6.834288994744431e-05,0,0
9673,strange,30,5.509358563746952e-05,30,6.834288994744431e-05,0,0
9731,indeed,30,5.509358563746952e-05,30,6.834288994744431e-05,0,0
10288,arabia,30,5.509358563746952e-05,30,6.834288994744431e-05,0,0
11303,brennan,30,5.509358563746952e-05,30,6.834288994744431e-05,0,0
13088,baltimore,30,5.509358563746952e-05,30,6.834288994744431e-05,0,0
93,alaska,29,5.32571327828872e-05,22,5.01181192947925e-05,7,6.63098564865249e-05
585,worlds,29,5.32571327828872e-05,19,4.328383030004807e-05,10,9.472836640932126e-05
667,sound,29,5.32571327828872e-05,28,6.378669728428137e-05,1,9.472836640932127e-06
749,events,29,5.32571327828872e-05,24,5.467431195795545e-05,5,4.736418320466063e-05
817,overtime,29,5.32571327828872e-05,25,5.695240828953693e-05,4,3.789134656372851e-05
844,announcing,29,5.32571327828872e-05,19,4.328383030004807e-05,10,9.472836640932126e-05
961,opposed,29,5.32571327828872e-05,25,5.695240828953693e-05,4,3.789134656372851e-05
972,worry,29,5.32571327828872e-05,23,5.239621562637398e-05,6,5.6837019845592764e-05
1481,influence,29,5.32571327828872e-05,22,5.01181192947925e-05,7,6.63098564865249e-05
1787,supposed,29,5.32571327828872e-05,26,5.923050462111841e-05,3,2.8418509922796382e-05
1958,detroit,29,5.32571327828872e-05,15,3.417144497372216e-05,14,0.0001326197129730498
2020,1st,29,5.32571327828872e-05,14,3.1893348642140685e-05,15,0.0001420925496139819
2061,plants,29,5.32571327828872e-05,22,5.01181192947925e-05,7,6.63098564865249e-05
2334,productive,29,5.32571327828872e-05,28,6.378669728428137e-05,1,9.472836640932127e-06
2387,personal,29,5.32571327828872e-05,21,4.784002296321102e-05,8,7.578269312745701e-05
2445,quo,29,5.32571327828872e-05,26,5.923050462111841e-05,3,2.8418509922796382e-05
2453,listening,29,5.32571327828872e-05,25,5.695240828953693e-05,4,3.789134656372851e-05
2458,career,29,5.32571327828872e-05,27,6.150860095269988e-05,2,1.8945673281864254e-05
2461,pays,29,5.32571327828872e-05,11,2.505905964739625e-05,18,0.0001705110595367783
2545,bills,29,5.32571327828872e-05,20,4.556192663162955e-05,9,8.525552976838915e-05
2676,per,29,5.32571327828872e-05,20,4.556192663162955e-05,9,8.525552976838915e-05
3288,tens,29,5.32571327828872e-05,27,6.150860095269988e-05,2,1.8945673281864254e-05
3821,typical,29,5.32571327828872e-05,7,1.5946674321070342e-05,22,0.0002084024061005068
3858,mccarthy,29,5.32571327828872e-05,28,6.378669728428137e-05,1,9.472836640932127e-06
3984,fault,29,5.32571327828872e-05,27,6.150860095269988e-05,2,1.8945673281864254e-05
5089,test,29,5.32571327828872e-05,25,5.695240828953693e-05,4,3.789134656372851e-05
5120,registered,29,5.32571327828872e-05,10,2.2780963315814774e-05,19,0.00017998389617771042
5456,facebook,29,5.32571327828872e-05,23,5.239621562637398e-05,6,5.6837019845592764e-05
5903,india,29,5.32571327828872e-05,27,6.150860095269988e-05,2,1.8945673281864254e-05
6087,indiana,29,5.32571327828872e-05,27,6.150860095269988e-05,2,1.8945673281864254e-05
6095,however,29,5.32571327828872e-05,27,6.150860095269988e-05,2,1.8945673281864254e-05
6660,cops,29,5.32571327828872e-05,25,5.695240828953693e-05,4,3.789134656372851e-05
6831,philadelphia,29,5.32571327828872e-05,28,6.378669728428137e-05,1,9.472836640932127e-06
6990,plenty,29,5.32571327828872e-05,28,6.378669728428137e-05,1,9.472836640932127e-06
7083,reps,29,5.32571327828872e-05,5,1.1390481657907387e-05,24,0.00022734807938237106
8096,fools,29,5.32571327828872e-05,29,6.606479361586284e-05,0,0
8411,various,29,5.32571327828872e-05,29,6.606479361586284e-05,0,0
8547,deleted,29,5.32571327828872e-05,29,6.606479361586284e-05,0,0
8831,inform,29,5.32571327828872e-05,29,6.606479361586284e-05,0,0
8879,bolton,29,5.32571327828872e-05,29,6.606479361586284e-05,0,0
10544,abc,29,5.32571327828872e-05,29,6.606479361586284e-05,0,0
10676,levin,29,5.32571327828872e-05,29,6.606479361586284e-05,0,0
14966,server,29,5.32571327828872e-05,29,6.606479361586284e-05,0,0
333,october,28,5.142067992830488e-05,23,5.239621562637398e-05,5,4.736418320466063e-05
875,citizenship,28,5.142067992830488e-05,14,3.1893348642140685e-05,14,0.0001326197129730498
1434,decide,28,5.142067992830488e-05,11,2.505905964739625e-05,17,0.00016103822289584616
1535,investment,28,5.142067992830488e-05,19,4.328383030004807e-05,9,8.525552976838915e-05
1626,modern,28,5.142067992830488e-05,25,5.695240828953693e-05,3,2.8418509922796382e-05
1670,age,28,5.142067992830488e-05,17,3.8727637636885116e-05,11,0.0001042012030502534
1816,assault,28,5.142067992830488e-05,17,3.8727637636885116e-05,11,0.0001042012030502534
1842,foundation,28,5.142067992830488e-05,25,5.695240828953693e-05,3,2.8418509922796382e-05
1957,#madeinamerica,28,5.142067992830488e-05,2,4.556192663162955e-06,26,0.0002462937526642353
2076,light,28,5.142067992830488e-05,22,5.01181192947925e-05,6,5.6837019845592764e-05
2094,petition,28,5.142067992830488e-05,1,2.2780963315814773e-06,27,0.0002557665893051674
2107,treat,28,5.142067992830488e-05,23,5.239621562637398e-05,5,4.736418320466063e-05
2178,begun,28,5.142067992830488e-05,24,5.467431195795545e-05,4,3.789134656372851e-05
2442,hospital,28,5.142067992830488e-05,24,5.467431195795545e-05,4,3.789134656372851e-05
2561,massachusetts,28,5.142067992830488e-05,9,2.0502866984233294e-05,19,0.00017998389617771042
3503,flu,28,5.142067992830488e-05,26,5.923050462111841e-05,2,1.8945673281864254e-05
3528,hurting,28,5.142067992830488e-05,24,5.467431195795545e-05,4,3.789134656372851e-05
3550,negotiate,28,5.142067992830488e-05,26,5.923050462111841e-05,2,1.8945673281864254e-05
3881,dealing,28,5.142067992830488e-05,27,6.150860095269988e-05,1,9.472836640932127e-06
4181,st,28,5.142067992830488e-05,14,3.1893348642140685e-05,14,0.0001326197129730498
4976,admitted,28,5.142067992830488e-05,27,6.150860095269988e-05,1,9.472836640932127e-06
5108,fool,28,5.142067992830488e-05,26,5.923050462111841e-05,2,1.8945673281864254e-05
5128,register,28,5.142067992830488e-05,13,2.9615252310559205e-05,15,0.0001420925496139819
5657,landing,28,5.142067992830488e-05,26,5.923050462111841e-05,2,1.8945673281864254e-05
6931,congresswoman,28,5.142067992830488e-05,27,6.150860095269988e-05,1,9.472836640932127e-06
7243,space,28,5.142067992830488e-05,25,5.695240828953693e-05,3,2.8418509922796382e-05
7454,shown,28,5.142067992830488e-05,27,6.150860095269988e-05,1,9.472836640932127e-06
8062,asap,28,5.142067992830488e-05,28,6.378669728428137e-05,0,0
8491,ok,28,5.142067992830488e-05,28,6.378669728428137e-05,0,0
8681,anonymous,28,5.142067992830488e-05,28,6.378669728428137e-05,0,0
8932,boring,28,5.142067992830488e-05,28,6.378669728428137e-05,0,0
9397,treason,28,5.142067992830488e-05,28,6.378669728428137e-05,0,0
9676,purposely,28,5.142067992830488e-05,28,6.378669728428137e-05,0,0
9943,humanitarian,28,5.142067992830488e-05,28,6.378669728428137e-05,0,0
10606,lover,28,5.142067992830488e-05,28,6.378669728428137e-05,0,0
10726,currency,28,5.142067992830488e-05,28,6.378669728428137e-05,0,0
12481,agent,28,5.142067992830488e-05,28,6.378669728428137e-05,0,0
407,proof,27,4.958422707372256e-05,25,5.695240828953693e-05,2,1.8945673281864254e-05
947,solution,27,4.958422707372256e-05,17,3.8727637636885116e-05,10,9.472836640932126e-05
1076,thursday,27,4.958422707372256e-05,25,5.695240828953693e-05,2,1.8945673281864254e-05
1360,key,27,4.958422707372256e-05,12,2.7337155978977726e-05,15,0.0001420925496139819
1372,fun,27,4.958422707372256e-05,19,4.328383030004807e-05,8,7.578269312745701e-05
1385,#loveislove,27,4.958422707372256e-05,0,0,27,0.0002557665893051674
1743,decided,27,4.958422707372256e-05,25,5.695240828953693e-05,2,1.8945673281864254e-05
2317,levels,27,4.958422707372256e-05,23,5.239621562637398e-05,4,3.789134656372851e-05
2736,suppression,27,4.958422707372256e-05,26,5.923050462111841e-05,1,9.472836640932127e-06
2863,push,27,4.958422707372256e-05,21,4.784002296321102e-05,6,5.6837019845592764e-05
3012,food,27,4.958422707372256e-05,25,5.695240828953693e-05,2,1.8945673281864254e-05
3027,representative,27,4.958422707372256e-05,20,4.556192663162955e-05,7,6.63098564865249e-05
3043,secret,27,4.958422707372256e-05,23,5.239621562637398e-05,4,3.789134656372851e-05
3080,excellent,27,4.958422707372256e-05,23,5.239621562637398e-05,4,3.789134656372851e-05
3105,forces,27,4.958422707372256e-05,20,4.556192663162955e-05,7,6.63098564865249e-05
3113,project,27,4.958422707372256e-05,24,5.467431195795545e-05,3,2.8418509922796382e-05
3445,storm,27,4.958422707372256e-05,22,5.01181192947925e-05,5,4.736418320466063e-05
3579,duty,27,4.958422707372256e-05,25,5.695240828953693e-05,2,1.8945673281864254e-05
3721,camp,27,4.958422707372256e-05,25,5.695240828953693e-05,2,1.8945673281864254e-05
3894,sit,27,4.958422707372256e-05,18,4.100573396846659e-05,9,8.525552976838915e-05
4615,#forward2012,27,4.958422707372256e-05,0,0,27,0.0002557665893051674
4969,appointed,27,4.958422707372256e-05,25,5.695240828953693e-05,2,1.8945673281864254e-05
4980,reviews,27,4.958422707372256e-05,25,5.695240828953693e-05,2,1.8945673281864254e-05
5131,mail,27,4.958422707372256e-05,24,5.467431195795545e-05,3,2.8418509922796382e-05
5324,firing,27,4.958422707372256e-05,24,5.467431195795545e-05,3,2.8418509922796382e-05
5673,medal,27,4.958422707372256e-05,24,5.467431195795545e-05,3,2.8418509922796382e-05
5936,army,27,4.958422707372256e-05,26,5.923050462111841e-05,1,9.472836640932127e-06
7065,greg,27,4.958422707372256e-05,26,5.923050462111841e-05,1,9.472836640932127e-06
7362,goods,27,4.958422707372256e-05,26,5.923050462111841e-05,1,9.472836640932127e-06
7658,crash,27,4.958422707372256e-05,26,5.923050462111841e-05,1,9.472836640932127e-06
8175,opinion,27,4.958422707372256e-05,27,6.150860095269988e-05,0,0
8457,losers,27,4.958422707372256e-05,27,6.150860095269988e-05,0,0
8610,finest,27,4.958422707372256e-05,27,6.150860095269988e-05,0,0
8637,pocahontas,27,4.958422707372256e-05,27,6.150860095269988e-05,0,0
8788,violent,27,4.958422707372256e-05,27,6.150860095269988e-05,0,0
8839,rush,27,4.958422707372256e-05,27,6.150860095269988e-05,0,0
9106,brett,27,4.958422707372256e-05,27,6.150860095269988e-05,0,0
9396,spying,27,4.958422707372256e-05,27,6.150860095269988e-05,0,0
9591,airport,27,4.958422707372256e-05,27,6.150860095269988e-05,0,0
9617,nervous,27,4.958422707372256e-05,27,6.150860095269988e-05,0,0
11626,racist,27,4.958422707372256e-05,27,6.150860095269988e-05,0,0
796,wages,26,4.7747774219140243e-05,14,3.1893348642140685e-05,12,0.00011367403969118553
1002,guess,26,4.7747774219140243e-05,20,4.556192663162955e-05,6,5.6837019845592764e-05
1591,train,26,4.7747774219140243e-05,17,3.8727637636885116e-05,9,8.525552976838915e-05
1680,quality,26,4.7747774219140243e-05,9,2.0502866984233294e-05,17,0.00016103822289584616
1719,task,26,4.7747774219140243e-05,21,4.784002296321102e-05,5,4.736418320466063e-05
1796,mind,26,4.7747774219140243e-05,18,4.100573396846659e-05,8,7.578269312745701e-05
1837,affected,26,4.7747774219140243e-05,20,4.556192663162955e-05,6,5.6837019845592764e-05
1872,apart,26,4.7747774219140243e-05,20,4.556192663162955e-05,6,5.6837019845592764e-05
1878,fallen,26,4.7747774219140243e-05,16,3.644954130530364e-05,10,9.472836640932126e-05
1928,critical,26,4.7747774219140243e-05,18,4.100573396846659e-05,8,7.578269312745701e-05
1992,quarter,26,4.7747774219140243e-05,14,3.1893348642140685e-05,12,0.00011367403969118553
2026,reducing,26,4.7747774219140243e-05,16,3.644954130530364e-05,10,9.472836640932126e-05
2127,congrats,26,4.7747774219140243e-05,19,4.328383030004807e-05,7,6.63098564865249e-05
2145,below,26,4.7747774219140243e-05,22,5.01181192947925e-05,4,3.789134656372851e-05
2184,direction,26,4.7747774219140243e-05,17,3.8727637636885116e-05,9,8.525552976838915e-05
2280,civil,26,4.7747774219140243e-05,20,4.556192663162955e-05,6,5.6837019845592764e-05
2351,trust,26,4.7747774219140243e-05,15,3.417144497372216e-05,11,0.0001042012030502534
2473,rated,26,4.7747774219140243e-05,24,5.467431195795545e-05,2,1.8945673281864254e-05
2549,birth,26,4.7747774219140243e-05,8,1.822477065265182e-05,18,0.0001705110595367783
3247,organization,26,4.7747774219140243e-05,21,4.784002296321102e-05,5,4.736418320466063e-05
3390,considered,26,4.7747774219140243e-05,25,5.695240828953693e-05,1,9.472836640932127e-06
3994,represent,26,4.7747774219140243e-05,25,5.695240828953693e-05,1,9.472836640932127e-06
4352,shape,26,4.7747774219140243e-05,23,5.239621562637398e-05,3,2.8418509922796382e-05
4490,manufacturers,26,4.7747774219140243e-05,24,5.467431195795545e-05,2,1.8945673281864254e-05
4575,bruce,26,4.7747774219140243e-05,24,5.467431195795545e-05,2,1.8945673281864254e-05
4683,hearts,26,4.7747774219140243e-05,23,5.239621562637398e-05,3,2.8418509922796382e-05
4889,stage,26,4.7747774219140243e-05,19,4.328383030004807e-05,7,6.63098564865249e-05
5075,advocate,26,4.7747774219140243e-05,24,5.467431195795545e-05,2,1.8945673281864254e-05
5084,answers,26,4.7747774219140243e-05,23,5.239621562637398e-05,3,2.8418509922796382e-05
5204,4th,26,4.7747774219140243e-05,25,5.695240828953693e-05,1,9.472836640932127e-06
5388,figure,26,4.7747774219140243e-05,23,5.239621562637398e-05,3,2.8418509922796382e-05
5575,700,26,4.7747774219140243e-05,25,5.695240828953693e-05,1,9.472836640932127e-06
6134,businessman,26,4.7747774219140243e-05,25,5.695240828953693e-05,1,9.472836640932127e-06
6384,rebuilt,26,4.7747774219140243e-05,25,5.695240828953693e-05,1,9.472836640932127e-06
6790,brother,26,4.7747774219140243e-05,25,5.695240828953693e-05,1,9.472836640932127e-06
7591,representing,26,4.7747774219140243e-05,25,5.695240828953693e-05,1,9.472836640932127e-06
7887,anticipated,26,4.7747774219140243e-05,26,5.923050462111841e-05,0,0
8625,considering,26,4.7747774219140243e-05,26,5.923050462111841e-05,0,0
8716,nasty,26,4.7747774219140243e-05,26,5.923050462111841e-05,0,0
9089,heavily,26,4.7747774219140243e-05,26,5.923050462111841e-05,0,0
9198,fixed,26,4.7747774219140243e-05,26,5.923050462111841e-05,0,0
9392,barr,26,4.7747774219140243e-05,26,5.923050462111841e-05,0,0
9430,troy,26,4.7747774219140243e-05,26,5.923050462111841e-05,0,0
10176,iranian,26,4.7747774219140243e-05,26,5.923050462111841e-05,0,0
10449,bias,26,4.7747774219140243e-05,26,5.923050462111841e-05,0,0
10633,loyal,26,4.7747774219140243e-05,26,5.923050462111841e-05,0,0
10664,represented,26,4.7747774219140243e-05,26,5.923050462111841e-05,0,0
11305,clapper,26,4.7747774219140243e-05,26,5.923050462111841e-05,0,0
11364,quid,26,4.7747774219140243e-05,26,5.923050462111841e-05,0,0
12262,obstruct,26,4.7747774219140243e-05,26,5.923050462111841e-05,0,0
13669,ron,26,4.7747774219140243e-05,26,5.923050462111841e-05,0,0
487,paycheck,25,4.591132136455793e-05,10,2.2780963315814774e-05,15,0.0001420925496139819
569,example,25,4.591132136455793e-05,17,3.8727637636885116e-05,8,7.578269312745701e-05
636,die,25,4.591132136455793e-05,21,4.784002296321102e-05,4,3.789134656372851e-05
649,ends,25,4.591132136455793e-05,18,4.100573396846659e-05,7,6.63098564865249e-05
764,basic,25,4.591132136455793e-05,4,9.11238532632591e-06,21,0.00019892956945957466
881,claim,25,4.591132136455793e-05,18,4.100573396846659e-05,7,6.63098564865249e-05
1046,hire,25,4.591132136455793e-05,11,2.505905964739625e-05,14,0.0001326197129730498
1747,encourage,25,4.591132136455793e-05,19,4.328383030004807e-05,6,5.6837019845592764e-05
1871,generations,25,4.591132136455793e-05,7,1.5946674321070342e-05,18,0.0001705110595367783
1963,otherwise,25,4.591132136455793e-05,21,4.784002296321102e-05,4,3.789134656372851e-05
1984,holiday,25,4.591132136455793e-05,12,2.7337155978977726e-05,13,0.00012314687633211766
2059,200,25,4.591132136455793e-05,22,5.01181192947925e-05,3,2.8418509922796382e-05
2129,bit,25,4.591132136455793e-05,16,3.644954130530364e-05,9,8.525552976838915e-05
2152,ten,25,4.591132136455793e-05,20,4.556192663162955e-05,5,4.736418320466063e-05
2166,extreme,25,4.591132136455793e-05,18,4.100573396846659e-05,7,6.63098564865249e-05
2244,responsibility,25,4.591132136455793e-05,6,1.3668577989488863e-05,19,0.00017998389617771042
2349,obligation,25,4.591132136455793e-05,11,2.505905964739625e-05,14,0.0001326197129730498
2373,accept,25,4.591132136455793e-05,16,3.644954130530364e-05,9,8.525552976838915e-05
2499,wave,25,4.591132136455793e-05,24,5.467431195795545e-05,1,9.472836640932127e-06
2698,lifetime,25,4.591132136455793e-05,14,3.1893348642140685e-05,11,0.0001042012030502534
2959,launch,25,4.591132136455793e-05,19,4.328383030004807e-05,6,5.6837019845592764e-05
2995,shes,25,4.591132136455793e-05,18,4.100573396846659e-05,7,6.63098564865249e-05
3277,include,25,4.591132136455793e-05,24,5.467431195795545e-05,1,9.472836640932127e-06
3562,defund,25,4.591132136455793e-05,21,4.784002296321102e-05,4,3.789134656372851e-05
3611,chinas,25,4.591132136455793e-05,24,5.467431195795545e-05,1,9.472836640932127e-06
3854,confirmed,25,4.591132136455793e-05,21,4.784002296321102e-05,4,3.789134656372851e-05
3866,al,25,4.591132136455793e-05,16,3.644954130530364e-05,9,8.525552976838915e-05
3897,independence,25,4.591132136455793e-05,20,4.556192663162955e-05,5,4.736418320466063e-05
4280,reagan,25,4.591132136455793e-05,20,4.556192663162955e-05,5,4.736418320466063e-05
4634,learned,25,4.591132136455793e-05,22,5.01181192947925e-05,3,2.8418509922796382e-05
4801,ship,25,4.591132136455793e-05,19,4.328383030004807e-05,6,5.6837019845592764e-05
5090,stimulus,25,4.591132136455793e-05,24,5.467431195795545e-05,1,9.472836640932127e-06
5828,pittsburgh,25,4.591132136455793e-05,23,5.239621562637398e-05,2,1.8945673281864254e-05
5859,investigating,25,4.591132136455793e-05,23,5.239621562637398e-05,2,1.8945673281864254e-05
6275,#buffettrule,25,4.591132136455793e-05,0,0,25,0.0002368209160233032
6780,drop,25,4.591132136455793e-05,22,5.01181192947925e-05,3,2.8418509922796382e-05
7924,@nbcnews,25,4.591132136455793e-05,25,5.695240828953693e-05,0,0
8090,terminated,25,4.591132136455793e-05,25,5.695240828953693e-05,0,0
8158,unfairly,25,4.591132136455793e-05,25,5.695240828953693e-05,0,0
8202,virtually,25,4.591132136455793e-05,25,5.695240828953693e-05,0,0
8364,pushed,25,4.591132136455793e-05,25,5.695240828953693e-05,0,0
8641,looters,25,4.591132136455793e-05,25,5.695240828953693e-05,0,0
8725,appropriate,25,4.591132136455793e-05,25,5.695240828953693e-05,0,0
8927,addition,25,4.591132136455793e-05,25,5.695240828953693e-05,0,0
8983,@dbongino,25,4.591132136455793e-05,25,5.695240828953693e-05,0,0
9049,agitators,25,4.591132136455793e-05,25,5.695240828953693e-05,0,0
9372,constantly,25,4.591132136455793e-05,25,5.695240828953693e-05,0,0
9387,hates,25,4.591132136455793e-05,25,5.695240828953693e-05,0,0
9789,removed,25,4.591132136455793e-05,25,5.695240828953693e-05,0,0
9801,moore,25,4.591132136455793e-05,25,5.695240828953693e-05,0,0
11304,cia,25,4.591132136455793e-05,25,5.695240828953693e-05,0,0
12832,picture,25,4.591132136455793e-05,25,5.695240828953693e-05,0,0
16552,ohr,25,4.591132136455793e-05,25,5.695240828953693e-05,0,0
397,14,24,4.407486850997561e-05,17,3.8727637636885116e-05,7,6.63098564865249e-05
526,26,24,4.407486850997561e-05,8,1.822477065265182e-05,16,0.00015156538625491403
834,challenge,24,4.407486850997561e-05,10,2.2780963315814774e-05,14,0.0001326197129730498
850,investing,24,4.407486850997561e-05,10,2.2780963315814774e-05,14,0.0001326197129730498
1044,labor,24,4.407486850997561e-05,19,4.328383030004807e-05,5,4.736418320466063e-05
1135,teacher,24,4.407486850997561e-05,4,9.11238532632591e-06,20,0.00018945673281864253
1173,inspired,24,4.407486850997561e-05,13,2.9615252310559205e-05,11,0.0001042012030502534
1474,science,24,4.407486850997561e-05,2,4.556192663162955e-06,22,0.0002084024061005068
1538,denied,24,4.407486850997561e-05,7,1.5946674321070342e-05,17,0.00016103822289584616
1625,internet,24,4.407486850997561e-05,13,2.9615252310559205e-05,11,0.0001042012030502534
2016,uniform,24,4.407486850997561e-05,10,2.2780963315814774e-05,14,0.0001326197129730498
2075,liberty,24,4.407486850997561e-05,20,4.556192663162955e-05,4,3.789134656372851e-05
2156,match,24,4.407486850997561e-05,22,5.01181192947925e-05,2,1.8945673281864254e-05
2164,thinks,24,4.407486850997561e-05,13,2.9615252310559205e-05,11,0.0001042012030502534
2197,signature,24,4.407486850997561e-05,23,5.239621562637398e-05,1,9.472836640932127e-06
2482,employment,24,4.407486850997561e-05,19,4.328383030004807e-05,5,4.736418320466063e-05
2566,300,24,4.407486850997561e-05,20,4.556192663162955e-05,4,3.789134656372851e-05
2593,dreams,24,4.407486850997561e-05,15,3.417144497372216e-05,9,8.525552976838915e-05
2798,sometimes,24,4.407486850997561e-05,21,4.784002296321102e-05,3,2.8418509922796382e-05
2935,cares,24,4.407486850997561e-05,23,5.239621562637398e-05,1,9.472836640932127e-06
2958,competition,24,4.407486850997561e-05,22,5.01181192947925e-05,2,1.8945673281864254e-05
3035,knowing,24,4.407486850997561e-05,18,4.100573396846659e-05,6,5.6837019845592764e-05
3171,hispanic,24,4.407486850997561e-05,21,4.784002296321102e-05,3,2.8418509922796382e-05
3392,combat,24,4.407486850997561e-05,16,3.644954130530364e-05,8,7.578269312745701e-05
3415,protects,24,4.407486850997561e-05,17,3.8727637636885116e-05,7,6.63098564865249e-05
3571,agencies,24,4.407486850997561e-05,21,4.784002296321102e-05,3,2.8418509922796382e-05
3617,heritage,24,4.407486850997561e-05,19,4.328383030004807e-05,5,4.736418320466063e-05
3640,lincoln,24,4.407486850997561e-05,20,4.556192663162955e-05,4,3.789134656372851e-05
3793,focused,24,4.407486850997561e-05,22,5.01181192947925e-05,2,1.8945673281864254e-05
4114,dying,24,4.407486850997561e-05,23,5.239621562637398e-05,1,9.472836640932127e-06
4126,stolen,24,4.407486850997561e-05,23,5.239621562637398e-05,1,9.472836640932127e-06
4438,nominee,24,4.407486850997561e-05,19,4.328383030004807e-05,5,4.736418320466063e-05
4618,risk,24,4.407486850997561e-05,23,5.239621562637398e-05,1,9.472836640932127e-06
5036,closer,24,4.407486850997561e-05,16,3.644954130530364e-05,8,7.578269312745701e-05
5044,21,24,4.407486850997561e-05,22,5.01181192947925e-05,2,1.8945673281864254e-05
5051,following,24,4.407486850997561e-05,23,5.239621562637398e-05,1,9.472836640932127e-06
5092,absolute,24,4.407486850997561e-05,23,5.239621562637398e-05,1,9.472836640932127e-06
5327,bumper,24,4.407486850997561e-05,0,0,24,0.00022734807938237106
5329,sticker,24,4.407486850997561e-05,0,0,24,0.00022734807938237106
5854,andy,24,4.407486850997561e-05,23,5.239621562637398e-05,1,9.472836640932127e-06
5862,knowledge,24,4.407486850997561e-05,21,4.784002296321102e-05,3,2.8418509922796382e-05
5954,firefighters,24,4.407486850997561e-05,14,3.1893348642140685e-05,10,9.472836640932126e-05
6883,ken,24,4.407486850997561e-05,23,5.239621562637398e-05,1,9.472836640932127e-06
6969,dakota,24,4.407486850997561e-05,23,5.239621562637398e-05,1,9.472836640932127e-06
7073,briefing,24,4.407486850997561e-05,23,5.239621562637398e-05,1,9.472836640932127e-06
7970,watchers,24,4.407486850997561e-05,24,5.467431195795545e-05,0,0
8308,jason,24,4.407486850997561e-05,24,5.467431195795545e-05,0,0
8316,safely,24,4.407486850997561e-05,24,5.467431195795545e-05,0,0
8335,eric,24,4.407486850997561e-05,24,5.467431195795545e-05,0,0
8358,abolish,24,4.407486850997561e-05,24,5.467431195795545e-05,0,0
8505,anti-trump,24,4.407486850997561e-05,24,5.467431195795545e-05,0,0
8635,endorse,24,4.407486850997561e-05,24,5.467431195795545e-05,0,0
8734,network,24,4.407486850997561e-05,24,5.467431195795545e-05,0,0
8957,wallace,24,4.407486850997561e-05,24,5.467431195795545e-05,0,0
9156,terrorists,24,4.407486850997561e-05,24,5.467431195795545e-05,0,0
9375,disgraced,24,4.407486850997561e-05,24,5.467431195795545e-05,0,0
9463,destruction,24,4.407486850997561e-05,24,5.467431195795545e-05,0,0
9562,narrative,24,4.407486850997561e-05,24,5.467431195795545e-05,0,0
9714,@foxbusiness,24,4.407486850997561e-05,24,5.467431195795545e-05,0,0
9911,fiction,24,4.407486850997561e-05,24,5.467431195795545e-05,0,0
9939,trafficking,24,4.407486850997561e-05,24,5.467431195795545e-05,0,0
10116,leaked,24,4.407486850997561e-05,24,5.467431195795545e-05,0,0
10569,transit,24,4.407486850997561e-05,24,5.467431195795545e-05,0,0
11807,arena,24,4.407486850997561e-05,24,5.467431195795545e-05,0,0
125,speed,23,4.2238415655393294e-05,20,4.556192663162955e-05,3,2.8418509922796382e-05
130,recorded,23,4.2238415655393294e-05,20,4.556192663162955e-05,3,2.8418509922796382e-05
353,2008,23,4.2238415655393294e-05,2,4.556192663162955e-06,21,0.00019892956945957466
370,effect,23,4.2238415655393294e-05,17,3.8727637636885116e-05,6,5.6837019845592764e-05
496,uninsured,23,4.2238415655393294e-05,1,2.2780963315814773e-06,22,0.0002084024061005068
510,80,23,4.2238415655393294e-05,14,3.1893348642140685e-05,9,8.525552976838915e-05
718,commit,23,4.2238415655393294e-05,10,2.2780963315814774e-05,13,0.00012314687633211766
727,advice,23,4.2238415655393294e-05,19,4.328383030004807e-05,4,3.789134656372851e-05
775,experts,23,4.2238415655393294e-05,19,4.328383030004807e-05,4,3.789134656372851e-05
813,lines,23,4.2238415655393294e-05,21,4.784002296321102e-05,2,1.8945673281864254e-05
856,town,23,4.2238415655393294e-05,16,3.644954130530364e-05,7,6.63098564865249e-05
1053,sitting,23,4.2238415655393294e-05,18,4.100573396846659e-05,5,4.736418320466063e-05
1126,research,23,4.2238415655393294e-05,19,4.328383030004807e-05,4,3.789134656372851e-05
1201,bottom,23,4.2238415655393294e-05,9,2.0502866984233294e-05,14,0.0001326197129730498
1263,failure,23,4.2238415655393294e-05,18,4.100573396846659e-05,5,4.736418320466063e-05
1275,marriage,23,4.2238415655393294e-05,1,2.2780963315814773e-06,22,0.0002084024061005068
1357,legacy,23,4.2238415655393294e-05,13,2.9615252310559205e-05,10,9.472836640932126e-05
1380,whom,23,4.2238415655393294e-05,15,3.417144497372216e-05,8,7.578269312745701e-05
1784,era,23,4.2238415655393294e-05,18,4.100573396846659e-05,5,4.736418320466063e-05
1844,vast,23,4.2238415655393294e-05,19,4.328383030004807e-05,4,3.789134656372851e-05
1881,ceo,23,4.2238415655393294e-05,21,4.784002296321102e-05,2,1.8945673281864254e-05
1946,discussing,23,4.2238415655393294e-05,21,4.784002296321102e-05,2,1.8945673281864254e-05
1981,piece,23,4.2238415655393294e-05,13,2.9615252310559205e-05,10,9.472836640932126e-05
2202,employees,23,4.2238415655393294e-05,19,4.328383030004807e-05,4,3.789134656372851e-05
2321,acts,23,4.2238415655393294e-05,19,4.328383030004807e-05,4,3.789134656372851e-05
2425,daughters,23,4.2238415655393294e-05,1,2.2780963315814773e-06,22,0.0002084024061005068
2457,overseas,23,4.2238415655393294e-05,11,2.505905964739625e-05,12,0.00011367403969118553
2462,52,23,4.2238415655393294e-05,17,3.8727637636885116e-05,6,5.6837019845592764e-05
2610,allies,23,4.2238415655393294e-05,18,4.100573396846659e-05,5,4.736418320466063e-05
2872,barely,23,4.2238415655393294e-05,19,4.328383030004807e-05,4,3.789134656372851e-05
2906,@michelleobama,23,4.2238415655393294e-05,1,2.2780963315814773e-06,22,0.0002084024061005068
3246,peaceful,23,4.2238415655393294e-05,22,5.01181192947925e-05,1,9.472836640932127e-06
3548,puts,23,4.2238415655393294e-05,18,4.100573396846659e-05,5,4.736418320466063e-05
3969,shame,23,4.2238415655393294e-05,19,4.328383030004807e-05,4,3.789134656372851e-05
4476,ford,23,4.2238415655393294e-05,21,4.784002296321102e-05,2,1.8945673281864254e-05
4628,whos,23,4.2238415655393294e-05,8,1.822477065265182e-05,15,0.0001420925496139819
4922,development,23,4.2238415655393294e-05,21,4.784002296321102e-05,2,1.8945673281864254e-05
4991,werent,23,4.2238415655393294e-05,21,4.784002296321102e-05,2,1.8945673281864254e-05
5187,includes,23,4.2238415655393294e-05,18,4.100573396846659e-05,5,4.736418320466063e-05
5458,ted,23,4.2238415655393294e-05,21,4.784002296321102e-05,2,1.8945673281864254e-05
5471,thrown,23,4.2238415655393294e-05,22,5.01181192947925e-05,1,9.472836640932127e-06
6082,400,23,4.2238415655393294e-05,18,4.100573396846659e-05,5,4.736418320466063e-05
6149,patients,23,4.2238415655393294e-05,21,4.784002296321102e-05,2,1.8945673281864254e-05
6996,fail,23,4.2238415655393294e-05,21,4.784002296321102e-05,2,1.8945673281864254e-05
7177,kansas,23,4.2238415655393294e-05,22,5.01181192947925e-05,1,9.472836640932127e-06
7802,#hc09,23,4.2238415655393294e-05,0,0,23,0.00021787524274143893
8098,doug,23,4.2238415655393294e-05,23,5.239621562637398e-05,0,0
8152,swine,23,4.2238415655393294e-05,23,5.239621562637398e-05,0,0
8210,mine,23,4.2238415655393294e-05,23,5.239621562637398e-05,0,0
8236,maine,23,4.2238415655393294e-05,23,5.239621562637398e-05,0,0
8492,thugs,23,4.2238415655393294e-05,23,5.239621562637398e-05,0,0
8576,mattis,23,4.2238415655393294e-05,23,5.239621562637398e-05,0,0
8583,rasmussen,23,4.2238415655393294e-05,23,5.239621562637398e-05,0,0
8596,verification,23,4.2238415655393294e-05,23,5.239621562637398e-05,0,0
8824,witness,23,4.2238415655393294e-05,23,5.239621562637398e-05,0,0
8990,author,23,4.2238415655393294e-05,23,5.239621562637398e-05,0,0
9070,reporter,23,4.2238415655393294e-05,23,5.239621562637398e-05,0,0
9233,tim,23,4.2238415655393294e-05,23,5.239621562637398e-05,0,0
9447,5th,23,4.2238415655393294e-05,23,5.239621562637398e-05,0,0
9561,mccain,23,4.2238415655393294e-05,23,5.239621562637398e-05,0,0
9922,meddling,23,4.2238415655393294e-05,23,5.239621562637398e-05,0,0
9990,concerned,23,4.2238415655393294e-05,23,5.239621562637398e-05,0,0
10827,wounded,23,4.2238415655393294e-05,23,5.239621562637398e-05,0,0
11379,agricultural,23,4.2238415655393294e-05,23,5.239621562637398e-05,0,0
11449,pastor,23,4.2238415655393294e-05,23,5.239621562637398e-05,0,0
11554,london,23,4.2238415655393294e-05,23,5.239621562637398e-05,0,0
12005,h,23,4.2238415655393294e-05,23,5.239621562637398e-05,0,0
12486,steele,23,4.2238415655393294e-05,23,5.239621562637398e-05,0,0
13266,optimism,23,4.2238415655393294e-05,23,5.239621562637398e-05,0,0
13,tune,22,4.0401962800810976e-05,5,1.1390481657907387e-05,17,0.00016103822289584616
52,31,22,4.0401962800810976e-05,11,2.505905964739625e-05,11,0.0001042012030502534
85,merry,22,4.0401962800810976e-05,11,2.505905964739625e-05,11,0.0001042012030502534
119,grassroots,22,4.0401962800810976e-05,1,2.2780963315814773e-06,21,0.00019892956945957466
228,common-sense,22,4.0401962800810976e-05,0,0,22,0.0002084024061005068
258,devastating,22,4.0401962800810976e-05,20,4.556192663162955e-05,2,1.8945673281864254e-05
332,keeps,22,4.0401962800810976e-05,19,4.328383030004807e-05,3,2.8418509922796382e-05
476,private-sector,22,4.0401962800810976e-05,0,0,22,0.0002084024061005068
729,daughter,22,4.0401962800810976e-05,16,3.644954130530364e-05,6,5.6837019845592764e-05
763,universal,22,4.0401962800810976e-05,6,1.3668577989488863e-05,16,0.00015156538625491403
849,helps,22,4.0401962800810976e-05,8,1.822477065265182e-05,14,0.0001326197129730498
1108,mass,22,4.0401962800810976e-05,20,4.556192663162955e-05,2,1.8945673281864254e-05
1202,economics,22,4.0401962800810976e-05,4,9.11238532632591e-06,18,0.0001705110595367783
1339,goal,22,4.0401962800810976e-05,7,1.5946674321070342e-05,15,0.0001420925496139819
1464,anger,22,4.0401962800810976e-05,21,4.784002296321102e-05,1,9.472836640932127e-06
1583,photos,22,4.0401962800810976e-05,3,6.8342889947444315e-06,19,0.00017998389617771042
1781,@dhsgov,22,4.0401962800810976e-05,21,4.784002296321102e-05,1,9.472836640932127e-06
2144,catch,22,4.0401962800810976e-05,18,4.100573396846659e-05,4,3.789134656372851e-05
2275,pledge,22,4.0401962800810976e-05,17,3.8727637636885116e-05,5,4.736418320466063e-05
2371,importance,22,4.0401962800810976e-05,13,2.9615252310559205e-05,9,8.525552976838915e-05
2479,planning,22,4.0401962800810976e-05,20,4.556192663162955e-05,2,1.8945673281864254e-05
2724,lucky,22,4.0401962800810976e-05,17,3.8727637636885116e-05,5,4.736418320466063e-05
2729,tragedy,22,4.0401962800810976e-05,14,3.1893348642140685e-05,8,7.578269312745701e-05
2809,#getcoverednow,22,4.0401962800810976e-05,0,0,22,0.0002084024061005068
2841,winners,22,4.0401962800810976e-05,18,4.100573396846659e-05,4,3.789134656372851e-05
2976,joined,22,4.0401962800810976e-05,17,3.8727637636885116e-05,5,4.736418320466063e-05
3124,pete,22,4.0401962800810976e-05,20,4.556192663162955e-05,2,1.8945673281864254e-05
3193,partners,22,4.0401962800810976e-05,20,4.556192663162955e-05,2,1.8945673281864254e-05
3263,officially,22,4.0401962800810976e-05,18,4.100573396846659e-05,4,3.789134656372851e-05
3293,inside,22,4.0401962800810976e-05,19,4.328383030004807e-05,3,2.8418509922796382e-05
3412,illinois,22,4.0401962800810976e-05,19,4.328383030004807e-05,3,2.8418509922796382e-05
3553,realize,22,4.0401962800810976e-05,21,4.784002296321102e-05,1,9.472836640932127e-06
3596,charged,22,4.0401962800810976e-05,20,4.556192663162955e-05,2,1.8945673281864254e-05
3661,tour,22,4.0401962800810976e-05,16,3.644954130530364e-05,6,5.6837019845592764e-05
3680,memory,22,4.0401962800810976e-05,17,3.8727637636885116e-05,5,4.736418320466063e-05
3745,johnson,22,4.0401962800810976e-05,20,4.556192663162955e-05,2,1.8945673281864254e-05
3748,homes,22,4.0401962800810976e-05,16,3.644954130530364e-05,6,5.6837019845592764e-05
3965,paper,22,4.0401962800810976e-05,18,4.100573396846659e-05,4,3.789134656372851e-05
3976,performance,22,4.0401962800810976e-05,17,3.8727637636885116e-05,5,4.736418320466063e-05
4012,hike,22,4.0401962800810976e-05,11,2.505905964739625e-05,11,0.0001042012030502534
4138,prayer,22,4.0401962800810976e-05,20,4.556192663162955e-05,2,1.8945673281864254e-05
4232,m,22,4.0401962800810976e-05,20,4.556192663162955e-05,2,1.8945673281864254e-05
4339,courageous,22,4.0401962800810976e-05,21,4.784002296321102e-05,1,9.472836640932127e-06
4672,ny,22,4.0401962800810976e-05,21,4.784002296321102e-05,1,9.472836640932127e-06
4721,tool,22,4.0401962800810976e-05,16,3.644954130530364e-05,6,5.6837019845592764e-05
4893,nights,22,4.0401962800810976e-05,11,2.505905964739625e-05,11,0.0001042012030502534
5201,pitch,22,4.0401962800810976e-05,3,6.8342889947444315e-06,19,0.00017998389617771042
5407,motors,22,4.0401962800810976e-05,18,4.100573396846659e-05,4,3.789134656372851e-05
5486,sell,22,4.0401962800810976e-05,20,4.556192663162955e-05,2,1.8945673281864254e-05
5698,comeback,22,4.0401962800810976e-05,18,4.100573396846659e-05,4,3.789134656372851e-05
6061,afraid,22,4.0401962800810976e-05,20,4.556192663162955e-05,2,1.8945673281864254e-05
6773,orders,22,4.0401962800810976e-05,21,4.784002296321102e-05,1,9.472836640932127e-06
7244,books,22,4.0401962800810976e-05,20,4.556192663162955e-05,2,1.8945673281864254e-05
7408,edwards,22,4.0401962800810976e-05,21,4.784002296321102e-05,1,9.472836640932127e-06
7880,info,22,4.0401962800810976e-05,21,4.784002296321102e-05,1,9.472836640932127e-06
7962,unconstitutional,22,4.0401962800810976e-05,22,5.01181192947925e-05,0,0
8004,rino,22,4.0401962800810976e-05,22,5.01181192947925e-05,0,0
8065,fighters,22,4.0401962800810976e-05,22,5.01181192947925e-05,0,0
8126,increases,22,4.0401962800810976e-05,22,5.01181192947925e-05,0,0
8134,establishment,22,4.0401962800810976e-05,22,5.01181192947925e-05,0,0
8155,protest,22,4.0401962800810976e-05,22,5.01181192947925e-05,0,0
8201,unfortunately,22,4.0401962800810976e-05,22,5.01181192947925e-05,0,0
8267,primaries,22,4.0401962800810976e-05,22,5.01181192947925e-05,0,0
8294,completed,22,4.0401962800810976e-05,22,5.01181192947925e-05,0,0
8594,brad,22,4.0401962800810976e-05,22,5.01181192947925e-05,0,0
8670,hospitals,22,4.0401962800810976e-05,22,5.01181192947925e-05,0,0
8679,utah,22,4.0401962800810976e-05,22,5.01181192947925e-05,0,0
8793,silent,22,4.0401962800810976e-05,22,5.01181192947925e-05,0,0
8834,@varneyco,22,4.0401962800810976e-05,22,5.01181192947925e-05,0,0
8943,republic,22,4.0401962800810976e-05,22,5.01181192947925e-05,0,0
9469,graham,22,4.0401962800810976e-05,22,5.01181192947925e-05,0,0
9519,2a,22,4.0401962800810976e-05,22,5.01181192947925e-05,0,0
9698,chaos,22,4.0401962800810976e-05,22,5.01181192947925e-05,0,0
9904,impeached,22,4.0401962800810976e-05,22,5.01181192947925e-05,0,0
9937,caravans,22,4.0401962800810976e-05,22,5.01181192947925e-05,0,0
10023,investigations,22,4.0401962800810976e-05,22,5.01181192947925e-05,0,0
10351,upon,22,4.0401962800810976e-05,22,5.01181192947925e-05,0,0
10392,stocks,22,4.0401962800810976e-05,22,5.01181192947925e-05,0,0
10483,chain,22,4.0401962800810976e-05,22,5.01181192947925e-05,0,0
14538,#usa🇺🇸,22,4.0401962800810976e-05,22,5.01181192947925e-05,0,0
16491,cohen,22,4.0401962800810976e-05,22,5.01181192947925e-05,0,0
70,seven,21,3.856550994622866e-05,17,3.8727637636885116e-05,4,3.789134656372851e-05
103,2015,21,3.856550994622866e-05,8,1.822477065265182e-05,13,0.00012314687633211766
316,deniers,21,3.856550994622866e-05,1,2.2780963315814773e-06,20,0.00018945673281864253
336,track,21,3.856550994622866e-05,15,3.417144497372216e-05,6,5.6837019845592764e-05
572,lowering,21,3.856550994622866e-05,18,4.100573396846659e-05,3,2.8418509922796382e-05
930,gift,21,3.856550994622866e-05,18,4.100573396846659e-05,3,2.8418509922796382e-05
1096,recognize,21,3.856550994622866e-05,17,3.8727637636885116e-05,4,3.789134656372851e-05
1100,invest,21,3.856550994622866e-05,6,1.3668577989488863e-05,15,0.0001420925496139819
1177,fourth,21,3.856550994622866e-05,11,2.505905964739625e-05,10,9.472836640932126e-05
1553,offer,21,3.856550994622866e-05,12,2.7337155978977726e-05,9,8.525552976838915e-05
1599,wealthy,21,3.856550994622866e-05,5,1.1390481657907387e-05,16,0.00015156538625491403
1798,deny,21,3.856550994622866e-05,5,1.1390481657907387e-05,16,0.00015156538625491403
1861,teams,21,3.856550994622866e-05,19,4.328383030004807e-05,2,1.8945673281864254e-05
1873,drive,21,3.856550994622866e-05,15,3.417144497372216e-05,6,5.6837019845592764e-05
1916,pace,21,3.856550994622866e-05,16,3.644954130530364e-05,5,4.736418320466063e-05
1951,annual,21,3.856550994622866e-05,13,2.9615252310559205e-05,8,7.578269312745701e-05
2013,review,21,3.856550994622866e-05,16,3.644954130530364e-05,5,4.736418320466063e-05
2066,fixing,21,3.856550994622866e-05,15,3.417144497372216e-05,6,5.6837019845592764e-05
2153,island,21,3.856550994622866e-05,19,4.328383030004807e-05,2,1.8945673281864254e-05
2191,announcement,21,3.856550994622866e-05,14,3.1893348642140685e-05,7,6.63098564865249e-05
2250,marine,21,3.856550994622866e-05,18,4.100573396846659e-05,3,2.8418509922796382e-05
2345,mission,21,3.856550994622866e-05,12,2.7337155978977726e-05,9,8.525552976838915e-05
2375,brown,21,3.856550994622866e-05,19,4.328383030004807e-05,2,1.8945673281864254e-05
2604,groups,21,3.856550994622866e-05,17,3.8727637636885116e-05,4,3.789134656372851e-05
2701,staying,21,3.856550994622866e-05,15,3.417144497372216e-05,6,5.6837019845592764e-05
2857,loud,21,3.856550994622866e-05,17,3.8727637636885116e-05,4,3.789134656372851e-05
2998,sold,21,3.856550994622866e-05,17,3.8727637636885116e-05,4,3.789134656372851e-05
3013,table,21,3.856550994622866e-05,12,2.7337155978977726e-05,9,8.525552976838915e-05
3102,neighbors,21,3.856550994622866e-05,14,3.1893348642140685e-05,7,6.63098564865249e-05
3103,armed,21,3.856550994622866e-05,17,3.8727637636885116e-05,4,3.789134656372851e-05
3167,amount,21,3.856550994622866e-05,17,3.8727637636885116e-05,4,3.789134656372851e-05
3194,code,21,3.856550994622866e-05,9,2.0502866984233294e-05,12,0.00011367403969118553
3287,vision,21,3.856550994622866e-05,10,2.2780963315814774e-05,11,0.0001042012030502534
3353,supported,21,3.856550994622866e-05,12,2.7337155978977726e-05,9,8.525552976838915e-05
3410,gain,21,3.856550994622866e-05,18,4.100573396846659e-05,3,2.8418509922796382e-05
3517,costly,21,3.856550994622866e-05,20,4.556192663162955e-05,1,9.472836640932127e-06
3564,standards,21,3.856550994622866e-05,9,2.0502866984233294e-05,12,0.00011367403969118553
3613,quick,21,3.856550994622866e-05,12,2.7337155978977726e-05,9,8.525552976838915e-05
3691,tests,21,3.856550994622866e-05,20,4.556192663162955e-05,1,9.472836640932127e-06
3725,base,21,3.856550994622866e-05,20,4.556192663162955e-05,1,9.472836640932127e-06
3843,journalism,21,3.856550994622866e-05,20,4.556192663162955e-05,1,9.472836640932127e-06
3995,yesterdays,21,3.856550994622866e-05,10,2.2780963315814774e-05,11,0.0001042012030502534
4187,streets,21,3.856550994622866e-05,19,4.328383030004807e-05,2,1.8945673281864254e-05
4298,prove,21,3.856550994622866e-05,17,3.8727637636885116e-05,4,3.789134656372851e-05
4705,fan,21,3.856550994622866e-05,19,4.328383030004807e-05,2,1.8945673281864254e-05
4734,interests,21,3.856550994622866e-05,14,3.1893348642140685e-05,7,6.63098564865249e-05
4744,doubling,21,3.856550994622866e-05,5,1.1390481657907387e-05,16,0.00015156538625491403
4781,hed,21,3.856550994622866e-05,3,6.8342889947444315e-06,18,0.0001705110595367783
4832,ad,21,3.856550994622866e-05,18,4.100573396846659e-05,3,2.8418509922796382e-05
4838,tape,21,3.856550994622866e-05,20,4.556192663162955e-05,1,9.472836640932127e-06
4936,sacred,21,3.856550994622866e-05,18,4.100573396846659e-05,3,2.8418509922796382e-05
5283,packed,21,3.856550994622866e-05,20,4.556192663162955e-05,1,9.472836640932127e-06
5435,secured,21,3.856550994622866e-05,19,4.328383030004807e-05,2,1.8945673281864254e-05
5615,extremely,21,3.856550994622866e-05,20,4.556192663162955e-05,1,9.472836640932127e-06
6058,professionals,21,3.856550994622866e-05,19,4.328383030004807e-05,2,1.8945673281864254e-05
6397,sentence,21,3.856550994622866e-05,20,4.556192663162955e-05,1,9.472836640932127e-06
6501,opened,21,3.856550994622866e-05,20,4.556192663162955e-05,1,9.472836640932127e-06
6581,signatures,21,3.856550994622866e-05,20,4.556192663162955e-05,1,9.472836640932127e-06
6627,religious,21,3.856550994622866e-05,18,4.100573396846659e-05,3,2.8418509922796382e-05
6842,version,21,3.856550994622866e-05,19,4.328383030004807e-05,2,1.8945673281864254e-05
6902,possibly,21,3.856550994622866e-05,20,4.556192663162955e-05,1,9.472836640932127e-06
6940,ronald,21,3.856550994622866e-05,20,4.556192663162955e-05,1,9.472836640932127e-06
7227,embassy,21,3.856550994622866e-05,20,4.556192663162955e-05,1,9.472836640932127e-06
8003,landslide,21,3.856550994622866e-05,21,4.784002296321102e-05,0,0
8016,jackson,21,3.856550994622866e-05,21,4.784002296321102e-05,0,0
8140,desperate,21,3.856550994622866e-05,21,4.784002296321102e-05,0,0
8176,particular,21,3.856550994622866e-05,21,4.784002296321102e-05,0,0
8554,equipment,21,3.856550994622866e-05,21,4.784002296321102e-05,0,0
8620,nasdaq,21,3.856550994622866e-05,21,4.784002296321102e-05,0,0
8645,nebraska,21,3.856550994622866e-05,21,4.784002296321102e-05,0,0
9039,coup,21,3.856550994622866e-05,21,4.784002296321102e-05,0,0
9061,omar,21,3.856550994622866e-05,21,4.784002296321102e-05,0,0
9109,@stevehiltonx,21,3.856550994622866e-05,21,4.784002296321102e-05,0,0
9113,independent,21,3.856550994622866e-05,21,4.784002296321102e-05,0,0
9115,compared,21,3.856550994622866e-05,21,4.784002296321102e-05,0,0
9159,unlimited,21,3.856550994622866e-05,21,4.784002296321102e-05,0,0
9261,basis,21,3.856550994622866e-05,21,4.784002296321102e-05,0,0
9497,eu,21,3.856550994622866e-05,21,4.784002296321102e-05,0,0
9504,illegals,21,3.856550994622866e-05,21,4.784002296321102e-05,0,0
10058,remaining,21,3.856550994622866e-05,21,4.784002296321102e-05,0,0
10252,circuit,21,3.856550994622866e-05,21,4.784002296321102e-05,0,0
10301,seem,21,3.856550994622866e-05,21,4.784002296321102e-05,0,0
10408,psycho,21,3.856550994622866e-05,21,4.784002296321102e-05,0,0
10410,probe,21,3.856550994622866e-05,21,4.784002296321102e-05,0,0
10521,crazed,21,3.856550994622866e-05,21,4.784002296321102e-05,0,0
10780,g-7,21,3.856550994622866e-05,21,4.784002296321102e-05,0,0
11060,96,21,3.856550994622866e-05,21,4.784002296321102e-05,0,0
11159,@eddierispone,21,3.856550994622866e-05,21,4.784002296321102e-05,0,0
11604,argentina,21,3.856550994622866e-05,21,4.784002296321102e-05,0,0
11612,schiffs,21,3.856550994622866e-05,21,4.784002296321102e-05,0,0
14942,moon,21,3.856550994622866e-05,21,4.784002296321102e-05,0,0
16679,asylum,21,3.856550994622866e-05,21,4.784002296321102e-05,0,0
19760,paso,21,3.856550994622866e-05,21,4.784002296321102e-05,0,0
129,likely,20,3.6729057091646345e-05,13,2.9615252310559205e-05,7,6.63098564865249e-05
360,wind,20,3.6729057091646345e-05,2,4.556192663162955e-06,18,0.0001705110595367783
358,solar,20,3.6729057091646345e-05,0,0,20,0.00018945673281864253
826,#standwithwomen,20,3.6729057091646345e-05,0,0,20,0.00018945673281864253
872,round,20,3.6729057091646345e-05,14,3.1893348642140685e-05,6,5.6837019845592764e-05
912,medicaid,20,3.6729057091646345e-05,1,2.2780963315814773e-06,19,0.00017998389617771042
1158,journey,20,3.6729057091646345e-05,7,1.5946674321070342e-05,13,0.00012314687633211766
1207,cool,20,3.6729057091646345e-05,14,3.1893348642140685e-05,6,5.6837019845592764e-05
1286,terms,20,3.6729057091646345e-05,19,4.328383030004807e-05,1,9.472836640932127e-06
1304,directly,20,3.6729057091646345e-05,17,3.8727637636885116e-05,3,2.8418509922796382e-05
1605,stood,20,3.6729057091646345e-05,15,3.417144497372216e-05,5,4.736418320466063e-05
1782,fund,20,3.6729057091646345e-05,14,3.1893348642140685e-05,6,5.6837019845592764e-05
1955,december,20,3.6729057091646345e-05,15,3.417144497372216e-05,5,4.736418320466063e-05
2009,bay,20,3.6729057091646345e-05,16,3.644954130530364e-05,4,3.789134656372851e-05
2096,finding,20,3.6729057091646345e-05,17,3.8727637636885116e-05,3,2.8418509922796382e-05
2108,urging,20,3.6729057091646345e-05,11,2.505905964739625e-05,9,8.525552976838915e-05
2257,#climate,20,3.6729057091646345e-05,0,0,20,0.00018945673281864253
2474,70,20,3.6729057091646345e-05,18,4.100573396846659e-05,2,1.8945673281864254e-05
2599,doors,20,3.6729057091646345e-05,7,1.5946674321070342e-05,13,0.00012314687633211766
2667,felt,20,3.6729057091646345e-05,15,3.417144497372216e-05,5,4.736418320466063e-05
2669,moved,20,3.6729057091646345e-05,17,3.8727637636885116e-05,3,2.8418509922796382e-05
2790,fill,20,3.6729057091646345e-05,11,2.505905964739625e-05,9,8.525552976838915e-05
3122,2011,20,3.6729057091646345e-05,4,9.11238532632591e-06,16,0.00015156538625491403
3156,jr,20,3.6729057091646345e-05,15,3.417144497372216e-05,5,4.736418320466063e-05
3172,100000,20,3.6729057091646345e-05,12,2.7337155978977726e-05,8,7.578269312745701e-05
3243,ground,20,3.6729057091646345e-05,16,3.644954130530364e-05,4,3.789134656372851e-05
3250,seriously,20,3.6729057091646345e-05,17,3.8727637636885116e-05,3,2.8418509922796382e-05
3552,opponents,20,3.6729057091646345e-05,16,3.644954130530364e-05,4,3.789134656372851e-05
3615,lack,20,3.6729057091646345e-05,19,4.328383030004807e-05,1,9.472836640932127e-06
3931,begins,20,3.6729057091646345e-05,14,3.1893348642140685e-05,6,5.6837019845592764e-05
3937,#immigrationreform,20,3.6729057091646345e-05,0,0,20,0.00018945673281864253
4184,#wedemandavote,20,3.6729057091646345e-05,0,0,20,0.00018945673281864253
4350,text,20,3.6729057091646345e-05,14,3.1893348642140685e-05,6,5.6837019845592764e-05
4387,purpose,20,3.6729057091646345e-05,17,3.8727637636885116e-05,3,2.8418509922796382e-05
4428,scheduled,20,3.6729057091646345e-05,19,4.328383030004807e-05,1,9.472836640932127e-06
4474,mandate,20,3.6729057091646345e-05,15,3.417144497372216e-05,5,4.736418320466063e-05
4607,josh,20,3.6729057091646345e-05,19,4.328383030004807e-05,1,9.472836640932127e-06
4717,volunteer,20,3.6729057091646345e-05,13,2.9615252310559205e-05,7,6.63098564865249e-05
4926,tragic,20,3.6729057091646345e-05,13,2.9615252310559205e-05,7,6.63098564865249e-05
5085,notice,20,3.6729057091646345e-05,19,4.328383030004807e-05,1,9.472836640932127e-06
5294,rich,20,3.6729057091646345e-05,17,3.8727637636885116e-05,3,2.8418509922796382e-05
5452,patrick,20,3.6729057091646345e-05,19,4.328383030004807e-05,1,9.472836640932127e-06
5451,interested,20,3.6729057091646345e-05,19,4.328383030004807e-05,1,9.472836640932127e-06
5893,award,20,3.6729057091646345e-05,19,4.328383030004807e-05,1,9.472836640932127e-06
5915,purposes,20,3.6729057091646345e-05,19,4.328383030004807e-05,1,9.472836640932127e-06
6185,walls,20,3.6729057091646345e-05,19,4.328383030004807e-05,1,9.472836640932127e-06
6553,ceremony,20,3.6729057091646345e-05,18,4.100573396846659e-05,2,1.8945673281864254e-05
6601,electoral,20,3.6729057091646345e-05,19,4.328383030004807e-05,1,9.472836640932127e-06
6667,cancel,20,3.6729057091646345e-05,19,4.328383030004807e-05,1,9.472836640932127e-06
6937,garden,20,3.6729057091646345e-05,17,3.8727637636885116e-05,3,2.8418509922796382e-05
7815,hill,20,3.6729057091646345e-05,19,4.328383030004807e-05,1,9.472836640932127e-06
7817,pray,20,3.6729057091646345e-05,19,4.328383030004807e-05,1,9.472836640932127e-06
8013,seldom,20,3.6729057091646345e-05,20,4.556192663162955e-05,0,0
8075,incorrect,20,3.6729057091646345e-05,20,4.556192663162955e-05,0,0
8217,wheres,20,3.6729057091646345e-05,20,4.556192663162955e-05,0,0
8297,andor,20,3.6729057091646345e-05,20,4.556192663162955e-05,0,0
8608,basement,20,3.6729057091646345e-05,20,4.556192663162955e-05,0,0
8702,embarrassment,20,3.6729057091646345e-05,20,4.556192663162955e-05,0,0
9105,ivanka,20,3.6729057091646345e-05,20,4.556192663162955e-05,0,0
9332,phenomenal,20,3.6729057091646345e-05,20,4.556192663162955e-05,0,0
9660,mostly,20,3.6729057091646345e-05,20,4.556192663162955e-05,0,0
9910,demean,20,3.6729057091646345e-05,20,4.556192663162955e-05,0,0
10032,o,20,3.6729057091646345e-05,20,4.556192663162955e-05,0,0
10033,departing,20,3.6729057091646345e-05,20,4.556192663162955e-05,0,0
10485,leaking,20,3.6729057091646345e-05,20,4.556192663162955e-05,0,0
10779,monitoring,20,3.6729057091646345e-05,20,4.556192663162955e-05,0,0
10786,dallas,20,3.6729057091646345e-05,20,4.556192663162955e-05,0,0
10829,@lindseygrahamsc,20,3.6729057091646345e-05,20,4.556192663162955e-05,0,0
10904,@greggjarrett,20,3.6729057091646345e-05,20,4.556192663162955e-05,0,0
11034,aoc,20,3.6729057091646345e-05,20,4.556192663162955e-05,0,0
11043,surveillance,20,3.6729057091646345e-05,20,4.556192663162955e-05,0,0
11121,soooo,20,3.6729057091646345e-05,20,4.556192663162955e-05,0,0
11330,nadler,20,3.6729057091646345e-05,20,4.556192663162955e-05,0,0
11345,2019,20,3.6729057091646345e-05,20,4.556192663162955e-05,0,0
11565,tightening,20,3.6729057091646345e-05,20,4.556192663162955e-05,0,0
11837,#1,20,3.6729057091646345e-05,20,4.556192663162955e-05,0,0
13444,roy,20,3.6729057091646345e-05,20,4.556192663162955e-05,0,0
609,aside,19,3.489260423706403e-05,4,9.11238532632591e-06,15,0.0001420925496139819
620,planet,19,3.489260423706403e-05,7,1.5946674321070342e-05,12,0.00011367403969118553
618,capacity,19,3.489260423706403e-05,14,3.1893348642140685e-05,5,4.736418320466063e-05
624,…,19,3.489260423706403e-05,0,0,19,0.00017998389617771042
671,walk,19,3.489260423706403e-05,9,2.0502866984233294e-05,10,9.472836640932126e-05
685,wasting,19,3.489260423706403e-05,18,4.100573396846659e-05,1,9.472836640932127e-06
717,citizen,19,3.489260423706403e-05,14,3.1893348642140685e-05,5,4.736418320466063e-05
721,investments,19,3.489260423706403e-05,8,1.822477065265182e-05,11,0.0001042012030502534
725,reduced,19,3.489260423706403e-05,13,2.9615252310559205e-05,6,5.6837019845592764e-05
931,jon,19,3.489260423706403e-05,17,3.8727637636885116e-05,2,1.8945673281864254e-05
958,alternative,19,3.489260423706403e-05,18,4.100573396846659e-05,1,9.472836640932127e-06
987,decade,19,3.489260423706403e-05,4,9.11238532632591e-06,15,0.0001420925496139819
1021,fewer,19,3.489260423706403e-05,11,2.505905964739625e-05,8,7.578269312745701e-05
1118,arrested,19,3.489260423706403e-05,18,4.100573396846659e-05,1,9.472836640932127e-06
1276,ruling,19,3.489260423706403e-05,11,2.505905964739625e-05,8,7.578269312745701e-05
1552,experience,19,3.489260423706403e-05,16,3.644954130530364e-05,3,2.8418509922796382e-05
1636,discrimination,19,3.489260423706403e-05,3,6.8342889947444315e-06,16,0.00015156538625491403
1718,ours,19,3.489260423706403e-05,11,2.505905964739625e-05,8,7.578269312745701e-05
1720,fear,19,3.489260423706403e-05,12,2.7337155978977726e-05,7,6.63098564865249e-05
1817,sexual,19,3.489260423706403e-05,5,1.1390481657907387e-05,14,0.0001326197129730498
1879,warmest,19,3.489260423706403e-05,13,2.9615252310559205e-05,6,5.6837019845592764e-05
1906,salute,19,3.489260423706403e-05,16,3.644954130530364e-05,3,2.8418509922796382e-05
1942,online,19,3.489260423706403e-05,11,2.505905964739625e-05,8,7.578269312745701e-05
2095,#thisiswhy,19,3.489260423706403e-05,0,0,19,0.00017998389617771042
2122,champions,19,3.489260423706403e-05,14,3.1893348642140685e-05,5,4.736418320466063e-05
2143,math,19,3.489260423706403e-05,0,0,19,0.00017998389617771042
2205,blocking,19,3.489260423706403e-05,9,2.0502866984233294e-05,10,9.472836640932126e-05
2282,violation,19,3.489260423706403e-05,18,4.100573396846659e-05,1,9.472836640932127e-06
2348,mental,19,3.489260423706403e-05,12,2.7337155978977726e-05,7,6.63098564865249e-05
2393,deepest,19,3.489260423706403e-05,16,3.644954130530364e-05,3,2.8418509922796382e-05
2511,#actonreform,19,3.489260423706403e-05,0,0,19,0.00017998389617771042
2635,fans,19,3.489260423706403e-05,15,3.417144497372216e-05,4,3.789134656372851e-05
2811,sides,19,3.489260423706403e-05,13,2.9615252310559205e-05,6,5.6837019845592764e-05
3174,february,19,3.489260423706403e-05,13,2.9615252310559205e-05,6,5.6837019845592764e-05
3206,priority,19,3.489260423706403e-05,10,2.2780963315814774e-05,9,8.525552976838915e-05
3327,peoples,19,3.489260423706403e-05,11,2.505905964739625e-05,8,7.578269312745701e-05
3490,negotiating,19,3.489260423706403e-05,18,4.100573396846659e-05,1,9.472836640932127e-06
3578,constitutional,19,3.489260423706403e-05,18,4.100573396846659e-05,1,9.472836640932127e-06
4104,#demandaction,19,3.489260423706403e-05,0,0,19,0.00017998389617771042
4145,apple,19,3.489260423706403e-05,18,4.100573396846659e-05,1,9.472836640932127e-06
4384,arms,19,3.489260423706403e-05,18,4.100573396846659e-05,1,9.472836640932127e-06
4411,proclamation,19,3.489260423706403e-05,18,4.100573396846659e-05,1,9.472836640932127e-06
4488,reduction,19,3.489260423706403e-05,13,2.9615252310559205e-05,6,5.6837019845592764e-05
4519,surprise,19,3.489260423706403e-05,18,4.100573396846659e-05,1,9.472836640932127e-06
4745,grants,19,3.489260423706403e-05,9,2.0502866984233294e-05,10,9.472836640932126e-05
4819,vegas,19,3.489260423706403e-05,17,3.8727637636885116e-05,2,1.8945673281864254e-05
4849,#romnesia,19,3.489260423706403e-05,0,0,19,0.00017998389617771042
4932,strategy,19,3.489260423706403e-05,13,2.9615252310559205e-05,6,5.6837019845592764e-05
5033,campaigning,19,3.489260423706403e-05,17,3.8727637636885116e-05,2,1.8945673281864254e-05
5042,vs,19,3.489260423706403e-05,14,3.1893348642140685e-05,5,4.736418320466063e-05
5132,minute,19,3.489260423706403e-05,12,2.7337155978977726e-05,7,6.63098564865249e-05
5238,property,19,3.489260423706403e-05,17,3.8727637636885116e-05,2,1.8945673281864254e-05
5290,45,19,3.489260423706403e-05,13,2.9615252310559205e-05,6,5.6837019845592764e-05
6075,pres,19,3.489260423706403e-05,17,3.8727637636885116e-05,2,1.8945673281864254e-05
6502,quite,19,3.489260423706403e-05,18,4.100573396846659e-05,1,9.472836640932127e-06
6791,battle,19,3.489260423706403e-05,18,4.100573396846659e-05,1,9.472836640932127e-06
6861,veto,19,3.489260423706403e-05,18,4.100573396846659e-05,1,9.472836640932127e-06
6941,warrior,19,3.489260423706403e-05,18,4.100573396846659e-05,1,9.472836640932127e-06
7588,authorities,19,3.489260423706403e-05,18,4.100573396846659e-05,1,9.472836640932127e-06
7805,singapore,19,3.489260423706403e-05,18,4.100573396846659e-05,1,9.472836640932127e-06
8104,observers,19,3.489260423706403e-05,19,4.328383030004807e-05,0,0
8418,pack,19,3.489260423706403e-05,19,4.328383030004807e-05,0,0
8454,conspiracy,19,3.489260423706403e-05,19,4.328383030004807e-05,0,0
8498,articles,19,3.489260423706403e-05,19,4.328383030004807e-05,0,0
8642,seattle,19,3.489260423706403e-05,19,4.328383030004807e-05,0,0
8790,garbage,19,3.489260423706403e-05,19,4.328383030004807e-05,0,0
8856,charles,19,3.489260423706403e-05,19,4.328383030004807e-05,0,0
8884,gee,19,3.489260423706403e-05,19,4.328383030004807e-05,0,0
9154,migration,19,3.489260423706403e-05,19,4.328383030004807e-05,0,0
9171,jones,19,3.489260423706403e-05,19,4.328383030004807e-05,0,0
9441,legally,19,3.489260423706403e-05,19,4.328383030004807e-05,0,0
9466,handled,19,3.489260423706403e-05,19,4.328383030004807e-05,0,0
9825,➡️,19,3.489260423706403e-05,19,4.328383030004807e-05,0,0
10076,bel,19,3.489260423706403e-05,19,4.328383030004807e-05,0,0
10276,charlie,19,3.489260423706403e-05,19,4.328383030004807e-05,0,0
11603,aluminum,19,3.489260423706403e-05,19,4.328383030004807e-05,0,0
12313,leaks,19,3.489260423706403e-05,19,4.328383030004807e-05,0,0
12869,rocket,19,3.489260423706403e-05,19,4.328383030004807e-05,0,0
13079,@abeshinzo,19,3.489260423706403e-05,19,4.328383030004807e-05,0,0
13094,ed,19,3.489260423706403e-05,19,4.328383030004807e-05,0,0
13122,lottery,19,3.489260423706403e-05,19,4.328383030004807e-05,0,0
13225,exact,19,3.489260423706403e-05,19,4.328383030004807e-05,0,0
13719,wasted,19,3.489260423706403e-05,19,4.328383030004807e-05,0,0
14862,#fakenews,19,3.489260423706403e-05,19,4.328383030004807e-05,0,0
17058,bishop,19,3.489260423706403e-05,19,4.328383030004807e-05,0,0
116,view,18,3.305615138248171e-05,11,2.505905964739625e-05,7,6.63098564865249e-05
314,excuses,18,3.305615138248171e-05,14,3.1893348642140685e-05,4,3.789134656372851e-05
380,honoring,18,3.305615138248171e-05,12,2.7337155978977726e-05,6,5.6837019845592764e-05
455,falling,18,3.305615138248171e-05,16,3.644954130530364e-05,2,1.8945673281864254e-05
556,gained,18,3.305615138248171e-05,10,2.2780963315814774e-05,8,7.578269312745701e-05
951,apply,18,3.305615138248171e-05,9,2.0502866984233294e-05,9,8.525552976838915e-05
1031,fell,18,3.305615138248171e-05,10,2.2780963315814774e-05,8,7.578269312745701e-05
1175,cup,18,3.305615138248171e-05,13,2.9615252310559205e-05,5,4.736418320466063e-05
1334,tribute,18,3.305615138248171e-05,10,2.2780963315814774e-05,8,7.578269312745701e-05
1541,increasing,18,3.305615138248171e-05,10,2.2780963315814774e-05,8,7.578269312745701e-05
1601,believes,18,3.305615138248171e-05,10,2.2780963315814774e-05,8,7.578269312745701e-05
1647,creation,18,3.305615138248171e-05,7,1.5946674321070342e-05,11,0.0001042012030502534
1799,lawmakers,18,3.305615138248171e-05,11,2.505905964739625e-05,7,6.63098564865249e-05
1892,earn,18,3.305615138248171e-05,1,2.2780963315814773e-06,17,0.00016103822289584616
1899,link,18,3.305615138248171e-05,3,6.8342889947444315e-06,15,0.0001420925496139819
2008,delivers,18,3.305615138248171e-05,10,2.2780963315814774e-05,8,7.578269312745701e-05
2057,latest,18,3.305615138248171e-05,9,2.0502866984233294e-05,9,8.525552976838915e-05
2106,traffic,18,3.305615138248171e-05,16,3.644954130530364e-05,2,1.8945673281864254e-05
2148,28,18,3.305615138248171e-05,11,2.505905964739625e-05,7,6.63098564865249e-05
2182,lift,18,3.305615138248171e-05,9,2.0502866984233294e-05,9,8.525552976838915e-05
2217,pretty,18,3.305615138248171e-05,14,3.1893348642140685e-05,4,3.789134656372851e-05
2379,doctor,18,3.305615138248171e-05,11,2.505905964739625e-05,7,6.63098564865249e-05
2472,condition,18,3.305615138248171e-05,8,1.822477065265182e-05,10,9.472836640932126e-05
2538,husband,18,3.305615138248171e-05,17,3.8727637636885116e-05,1,9.472836640932127e-06
2761,expect,18,3.305615138248171e-05,13,2.9615252310559205e-05,5,4.736418320466063e-05
2766,earned,18,3.305615138248171e-05,11,2.505905964739625e-05,7,6.63098564865249e-05
2768,maryland,18,3.305615138248171e-05,14,3.1893348642140685e-05,4,3.789134656372851e-05
3077,excited,18,3.305615138248171e-05,12,2.7337155978977726e-05,6,5.6837019845592764e-05
3098,quit,18,3.305615138248171e-05,13,2.9615252310559205e-05,5,4.736418320466063e-05
3111,owners,18,3.305615138248171e-05,10,2.2780963315814774e-05,8,7.578269312745701e-05
3237,turns,18,3.305615138248171e-05,13,2.9615252310559205e-05,5,4.736418320466063e-05
3295,search,18,3.305615138248171e-05,17,3.8727637636885116e-05,1,9.472836640932127e-06
3311,glad,18,3.305615138248171e-05,15,3.417144497372216e-05,3,2.8418509922796382e-05
3358,parties,18,3.305615138248171e-05,10,2.2780963315814774e-05,8,7.578269312745701e-05
3486,hostage,18,3.305615138248171e-05,15,3.417144497372216e-05,3,2.8418509922796382e-05
4142,burn,18,3.305615138248171e-05,17,3.8727637636885116e-05,1,9.472836640932127e-06
4153,buying,18,3.305615138248171e-05,16,3.644954130530364e-05,2,1.8945673281864254e-05
4216,above,18,3.305615138248171e-05,13,2.9615252310559205e-05,5,4.736418320466063e-05
4302,smarter,18,3.305615138248171e-05,16,3.644954130530364e-05,2,1.8945673281864254e-05
4377,inauguration,18,3.305615138248171e-05,13,2.9615252310559205e-05,5,4.736418320466063e-05
4466,balanced,18,3.305615138248171e-05,5,1.1390481657907387e-05,13,0.00012314687633211766
4467,technology,18,3.305615138248171e-05,16,3.644954130530364e-05,2,1.8945673281864254e-05
4478,stake,18,3.305615138248171e-05,4,9.11238532632591e-06,14,0.0001326197129730498
4617,driving,18,3.305615138248171e-05,15,3.417144497372216e-05,3,2.8418509922796382e-05
4694,hiring,18,3.305615138248171e-05,9,2.0502866984233294e-05,9,8.525552976838915e-05
4755,feeling,18,3.305615138248171e-05,12,2.7337155978977726e-05,6,5.6837019845592764e-05
4792,referred,18,3.305615138248171e-05,17,3.8727637636885116e-05,1,9.472836640932127e-06
4807,endorsed,18,3.305615138248171e-05,15,3.417144497372216e-05,3,2.8418509922796382e-05
4817,las,18,3.305615138248171e-05,17,3.8727637636885116e-05,1,9.472836640932127e-06
4856,nick,18,3.305615138248171e-05,17,3.8727637636885116e-05,1,9.472836640932127e-06
4901,depression,18,3.305615138248171e-05,15,3.417144497372216e-05,3,2.8418509922796382e-05
5025,trail,18,3.305615138248171e-05,13,2.9615252310559205e-05,5,4.736418320466063e-05
5295,blue,18,3.305615138248171e-05,15,3.417144497372216e-05,3,2.8418509922796382e-05
5307,hispanics,18,3.305615138248171e-05,17,3.8727637636885116e-05,1,9.472836640932127e-06
5313,entitled,18,3.305615138248171e-05,17,3.8727637636885116e-05,1,9.472836640932127e-06
5338,hosting,18,3.305615138248171e-05,15,3.417144497372216e-05,3,2.8418509922796382e-05
5484,33000,18,3.305615138248171e-05,17,3.8727637636885116e-05,1,9.472836640932127e-06
5490,signs,18,3.305615138248171e-05,14,3.1893348642140685e-05,4,3.789134656372851e-05
5635,acceptable,18,3.305615138248171e-05,17,3.8727637636885116e-05,1,9.472836640932127e-06
5679,orlando,18,3.305615138248171e-05,16,3.644954130530364e-05,2,1.8945673281864254e-05
5754,protected,18,3.305615138248171e-05,16,3.644954130530364e-05,2,1.8945673281864254e-05
5917,professional,18,3.305615138248171e-05,17,3.8727637636885116e-05,1,9.472836640932127e-06
6294,disappointed,18,3.305615138248171e-05,13,2.9615252310559205e-05,5,4.736418320466063e-05
6561,assist,18,3.305615138248171e-05,15,3.417144497372216e-05,3,2.8418509922796382e-05
7049,judicial,18,3.305615138248171e-05,16,3.644954130530364e-05,2,1.8945673281864254e-05
7273,hall,18,3.305615138248171e-05,15,3.417144497372216e-05,3,2.8418509922796382e-05
7707,largely,18,3.305615138248171e-05,17,3.8727637636885116e-05,1,9.472836640932127e-06
7755,elect,18,3.305615138248171e-05,16,3.644954130530364e-05,2,1.8945673281864254e-05
7877,h1n1,18,3.305615138248171e-05,17,3.8727637636885116e-05,1,9.472836640932127e-06
8110,reputation,18,3.305615138248171e-05,18,4.100573396846659e-05,0,0
8174,investigated,18,3.305615138248171e-05,18,4.100573396846659e-05,0,0
8188,nicely,18,3.305615138248171e-05,18,4.100573396846659e-05,0,0
8247,dishonesty,18,3.305615138248171e-05,18,4.100573396846659e-05,0,0
8371,apology,18,3.305615138248171e-05,18,4.100573396846659e-05,0,0
8496,revealed,18,3.305615138248171e-05,18,4.100573396846659e-05,0,0
8524,prevail,18,3.305615138248171e-05,18,4.100573396846659e-05,0,0
8538,forgot,18,3.305615138248171e-05,18,4.100573396846659e-05,0,0
8579,@kilmeade,18,3.305615138248171e-05,18,4.100573396846659e-05,0,0
8669,@msnbc,18,3.305615138248171e-05,18,4.100573396846659e-05,0,0
8810,reveal,18,3.305615138248171e-05,18,4.100573396846659e-05,0,0
8997,islamic,18,3.305615138248171e-05,18,4.100573396846659e-05,0,0
9011,rioters,18,3.305615138248171e-05,18,4.100573396846659e-05,0,0
9052,suburbs,18,3.305615138248171e-05,18,4.100573396846659e-05,0,0
9192,pandemic,18,3.305615138248171e-05,18,4.100573396846659e-05,0,0
9323,coal,18,3.305615138248171e-05,18,4.100573396846659e-05,0,0
9578,evil,18,3.305615138248171e-05,18,4.100573396846659e-05,0,0
9602,accurate,18,3.305615138248171e-05,18,4.100573396846659e-05,0,0
9610,@gopleader,18,3.305615138248171e-05,18,4.100573396846659e-05,0,0
9620,obvious,18,3.305615138248171e-05,18,4.100573396846659e-05,0,0
9689,knowingly,18,3.305615138248171e-05,18,4.100573396846659e-05,0,0
10206,phase,18,3.305615138248171e-05,18,4.100573396846659e-05,0,0
10421,cash,18,3.305615138248171e-05,18,4.100573396846659e-05,0,0
10763,bedminster,18,3.305615138248171e-05,18,4.100573396846659e-05,0,0
10797,receiving,18,3.305615138248171e-05,18,4.100573396846659e-05,0,0
10837,ridiculously,18,3.305615138248171e-05,18,4.100573396846659e-05,0,0
11307,liar,18,3.305615138248171e-05,18,4.100573396846659e-05,0,0
11564,quantitative,18,3.305615138248171e-05,18,4.100573396846659e-05,0,0
11567,tickets,18,3.305615138248171e-05,18,4.100573396846659e-05,0,0
11735,fabricated,18,3.305615138248171e-05,18,4.100573396846659e-05,0,0
11817,caliphate,18,3.305615138248171e-05,18,4.100573396846659e-05,0,0
12202,honduras,18,3.305615138248171e-05,18,4.100573396846659e-05,0,0
12507,regime,18,3.305615138248171e-05,18,4.100573396846659e-05,0,0
12724,eddie,18,3.305615138248171e-05,18,4.100573396846659e-05,0,0
13195,hostages,18,3.305615138248171e-05,18,4.100573396846659e-05,0,0
13607,jewish,18,3.305615138248171e-05,18,4.100573396846659e-05,0,0
13995,runoff,18,3.305615138248171e-05,18,4.100573396846659e-05,0,0
15288,denuclearization,18,3.305615138248171e-05,18,4.100573396846659e-05,0,0
15314,@emmanuelmacron,18,3.305615138248171e-05,18,4.100573396846659e-05,0,0
16545,pompeo,18,3.305615138248171e-05,18,4.100573396846659e-05,0,0
19103,elijah,18,3.305615138248171e-05,18,4.100573396846659e-05,0,0
45,reality,17,3.121969852789939e-05,9,2.0502866984233294e-05,8,7.578269312745701e-05
147,beauty,17,3.121969852789939e-05,16,3.644954130530364e-05,1,9.472836640932127e-06
307,thankful,17,3.121969852789939e-05,11,2.505905964739625e-05,6,5.6837019845592764e-05
392,volunteers,17,3.121969852789939e-05,2,4.556192663162955e-06,15,0.0001420925496139819
459,consumers,17,3.121969852789939e-05,11,2.505905964739625e-05,6,5.6837019845592764e-05
515,taxpayer,17,3.121969852789939e-05,12,2.7337155978977726e-05,5,4.736418320466063e-05
591,75,17,3.121969852789939e-05,12,2.7337155978977726e-05,5,4.736418320466063e-05
743,data,17,3.121969852789939e-05,15,3.417144497372216e-05,2,1.8945673281864254e-05
746,value,17,3.121969852789939e-05,13,2.9615252310559205e-05,4,3.789134656372851e-05
842,waters,17,3.121969852789939e-05,15,3.417144497372216e-05,2,1.8945673281864254e-05
940,achievement,17,3.121969852789939e-05,15,3.417144497372216e-05,2,1.8945673281864254e-05
1087,danger,17,3.121969852789939e-05,16,3.644954130530364e-05,1,9.472836640932127e-06
1341,resources,17,3.121969852789939e-05,12,2.7337155978977726e-05,5,4.736418320466063e-05
1353,original,17,3.121969852789939e-05,16,3.644954130530364e-05,1,9.472836640932127e-06
1358,wise,17,3.121969852789939e-05,15,3.417144497372216e-05,2,1.8945673281864254e-05
1456,accountable,17,3.121969852789939e-05,7,1.5946674321070342e-05,10,9.472836640932126e-05
1628,roads,17,3.121969852789939e-05,9,2.0502866984233294e-05,8,7.578269312745701e-05
1648,innovation,17,3.121969852789939e-05,5,1.1390481657907387e-05,12,0.00011367403969118553
1886,owe,17,3.121969852789939e-05,6,1.3668577989488863e-05,11,0.0001042012030502534
2175,respond,17,3.121969852789939e-05,11,2.505905964739625e-05,6,5.6837019845592764e-05
2212,grows,17,3.121969852789939e-05,4,9.11238532632591e-06,13,0.00012314687633211766
2214,thriving,17,3.121969852789939e-05,10,2.2780963315814774e-05,7,6.63098564865249e-05
2218,#equalpay,17,3.121969852789939e-05,0,0,17,0.00016103822289584616
2246,originally,17,3.121969852789939e-05,16,3.644954130530364e-05,1,9.472836640932127e-06
2415,lawsuit,17,3.121969852789939e-05,16,3.644954130530364e-05,1,9.472836640932127e-06
2432,jack,17,3.121969852789939e-05,15,3.417144497372216e-05,2,1.8945673281864254e-05
2506,24,17,3.121969852789939e-05,10,2.2780963315814774e-05,7,6.63098564865249e-05
2643,v,17,3.121969852789939e-05,7,1.5946674321070342e-05,10,9.472836640932126e-05
2695,#renewui,17,3.121969852789939e-05,0,0,17,0.00016103822289584616
2820,tweets,17,3.121969852789939e-05,11,2.505905964739625e-05,6,5.6837019845592764e-05
2881,demanding,17,3.121969852789939e-05,12,2.7337155978977726e-05,5,4.736418320466063e-05
3114,neither,17,3.121969852789939e-05,14,3.1893348642140685e-05,3,2.8418509922796382e-05
3135,launched,17,3.121969852789939e-05,8,1.822477065265182e-05,9,8.525552976838915e-05
3159,martin,17,3.121969852789939e-05,11,2.505905964739625e-05,6,5.6837019845592764e-05
3190,assistance,17,3.121969852789939e-05,15,3.417144497372216e-05,2,1.8945673281864254e-05
3557,wealthiest,17,3.121969852789939e-05,0,0,17,0.00016103822289584616
3610,regarding,17,3.121969852789939e-05,16,3.644954130530364e-05,1,9.472836640932127e-06
3669,baseball,17,3.121969852789939e-05,14,3.1893348642140685e-05,3,2.8418509922796382e-05
3718,housing,17,3.121969852789939e-05,12,2.7337155978977726e-05,5,4.736418320466063e-05
3781,korean,17,3.121969852789939e-05,16,3.644954130530364e-05,1,9.472836640932127e-06
3822,dog,17,3.121969852789939e-05,12,2.7337155978977726e-05,5,4.736418320466063e-05
3871,eliminate,17,3.121969852789939e-05,11,2.505905964739625e-05,6,5.6837019845592764e-05
3872,taxpayers,17,3.121969852789939e-05,14,3.1893348642140685e-05,3,2.8418509922796382e-05
4041,devastated,17,3.121969852789939e-05,16,3.644954130530364e-05,1,9.472836640932127e-06
4070,april,17,3.121969852789939e-05,13,2.9615252310559205e-05,4,3.789134656372851e-05
4386,express,17,3.121969852789939e-05,15,3.417144497372216e-05,2,1.8945673281864254e-05
4425,sen,17,3.121969852789939e-05,12,2.7337155978977726e-05,5,4.736418320466063e-05
4443,compromise,17,3.121969852789939e-05,3,6.8342889947444315e-06,14,0.0001326197129730498
4452,powers,17,3.121969852789939e-05,16,3.644954130530364e-05,1,9.472836640932127e-06
4503,pardon,17,3.121969852789939e-05,16,3.644954130530364e-05,1,9.472836640932127e-06
4600,recover,17,3.121969852789939e-05,15,3.417144497372216e-05,2,1.8945673281864254e-05
4723,chrysler,17,3.121969852789939e-05,10,2.2780963315814774e-05,7,6.63098564865249e-05
4731,re-election,17,3.121969852789939e-05,14,3.1893348642140685e-05,3,2.8418509922796382e-05
4827,la,17,3.121969852789939e-05,14,3.1893348642140685e-05,3,2.8418509922796382e-05
5015,destroying,17,3.121969852789939e-05,16,3.644954130530364e-05,1,9.472836640932127e-06
5358,beach,17,3.121969852789939e-05,16,3.644954130530364e-05,1,9.472836640932127e-06
5756,homeless,17,3.121969852789939e-05,16,3.644954130530364e-05,1,9.472836640932127e-06
6039,nominated,17,3.121969852789939e-05,15,3.417144497372216e-05,2,1.8945673281864254e-05
6085,loaded,17,3.121969852789939e-05,13,2.9615252310559205e-05,4,3.789134656372851e-05
6213,operation,17,3.121969852789939e-05,16,3.644954130530364e-05,1,9.472836640932127e-06
6522,placed,17,3.121969852789939e-05,16,3.644954130530364e-05,1,9.472836640932127e-06
7043,counted,17,3.121969852789939e-05,16,3.644954130530364e-05,1,9.472836640932127e-06
7389,returning,17,3.121969852789939e-05,15,3.417144497372216e-05,2,1.8945673281864254e-05
7494,unity,17,3.121969852789939e-05,16,3.644954130530364e-05,1,9.472836640932127e-06
7545,suffering,17,3.121969852789939e-05,16,3.644954130530364e-05,1,9.472836640932127e-06
7604,region,17,3.121969852789939e-05,16,3.644954130530364e-05,1,9.472836640932127e-06
7663,larger,17,3.121969852789939e-05,16,3.644954130530364e-05,1,9.472836640932127e-06
7695,rarely,17,3.121969852789939e-05,16,3.644954130530364e-05,1,9.472836640932127e-06
7774,gathered,17,3.121969852789939e-05,16,3.644954130530364e-05,1,9.472836640932127e-06
7827,doctors,17,3.121969852789939e-05,16,3.644954130530364e-05,1,9.472836640932127e-06
7931,dominion,17,3.121969852789939e-05,17,3.8727637636885116e-05,0,0
7958,plague,17,3.121969852789939e-05,17,3.8727637636885116e-05,0,0
7965,@jessebwatters,17,3.121969852789939e-05,17,3.8727637636885116e-05,0,0
7967,fraudulently,17,3.121969852789939e-05,17,3.8727637636885116e-05,0,0
8234,produced,17,3.121969852789939e-05,17,3.8727637636885116e-05,0,0
8518,stopping,17,3.121969852789939e-05,17,3.8727637636885116e-05,0,0
8762,networks,17,3.121969852789939e-05,17,3.8727637636885116e-05,0,0
8863,monuments,17,3.121969852789939e-05,17,3.8727637636885116e-05,0,0
8893,karen,17,3.121969852789939e-05,17,3.8727637636885116e-05,0,0
8959,surprised,17,3.121969852789939e-05,17,3.8727637636885116e-05,0,0
9013,socialist,17,3.121969852789939e-05,17,3.8727637636885116e-05,0,0
9048,woodward,17,3.121969852789939e-05,17,3.8727637636885116e-05,0,0
9047,proper,17,3.121969852789939e-05,17,3.8727637636885116e-05,0,0
9107,1100,17,3.121969852789939e-05,17,3.8727637636885116e-05,0,0
9174,details,17,3.121969852789939e-05,17,3.8727637636885116e-05,0,0
9254,upset,17,3.121969852789939e-05,17,3.8727637636885116e-05,0,0
9467,laughing,17,3.121969852789939e-05,17,3.8727637636885116e-05,0,0
9568,italy,17,3.121969852789939e-05,17,3.8727637636885116e-05,0,0
9637,blew,17,3.121969852789939e-05,17,3.8727637636885116e-05,0,0
9668,controlled,17,3.121969852789939e-05,17,3.8727637636885116e-05,0,0
10546,msnbc,17,3.121969852789939e-05,17,3.8727637636885116e-05,0,0
10559,flow,17,3.121969852789939e-05,17,3.8727637636885116e-05,0,0
10694,rogue,17,3.121969852789939e-05,17,3.8727637636885116e-05,0,0
10742,pour,17,3.121969852789939e-05,17,3.8727637636885116e-05,0,0
10761,complaining,17,3.121969852789939e-05,17,3.8727637636885116e-05,0,0
10773,commerce,17,3.121969852789939e-05,17,3.8727637636885116e-05,0,0
10863,negotiation,17,3.121969852789939e-05,17,3.8727637636885116e-05,0,0
11140,reed,17,3.121969852789939e-05,17,3.8727637636885116e-05,0,0
11368,subjects,17,3.121969852789939e-05,17,3.8727637636885116e-05,0,0
11471,management,17,3.121969852789939e-05,17,3.8727637636885116e-05,0,0
11949,causing,17,3.121969852789939e-05,17,3.8727637636885116e-05,0,0
13020,intel,17,3.121969852789939e-05,17,3.8727637636885116e-05,0,0
13043,r,17,3.121969852789939e-05,17,3.8727637636885116e-05,0,0
16428,barrier,17,3.121969852789939e-05,17,3.8727637636885116e-05,0,0
132,@ofa,16,2.9383245673317074e-05,0,0,16,0.00015156538625491403
263,repealing,16,2.9383245673317074e-05,2,4.556192663162955e-06,14,0.0001326197129730498
412,advanced,16,2.9383245673317074e-05,11,2.505905964739625e-05,5,4.736418320466063e-05
466,meaningful,16,2.9383245673317074e-05,11,2.505905964739625e-05,5,4.736418320466063e-05
779,scientists,16,2.9383245673317074e-05,7,1.5946674321070342e-05,9,8.525552976838915e-05
841,lands,16,2.9383245673317074e-05,14,3.1893348642140685e-05,2,1.8945673281864254e-05
949,weapon,16,2.9383245673317074e-05,12,2.7337155978977726e-05,4,3.789134656372851e-05
1103,twice,16,2.9383245673317074e-05,11,2.505905964739625e-05,5,4.736418320466063e-05
1221,#lovewins,16,2.9383245673317074e-05,0,0,16,0.00015156538625491403
1300,recognized,16,2.9383245673317074e-05,14,3.1893348642140685e-05,2,1.8945673281864254e-05
1340,hawaii,16,2.9383245673317074e-05,11,2.505905964739625e-05,5,4.736418320466063e-05
1393,98,16,2.9383245673317074e-05,0,0,16,0.00015156538625491403
1431,session,16,2.9383245673317074e-05,13,2.9615252310559205e-05,3,2.8418509922796382e-05
1463,#tbt,16,2.9383245673317074e-05,1,2.2780963315814773e-06,15,0.0001420925496139819
1503,sworn,16,2.9383245673317074e-05,10,2.2780963315814774e-05,6,5.6837019845592764e-05
1641,unbelievable,16,2.9383245673317074e-05,15,3.417144497372216e-05,1,9.472836640932127e-06
1653,confirm,16,2.9383245673317074e-05,10,2.2780963315814774e-05,6,5.6837019845592764e-05
1744,moments,16,2.9383245673317074e-05,8,1.822477065265182e-05,8,7.578269312745701e-05
1786,reminder,16,2.9383245673317074e-05,3,6.8342889947444315e-06,13,0.00012314687633211766
1801,21st,16,2.9383245673317074e-05,4,9.11238532632591e-06,12,0.00011367403969118553
1818,roll,16,2.9383245673317074e-05,9,2.0502866984233294e-05,7,6.63098564865249e-05
1825,recession,16,2.9383245673317074e-05,10,2.2780963315814774e-05,6,5.6837019845592764e-05
1862,odds,16,2.9383245673317074e-05,12,2.7337155978977726e-05,4,3.789134656372851e-05
1915,fastest,16,2.9383245673317074e-05,10,2.2780963315814774e-05,6,5.6837019845592764e-05
2049,#actonjobs,16,2.9383245673317074e-05,0,0,16,0.00015156538625491403
2159,boston,16,2.9383245673317074e-05,11,2.505905964739625e-05,5,4.736418320466063e-05
2237,cancer,16,2.9383245673317074e-05,3,6.8342889947444315e-06,13,0.00012314687633211766
2253,choices,16,2.9383245673317074e-05,5,1.1390481657907387e-05,11,0.0001042012030502534
2269,role,16,2.9383245673317074e-05,12,2.7337155978977726e-05,4,3.789134656372851e-05
2363,rescue,16,2.9383245673317074e-05,13,2.9615252310559205e-05,3,2.8418509922796382e-05
2404,53,16,2.9383245673317074e-05,13,2.9615252310559205e-05,3,2.8418509922796382e-05
2468,direct,16,2.9383245673317074e-05,14,3.1893348642140685e-05,2,1.8945673281864254e-05
2731,wake,16,2.9383245673317074e-05,8,1.822477065265182e-05,8,7.578269312745701e-05
2818,avoid,16,2.9383245673317074e-05,8,1.822477065265182e-05,8,7.578269312745701e-05
3008,scene,16,2.9383245673317074e-05,14,3.1893348642140685e-05,2,1.8945673281864254e-05
3052,39,16,2.9383245673317074e-05,11,2.505905964739625e-05,5,4.736418320466063e-05
3083,learning,16,2.9383245673317074e-05,12,2.7337155978977726e-05,4,3.789134656372851e-05
3140,marks,16,2.9383245673317074e-05,9,2.0502866984233294e-05,7,6.63098564865249e-05
3185,continued,16,2.9383245673317074e-05,12,2.7337155978977726e-05,4,3.789134656372851e-05
3196,determined,16,2.9383245673317074e-05,12,2.7337155978977726e-05,4,3.789134656372851e-05
3348,industries,16,2.9383245673317074e-05,15,3.417144497372216e-05,1,9.472836640932127e-06
3354,deficits,16,2.9383245673317074e-05,10,2.2780963315814774e-05,6,5.6837019845592764e-05
3796,competitive,16,2.9383245673317074e-05,14,3.1893348642140685e-05,2,1.8945673281864254e-05
3873,32,16,2.9383245673317074e-05,14,3.1893348642140685e-05,2,1.8945673281864254e-05
3890,doubled,16,2.9383245673317074e-05,4,9.11238532632591e-06,12,0.00011367403969118553
4231,series,16,2.9383245673317074e-05,11,2.505905964739625e-05,5,4.736418320466063e-05
4238,onto,16,2.9383245673317074e-05,14,3.1893348642140685e-05,2,1.8945673281864254e-05
4318,machine,16,2.9383245673317074e-05,15,3.417144497372216e-05,1,9.472836640932127e-06
4378,oath,16,2.9383245673317074e-05,14,3.1893348642140685e-05,2,1.8945673281864254e-05
4481,debbie,16,2.9383245673317074e-05,14,3.1893348642140685e-05,2,1.8945673281864254e-05
4588,bet,16,2.9383245673317074e-05,8,1.822477065265182e-05,8,7.578269312745701e-05
4620,hoping,16,2.9383245673317074e-05,11,2.505905964739625e-05,5,4.736418320466063e-05
4640,6th,16,2.9383245673317074e-05,12,2.7337155978977726e-05,4,3.789134656372851e-05
4657,gains,16,2.9383245673317074e-05,15,3.417144497372216e-05,1,9.472836640932127e-06
4911,transition,16,2.9383245673317074e-05,14,3.1893348642140685e-05,2,1.8945673281864254e-05
4963,t-shirt,16,2.9383245673317074e-05,1,2.2780963315814773e-06,15,0.0001420925496139819
5029,consider,16,2.9383245673317074e-05,15,3.417144497372216e-05,1,9.472836640932127e-06
5056,22,16,2.9383245673317074e-05,10,2.2780963315814774e-05,6,5.6837019845592764e-05
5066,conversations,16,2.9383245673317074e-05,14,3.1893348642140685e-05,2,1.8945673281864254e-05
5110,gm,16,2.9383245673317074e-05,9,2.0502866984233294e-05,7,6.63098564865249e-05
5142,eight,16,2.9383245673317074e-05,11,2.505905964739625e-05,5,4.736418320466063e-05
5315,comments,16,2.9383245673317074e-05,14,3.1893348642140685e-05,2,1.8945673281864254e-05
5368,combined,16,2.9383245673317074e-05,12,2.7337155978977726e-05,4,3.789134656372851e-05
5418,clintons,16,2.9383245673317074e-05,15,3.417144497372216e-05,1,9.472836640932127e-06
5443,covering,16,2.9383245673317074e-05,15,3.417144497372216e-05,1,9.472836640932127e-06
5585,writing,16,2.9383245673317074e-05,12,2.7337155978977726e-05,4,3.789134656372851e-05
5730,3000,16,2.9383245673317074e-05,11,2.505905964739625e-05,5,4.736418320466063e-05
5947,officer,16,2.9383245673317074e-05,14,3.1893348642140685e-05,2,1.8945673281864254e-05
6054,250,16,2.9383245673317074e-05,12,2.7337155978977726e-05,4,3.789134656372851e-05
6487,brand,16,2.9383245673317074e-05,15,3.417144497372216e-05,1,9.472836640932127e-06
6547,miami,16,2.9383245673317074e-05,14,3.1893348642140685e-05,2,1.8945673281864254e-05
7024,briefed,16,2.9383245673317074e-05,15,3.417144497372216e-05,1,9.472836640932127e-06
7029,granted,16,2.9383245673317074e-05,15,3.417144497372216e-05,1,9.472836640932127e-06
7256,strike,16,2.9383245673317074e-05,14,3.1893348642140685e-05,2,1.8945673281864254e-05
7278,celebration,16,2.9383245673317074e-05,13,2.9615252310559205e-05,3,2.8418509922796382e-05
7406,authorization,16,2.9383245673317074e-05,15,3.417144497372216e-05,1,9.472836640932127e-06
7482,disastrous,16,2.9383245673317074e-05,15,3.417144497372216e-05,1,9.472836640932127e-06
7488,understands,16,2.9383245673317074e-05,15,3.417144497372216e-05,1,9.472836640932127e-06
7746,martha,16,2.9383245673317074e-05,14,3.1893348642140685e-05,2,1.8945673281864254e-05
7922,ineffective,16,2.9383245673317074e-05,16,3.644954130530364e-05,0,0
7984,machines,16,2.9383245673317074e-05,16,3.644954130530364e-05,0,0
8017,ronny,16,2.9383245673317074e-05,16,3.644954130530364e-05,0,0
8087,legislative,16,2.9383245673317074e-05,16,3.644954130530364e-05,0,0
8276,@60minutes,16,2.9383245673317074e-05,16,3.644954130530364e-05,0,0
8405,mentioned,16,2.9383245673317074e-05,16,3.644954130530364e-05,0,0
8417,harris,16,2.9383245673317074e-05,16,3.644954130530364e-05,0,0
8439,suffered,16,2.9383245673317074e-05,16,3.644954130530364e-05,0,0
8444,continuation,16,2.9383245673317074e-05,16,3.644954130530364e-05,0,0
8499,fleeing,16,2.9383245673317074e-05,16,3.644954130530364e-05,0,0
8695,corker,16,2.9383245673317074e-05,16,3.644954130530364e-05,0,0
8727,conflicts,16,2.9383245673317074e-05,16,3.644954130530364e-05,0,0
8883,dumbest,16,2.9383245673317074e-05,16,3.644954130530364e-05,0,0
8920,nowhere,16,2.9383245673317074e-05,16,3.644954130530364e-05,0,0
9007,scarborough,16,2.9383245673317074e-05,16,3.644954130530364e-05,0,0
9024,overall,16,2.9383245673317074e-05,16,3.644954130530364e-05,0,0
9023,incompetence,16,2.9383245673317074e-05,16,3.644954130530364e-05,0,0
9041,apologized,16,2.9383245673317074e-05,16,3.644954130530364e-05,0,0
9132,replaced,16,2.9383245673317074e-05,16,3.644954130530364e-05,0,0
9368,merit,16,2.9383245673317074e-05,16,3.644954130530364e-05,0,0
9474,gangs,16,2.9383245673317074e-05,16,3.644954130530364e-05,0,0
10283,magnificent,16,2.9383245673317074e-05,16,3.644954130530364e-05,0,0
10406,iq,16,2.9383245673317074e-05,16,3.644954130530364e-05,0,0
10420,blaming,16,2.9383245673317074e-05,16,3.644954130530364e-05,0,0
10509,pelosis,16,2.9383245673317074e-05,16,3.644954130530364e-05,0,0
10602,liked,16,2.9383245673317074e-05,16,3.644954130530364e-05,0,0
10621,tiffany,16,2.9383245673317074e-05,16,3.644954130530364e-05,0,0
10641,player,16,2.9383245673317074e-05,16,3.644954130530364e-05,0,0
10791,wacky,16,2.9383245673317074e-05,16,3.644954130530364e-05,0,0
10845,juan,16,2.9383245673317074e-05,16,3.644954130530364e-05,0,0
10869,ranchers,16,2.9383245673317074e-05,16,3.644954130530364e-05,0,0
11614,impeachable,16,2.9383245673317074e-05,16,3.644954130530364e-05,0,0
11820,governments,16,2.9383245673317074e-05,16,3.644954130530364e-05,0,0
12431,spectacular,16,2.9383245673317074e-05,16,3.644954130530364e-05,0,0
12784,victories,16,2.9383245673317074e-05,16,3.644954130530364e-05,0,0
13149,opioid,16,2.9383245673317074e-05,16,3.644954130530364e-05,0,0
13245,mcmaster,16,2.9383245673317074e-05,16,3.644954130530364e-05,0,0
13322,disrespect,16,2.9383245673317074e-05,16,3.644954130530364e-05,0,0
117,yourself,15,2.754679281873476e-05,7,1.5946674321070342e-05,8,7.578269312745701e-05
451,selling,15,2.754679281873476e-05,9,2.0502866984233294e-05,6,5.6837019845592764e-05
528,adults,15,2.754679281873476e-05,2,4.556192663162955e-06,13,0.00012314687633211766
584,prisoners,15,2.754679281873476e-05,13,2.9615252310559205e-05,2,1.8945673281864254e-05
586,discusses,15,2.754679281873476e-05,3,6.8342889947444315e-06,12,0.00011367403969118553
635,10000,15,2.754679281873476e-05,9,2.0502866984233294e-05,6,5.6837019845592764e-05
785,expanding,15,2.754679281873476e-05,11,2.505905964739625e-05,4,3.789134656372851e-05
911,expanded,15,2.754679281873476e-05,5,1.1390481657907387e-05,10,9.472836640932126e-05
952,conflict,15,2.754679281873476e-05,12,2.7337155978977726e-05,3,2.8418509922796382e-05
978,tested,15,2.754679281873476e-05,13,2.9615252310559205e-05,2,1.8945673281864254e-05
1022,leads,15,2.754679281873476e-05,11,2.505905964739625e-05,4,3.789134656372851e-05
1114,fathers,15,2.754679281873476e-05,2,4.556192663162955e-06,13,0.00012314687633211766
1144,becomes,15,2.754679281873476e-05,13,2.9615252310559205e-05,2,1.8945673281864254e-05
1163,opportunities,15,2.754679281873476e-05,5,1.1390481657907387e-05,10,9.472836640932126e-05
1181,walking,15,2.754679281873476e-05,12,2.7337155978977726e-05,3,2.8418509922796382e-05
1204,top-down,15,2.754679281873476e-05,0,0,15,0.0001420925496139819
1252,midnight,15,2.754679281873476e-05,3,6.8342889947444315e-06,12,0.00011367403969118553
1350,deeply,15,2.754679281873476e-05,10,2.2780963315814774e-05,5,4.736418320466063e-05
1388,achieved,15,2.754679281873476e-05,14,3.1893348642140685e-05,1,9.472836640932127e-06
1395,carry,15,2.754679281873476e-05,10,2.2780963315814774e-05,5,4.736418320466063e-05
1394,born,15,2.754679281873476e-05,5,1.1390481657907387e-05,10,9.472836640932126e-05
1571,society,15,2.754679281873476e-05,9,2.0502866984233294e-05,6,5.6837019845592764e-05
1589,initiative,15,2.754679281873476e-05,9,2.0502866984233294e-05,6,5.6837019845592764e-05
1742,proved,15,2.754679281873476e-05,9,2.0502866984233294e-05,6,5.6837019845592764e-05
1969,resolution,15,2.754679281873476e-05,12,2.7337155978977726e-05,3,2.8418509922796382e-05
1988,hello,15,2.754679281873476e-05,11,2.505905964739625e-05,4,3.789134656372851e-05
2072,authority,15,2.754679281873476e-05,11,2.505905964739625e-05,4,3.789134656372851e-05
2213,rising,15,2.754679281873476e-05,9,2.0502866984233294e-05,6,5.6837019845592764e-05
2255,meaning,15,2.754679281873476e-05,12,2.7337155978977726e-05,3,2.8418509922796382e-05
2336,gap,15,2.754679281873476e-05,0,0,15,0.0001420925496139819
2465,#rebuildamerica,15,2.754679281873476e-05,0,0,15,0.0001420925496139819
2520,skills,15,2.754679281873476e-05,4,9.11238532632591e-06,11,0.0001042012030502534
2714,easter,15,2.754679281873476e-05,10,2.2780963315814774e-05,5,4.736418320466063e-05
2743,urge,15,2.754679281873476e-05,3,6.8342889947444315e-06,12,0.00011367403969118553
2949,shares,15,2.754679281873476e-05,5,1.1390481657907387e-05,10,9.472836640932126e-05
3070,bo,15,2.754679281873476e-05,0,0,15,0.0001420925496139819
3123,2010,15,2.754679281873476e-05,3,6.8342889947444315e-06,12,0.00011367403969118553
3244,names,15,2.754679281873476e-05,14,3.1893348642140685e-05,1,9.472836640932127e-06
3276,bright,15,2.754679281873476e-05,14,3.1893348642140685e-05,1,9.472836640932127e-06
3312,2009,15,2.754679281873476e-05,4,9.11238532632591e-06,11,0.0001042012030502534
3367,remembrance,15,2.754679281873476e-05,11,2.505905964739625e-05,4,3.789134656372851e-05
3379,passage,15,2.754679281873476e-05,11,2.505905964739625e-05,4,3.789134656372851e-05
3522,threaten,15,2.754679281873476e-05,8,1.822477065265182e-05,7,6.63098564865249e-05
3627,mistakes,15,2.754679281873476e-05,13,2.9615252310559205e-05,2,1.8945673281864254e-05
3736,certainly,15,2.754679281873476e-05,14,3.1893348642140685e-05,1,9.472836640932127e-06
3763,reforms,15,2.754679281873476e-05,5,1.1390481657907387e-05,10,9.472836640932126e-05
3772,farm,15,2.754679281873476e-05,14,3.1893348642140685e-05,1,9.472836640932127e-06
3784,rock,15,2.754679281873476e-05,14,3.1893348642140685e-05,1,9.472836640932127e-06
3966,followed,15,2.754679281873476e-05,13,2.9615252310559205e-05,2,1.8945673281864254e-05
4015,challenges,15,2.754679281873476e-05,3,6.8342889947444315e-06,12,0.00011367403969118553
4182,conservatives,15,2.754679281873476e-05,14,3.1893348642140685e-05,1,9.472836640932127e-06
4233,mary,15,2.754679281873476e-05,14,3.1893348642140685e-05,1,9.472836640932127e-06
4258,c,15,2.754679281873476e-05,13,2.9615252310559205e-05,2,1.8945673281864254e-05
4517,throw,15,2.754679281873476e-05,7,1.5946674321070342e-05,8,7.578269312745701e-05
4561,#forward,15,2.754679281873476e-05,0,0,15,0.0001420925496139819
4777,rape,15,2.754679281873476e-05,1,2.2780963315814773e-06,14,0.0001326197129730498
4794,todd,15,2.754679281873476e-05,13,2.9615252310559205e-05,2,1.8945673281864254e-05
4879,hide,15,2.754679281873476e-05,12,2.7337155978977726e-05,3,2.8418509922796382e-05
5107,attempt,15,2.754679281873476e-05,14,3.1893348642140685e-05,1,9.472836640932127e-06
5121,audience,15,2.754679281873476e-05,11,2.505905964739625e-05,4,3.789134656372851e-05
5495,seats,15,2.754679281873476e-05,13,2.9615252310559205e-05,2,1.8945673281864254e-05
5613,gold,15,2.754679281873476e-05,11,2.505905964739625e-05,4,3.789134656372851e-05
5741,operations,15,2.754679281873476e-05,14,3.1893348642140685e-05,1,9.472836640932127e-06
5746,hosted,15,2.754679281873476e-05,11,2.505905964739625e-05,4,3.789134656372851e-05
5766,capital,15,2.754679281873476e-05,13,2.9615252310559205e-05,2,1.8945673281864254e-05
5808,alex,15,2.754679281873476e-05,10,2.2780963315814774e-05,5,4.736418320466063e-05
5837,poland,15,2.754679281873476e-05,13,2.9615252310559205e-05,2,1.8945673281864254e-05
5842,church,15,2.754679281873476e-05,14,3.1893348642140685e-05,1,9.472836640932127e-06
6391,injured,15,2.754679281873476e-05,13,2.9615252310559205e-05,2,1.8945673281864254e-05
6628,accomplishments,15,2.754679281873476e-05,13,2.9615252310559205e-05,2,1.8945673281864254e-05
6725,grand,15,2.754679281873476e-05,14,3.1893348642140685e-05,1,9.472836640932127e-06
7010,alan,15,2.754679281873476e-05,14,3.1893348642140685e-05,1,9.472836640932127e-06
7164,billy,15,2.754679281873476e-05,14,3.1893348642140685e-05,1,9.472836640932127e-06
7343,egypt,15,2.754679281873476e-05,13,2.9615252310559205e-05,2,1.8945673281864254e-05
7516,bravery,15,2.754679281873476e-05,13,2.9615252310559205e-05,2,1.8945673281864254e-05
7649,cherish,15,2.754679281873476e-05,14,3.1893348642140685e-05,1,9.472836640932127e-06
7994,pollster,15,2.754679281873476e-05,15,3.417144497372216e-05,0,0
8159,viciously,15,2.754679281873476e-05,15,3.417144497372216e-05,0,0
8220,kemp,15,2.754679281873476e-05,15,3.417144497372216e-05,0,0
8291,allegations,15,2.754679281873476e-05,15,3.417144497372216e-05,0,0
8309,obamagate,15,2.754679281873476e-05,15,3.417144497372216e-05,0,0
8362,editorial,15,2.754679281873476e-05,15,3.417144497372216e-05,0,0
8372,fredo,15,2.754679281873476e-05,15,3.417144497372216e-05,0,0
8427,sided,15,2.754679281873476e-05,15,3.417144497372216e-05,0,0
8523,nevertheless,15,2.754679281873476e-05,15,3.417144497372216e-05,0,0
8601,whistleblowers,15,2.754679281873476e-05,15,3.417144497372216e-05,0,0
8624,@petehegseth,15,2.754679281873476e-05,15,3.417144497372216e-05,0,0
8672,tiny,15,2.754679281873476e-05,15,3.417144497372216e-05,0,0
8673,everywhere,15,2.754679281873476e-05,15,3.417144497372216e-05,0,0
8690,ripped,15,2.754679281873476e-05,15,3.417144497372216e-05,0,0
8722,t,15,2.754679281873476e-05,15,3.417144497372216e-05,0,0
8847,tower,15,2.754679281873476e-05,15,3.417144497372216e-05,0,0
8982,refusing,15,2.754679281873476e-05,15,3.417144497372216e-05,0,0
9142,location,15,2.754679281873476e-05,15,3.417144497372216e-05,0,0
9162,pharma,15,2.754679281873476e-05,15,3.417144497372216e-05,0,0
9173,s&p,15,2.754679281873476e-05,15,3.417144497372216e-05,0,0
9454,deputy,15,2.754679281873476e-05,15,3.417144497372216e-05,0,0
9486,commission,15,2.754679281873476e-05,15,3.417144497372216e-05,0,0
9565,texts,15,2.754679281873476e-05,15,3.417144497372216e-05,0,0
9626,requested,15,2.754679281873476e-05,15,3.417144497372216e-05,0,0
9773,clearly,15,2.754679281873476e-05,15,3.417144497372216e-05,0,0
9988,530,15,2.754679281873476e-05,15,3.417144497372216e-05,0,0
10386,lyin,15,2.754679281873476e-05,15,3.417144497372216e-05,0,0
10506,socialism,15,2.754679281873476e-05,15,3.417144497372216e-05,0,0
10635,coach,15,2.754679281873476e-05,15,3.417144497372216e-05,0,0
10919,delegation,15,2.754679281873476e-05,15,3.417144497372216e-05,0,0
10932,siege,15,2.754679281873476e-05,15,3.417144497372216e-05,0,0
11052,related,15,2.754679281873476e-05,15,3.417144497372216e-05,0,0
11415,uk,15,2.754679281873476e-05,15,3.417144497372216e-05,0,0
11493,deranged,15,2.754679281873476e-05,15,3.417144497372216e-05,0,0
11599,targeted,15,2.754679281873476e-05,15,3.417144497372216e-05,0,0
11686,treasury,15,2.754679281873476e-05,15,3.417144497372216e-05,0,0
12465,congresswomen,15,2.754679281873476e-05,15,3.417144497372216e-05,0,0
13817,tester,15,2.754679281873476e-05,15,3.417144497372216e-05,0,0
16391,caravan,15,2.754679281873476e-05,15,3.417144497372216e-05,0,0
19102,cummings,15,2.754679281873476e-05,15,3.417144497372216e-05,0,0
478,defending,14,2.571033996415244e-05,11,2.505905964739625e-05,3,2.8418509922796382e-05
674,agrees,14,2.571033996415244e-05,10,2.2780963315814774e-05,4,3.789134656372851e-05
754,#irandeal,14,2.571033996415244e-05,0,0,14,0.0001326197129730498
788,plain,14,2.571033996415244e-05,11,2.505905964739625e-05,3,2.8418509922796382e-05
832,succeeds,14,2.571033996415244e-05,3,6.8342889947444315e-06,11,0.0001042012030502534
869,42,14,2.571033996415244e-05,9,2.0502866984233294e-05,5,4.736418320466063e-05
883,full-time,14,2.571033996415244e-05,0,0,14,0.0001326197129730498
898,protections,14,2.571033996415244e-05,4,9.11238532632591e-06,10,9.472836640932126e-05
953,kennedy,14,2.571033996415244e-05,6,1.3668577989488863e-05,8,7.578269312745701e-05
957,wisdom,14,2.571033996415244e-05,13,2.9615252310559205e-05,1,9.472836640932127e-06
1199,boost,14,2.571033996415244e-05,10,2.2780963315814774e-05,4,3.789134656372851e-05
1250,preventive,14,2.571033996415244e-05,0,0,14,0.0001326197129730498
1338,electricity,14,2.571033996415244e-05,3,6.8342889947444315e-06,11,0.0001042012030502534
1343,brings,14,2.571033996415244e-05,11,2.505905964739625e-05,3,2.8418509922796382e-05
1445,mothers,14,2.571033996415244e-05,5,1.1390481657907387e-05,9,8.525552976838915e-05
1536,park,14,2.571033996415244e-05,10,2.2780963315814774e-05,4,3.789134656372851e-05
1593,workforce,14,2.571033996415244e-05,8,1.822477065265182e-05,6,5.6837019845592764e-05
1614,towards,14,2.571033996415244e-05,7,1.5946674321070342e-05,7,6.63098564865249e-05
1632,entered,14,2.571033996415244e-05,5,1.1390481657907387e-05,9,8.525552976838915e-05
1669,proposed,14,2.571033996415244e-05,7,1.5946674321070342e-05,7,6.63098564865249e-05
1676,produce,14,2.571033996415244e-05,12,2.7337155978977726e-05,2,1.8945673281864254e-05
1707,contributions,14,2.571033996415244e-05,12,2.7337155978977726e-05,2,1.8945673281864254e-05
1778,desk,14,2.571033996415244e-05,11,2.505905964739625e-05,3,2.8418509922796382e-05
1926,wishing,14,2.571033996415244e-05,10,2.2780963315814774e-05,4,3.789134656372851e-05
1930,solutions,14,2.571033996415244e-05,11,2.505905964739625e-05,3,2.8418509922796382e-05
1936,minds,14,2.571033996415244e-05,11,2.505905964739625e-05,3,2.8418509922796382e-05
2022,tomorrows,14,2.571033996415244e-05,2,4.556192663162955e-06,12,0.00011367403969118553
2085,approach,14,2.571033996415244e-05,5,1.1390481657907387e-05,9,8.525552976838915e-05
2329,heads,14,2.571033996415244e-05,9,2.0502866984233294e-05,5,4.736418320466063e-05
2613,existing,14,2.571033996415244e-05,12,2.7337155978977726e-05,2,1.8945673281864254e-05
2654,expand,14,2.571033996415244e-05,11,2.505905964739625e-05,3,2.8418509922796382e-05
2666,warm,14,2.571033996415244e-05,9,2.0502866984233294e-05,5,4.736418320466063e-05
2886,35,14,2.571033996415244e-05,8,1.822477065265182e-05,6,5.6837019845592764e-05
2950,environment,14,2.571033996415244e-05,10,2.2780963315814774e-05,4,3.789134656372851e-05
2967,contract,14,2.571033996415244e-05,12,2.7337155978977726e-05,2,1.8945673281864254e-05
3254,93,14,2.571033996415244e-05,12,2.7337155978977726e-05,2,1.8945673281864254e-05
3255,executives,14,2.571033996415244e-05,11,2.505905964739625e-05,3,2.8418509922796382e-05
3261,allows,14,2.571033996415244e-05,9,2.0502866984233294e-05,5,4.736418320466063e-05
3278,previously,14,2.571033996415244e-05,11,2.505905964739625e-05,3,2.8418509922796382e-05
3362,filibuster,14,2.571033996415244e-05,10,2.2780963315814774e-05,4,3.789134656372851e-05
3432,providing,14,2.571033996415244e-05,9,2.0502866984233294e-05,5,4.736418320466063e-05
3453,pull,14,2.571033996415244e-05,8,1.822477065265182e-05,6,5.6837019845592764e-05
3704,banned,14,2.571033996415244e-05,13,2.9615252310559205e-05,1,9.472836640932127e-06
3744,48,14,2.571033996415244e-05,10,2.2780963315814774e-05,4,3.789134656372851e-05
3835,congratulate,14,2.571033996415244e-05,11,2.505905964739625e-05,3,2.8418509922796382e-05
3880,busy,14,2.571033996415244e-05,12,2.7337155978977726e-05,2,1.8945673281864254e-05
3889,understanding,14,2.571033996415244e-05,13,2.9615252310559205e-05,1,9.472836640932127e-06
3896,fireworks,14,2.571033996415244e-05,12,2.7337155978977726e-05,2,1.8945673281864254e-05
3979,reaching,14,2.571033996415244e-05,10,2.2780963315814774e-05,4,3.789134656372851e-05
4014,upcoming,14,2.571033996415244e-05,13,2.9615252310559205e-05,1,9.472836640932127e-06
4080,beloved,14,2.571033996415244e-05,12,2.7337155978977726e-05,2,1.8945673281864254e-05
4223,programs,14,2.571033996415244e-05,7,1.5946674321070342e-05,7,6.63098564865249e-05
4255,harm,14,2.571033996415244e-05,11,2.505905964739625e-05,3,2.8418509922796382e-05
4292,views,14,2.571033996415244e-05,10,2.2780963315814774e-05,4,3.789134656372851e-05
4422,package,14,2.571033996415244e-05,12,2.7337155978977726e-05,2,1.8945673281864254e-05
4437,kerry,14,2.571033996415244e-05,12,2.7337155978977726e-05,2,1.8945673281864254e-05
4578,columbus,14,2.571033996415244e-05,6,1.3668577989488863e-05,8,7.578269312745701e-05
4642,kidding,14,2.571033996415244e-05,12,2.7337155978977726e-05,2,1.8945673281864254e-05
4722,walter,14,2.571033996415244e-05,13,2.9615252310559205e-05,1,9.472836640932127e-06
4767,covers,14,2.571033996415244e-05,9,2.0502866984233294e-05,5,4.736418320466063e-05
4910,perfectly,14,2.571033996415244e-05,12,2.7337155978977726e-05,2,1.8945673281864254e-05
4927,enemies,14,2.571033996415244e-05,11,2.505905964739625e-05,3,2.8418509922796382e-05
4944,abortion,14,2.571033996415244e-05,12,2.7337155978977726e-05,2,1.8945673281864254e-05
4999,suggested,14,2.571033996415244e-05,13,2.9615252310559205e-05,1,9.472836640932127e-06
5222,corporate,14,2.571033996415244e-05,6,1.3668577989488863e-05,8,7.578269312745701e-05
5286,returns,14,2.571033996415244e-05,5,1.1390481657907387e-05,9,8.525552976838915e-05
5494,rolling,14,2.571033996415244e-05,12,2.7337155978977726e-05,2,1.8945673281864254e-05
5496,trusted,14,2.571033996415244e-05,13,2.9615252310559205e-05,1,9.472836640932127e-06
5794,asks,14,2.571033996415244e-05,8,1.822477065265182e-05,6,5.6837019845592764e-05
5803,began,14,2.571033996415244e-05,13,2.9615252310559205e-05,1,9.472836640932127e-06
6051,sarah,14,2.571033996415244e-05,10,2.2780963315814774e-05,4,3.789134656372851e-05
6153,messages,14,2.571033996415244e-05,13,2.9615252310559205e-05,1,9.472836640932127e-06
6210,association,14,2.571033996415244e-05,13,2.9615252310559205e-05,1,9.472836640932127e-06
6288,lovers,14,2.571033996415244e-05,13,2.9615252310559205e-05,1,9.472836640932127e-06
7309,papers,14,2.571033996415244e-05,13,2.9615252310559205e-05,1,9.472836640932127e-06
7327,instructed,14,2.571033996415244e-05,13,2.9615252310559205e-05,1,9.472836640932127e-06
7347,advisor,14,2.571033996415244e-05,13,2.9615252310559205e-05,1,9.472836640932127e-06
7590,incredibly,14,2.571033996415244e-05,13,2.9615252310559205e-05,1,9.472836640932127e-06
7615,ongoing,14,2.571033996415244e-05,12,2.7337155978977726e-05,2,1.8945673281864254e-05
7772,attempted,14,2.571033996415244e-05,13,2.9615252310559205e-05,1,9.472836640932127e-06
7866,display,14,2.571033996415244e-05,13,2.9615252310559205e-05,1,9.472836640932127e-06
8006,@newsmax,14,2.571033996415244e-05,14,3.1893348642140685e-05,0,0
8014,rampant,14,2.571033996415244e-05,14,3.1893348642140685e-05,0,0
8042,starr,14,2.571033996415244e-05,14,3.1893348642140685e-05,0,0
8182,locations,14,2.571033996415244e-05,14,3.1893348642140685e-05,0,0
8195,rooms,14,2.571033996415244e-05,14,3.1893348642140685e-05,0,0
8274,dershowitz,14,2.571033996415244e-05,14,3.1893348642140685e-05,0,0
8314,improvements,14,2.571033996415244e-05,14,3.1893348642140685e-05,0,0
8337,mask,14,2.571033996415244e-05,14,3.1893348642140685e-05,0,0
8355,cabinet,14,2.571033996415244e-05,14,3.1893348642140685e-05,0,0
8357,investigators,14,2.571033996415244e-05,14,3.1893348642140685e-05,0,0
8382,unnecessary,14,2.571033996415244e-05,14,3.1893348642140685e-05,0,0
8385,multiple,14,2.571033996415244e-05,14,3.1893348642140685e-05,0,0
8409,covid-19,14,2.571033996415244e-05,14,3.1893348642140685e-05,0,0
8500,accurately,14,2.571033996415244e-05,14,3.1893348642140685e-05,0,0
8589,helpful,14,2.571033996415244e-05,14,3.1893348642140685e-05,0,0
8808,@nypost,14,2.571033996415244e-05,14,3.1893348642140685e-05,0,0
8828,stupidly,14,2.571033996415244e-05,14,3.1893348642140685e-05,0,0
8835,highs,14,2.571033996415244e-05,14,3.1893348642140685e-05,0,0
8908,#kag,14,2.571033996415244e-05,14,3.1893348642140685e-05,0,0
9077,handle,14,2.571033996415244e-05,14,3.1893348642140685e-05,0,0
9345,prosecutors,14,2.571033996415244e-05,14,3.1893348642140685e-05,0,0
9609,raises,14,2.571033996415244e-05,14,3.1893348642140685e-05,0,0
9685,additionally,14,2.571033996415244e-05,14,3.1893348642140685e-05,0,0
9835,resign,14,2.571033996415244e-05,14,3.1893348642140685e-05,0,0
9833,admit,14,2.571033996415244e-05,14,3.1893348642140685e-05,0,0
9838,401ks,14,2.571033996415244e-05,14,3.1893348642140685e-05,0,0
9986,judiciary,14,2.571033996415244e-05,14,3.1893348642140685e-05,0,0
9991,someday,14,2.571033996415244e-05,14,3.1893348642140685e-05,0,0
10030,losses,14,2.571033996415244e-05,14,3.1893348642140685e-05,0,0
10034,invisible,14,2.571033996415244e-05,14,3.1893348642140685e-05,0,0
10079,heed,14,2.571033996415244e-05,14,3.1893348642140685e-05,0,0
10130,به,14,2.571033996415244e-05,14,3.1893348642140685e-05,0,0
10180,commercial,14,2.571033996415244e-05,14,3.1893348642140685e-05,0,0
10370,headline,14,2.571033996415244e-05,14,3.1893348642140685e-05,0,0
10499,trumpers,14,2.571033996415244e-05,14,3.1893348642140685e-05,0,0
10503,penalty,14,2.571033996415244e-05,14,3.1893348642140685e-05,0,0
10566,washed,14,2.571033996415244e-05,14,3.1893348642140685e-05,0,0
10603,sections,14,2.571033996415244e-05,14,3.1893348642140685e-05,0,0
10609,shooter,14,2.571033996415244e-05,14,3.1893348642140685e-05,0,0
10644,supply,14,2.571033996415244e-05,14,3.1893348642140685e-05,0,0
10696,complain,14,2.571033996415244e-05,14,3.1893348642140685e-05,0,0
10778,flooding,14,2.571033996415244e-05,14,3.1893348642140685e-05,0,0
10877,missiles,14,2.571033996415244e-05,14,3.1893348642140685e-05,0,0
10947,@usnavy,14,2.571033996415244e-05,14,3.1893348642140685e-05,0,0
11133,@abc,14,2.571033996415244e-05,14,3.1893348642140685e-05,0,0
11370,securing,14,2.571033996415244e-05,14,3.1893348642140685e-05,0,0
11429,lee,14,2.571033996415244e-05,14,3.1893348642140685e-05,0,0
11637,remove,14,2.571033996415244e-05,14,3.1893348642140685e-05,0,0
11825,funded,14,2.571033996415244e-05,14,3.1893348642140685e-05,0,0
11913,generals,14,2.571033996415244e-05,14,3.1893348642140685e-05,0,0
12085,horror,14,2.571033996415244e-05,14,3.1893348642140685e-05,0,0
12275,misdemeanors,14,2.571033996415244e-05,14,3.1893348642140685e-05,0,0
12351,discussions,14,2.571033996415244e-05,14,3.1893348642140685e-05,0,0
12714,authorized,14,2.571033996415244e-05,14,3.1893348642140685e-05,0,0
13132,leaker,14,2.571033996415244e-05,14,3.1893348642140685e-05,0,0
13182,provided,14,2.571033996415244e-05,14,3.1893348642140685e-05,0,0
13219,guilty,14,2.571033996415244e-05,14,3.1893348642140685e-05,0,0
14294,fires,14,2.571033996415244e-05,14,3.1893348642140685e-05,0,0
14532,blumenthal,14,2.571033996415244e-05,14,3.1893348642140685e-05,0,0
14965,podesta,14,2.571033996415244e-05,14,3.1893348642140685e-05,0,0
14968,comeys,14,2.571033996415244e-05,14,3.1893348642140685e-05,0,0
15011,fusion,14,2.571033996415244e-05,14,3.1893348642140685e-05,0,0
15284,#unga,14,2.571033996415244e-05,14,3.1893348642140685e-05,0,0
15816,9th,14,2.571033996415244e-05,14,3.1893348642140685e-05,0,0
15900,councel,14,2.571033996415244e-05,14,3.1893348642140685e-05,0,0
18903,@mattbevin,14,2.571033996415244e-05,14,3.1893348642140685e-05,0,0
19763,dayton,14,2.571033996415244e-05,14,3.1893348642140685e-05,0,0
48,chip,13,2.3873887109570122e-05,1,2.2780963315814773e-06,12,0.00011367403969118553
243,addressing,13,2.3873887109570122e-05,4,9.11238532632591e-06,9,8.525552976838915e-05
275,parks,13,2.3873887109570122e-05,6,1.3668577989488863e-05,7,6.63098564865249e-05
565,limits,13,2.3873887109570122e-05,4,9.11238532632591e-06,9,8.525552976838915e-05
583,population,13,2.3873887109570122e-05,9,2.0502866984233294e-05,4,3.789134656372851e-05
662,fundraising,13,2.3873887109570122e-05,4,9.11238532632591e-06,9,8.525552976838915e-05
778,overwhelming,13,2.3873887109570122e-05,10,2.2780963315814774e-05,3,2.8418509922796382e-05
921,50th,13,2.3873887109570122e-05,3,6.8342889947444315e-06,10,9.472836640932126e-05
986,consequences,13,2.3873887109570122e-05,11,2.505905964739625e-05,2,1.8945673281864254e-05
1033,jobless,13,2.3873887109570122e-05,12,2.7337155978977726e-05,1,9.472836640932127e-06
1409,require,13,2.3873887109570122e-05,3,6.8342889947444315e-06,10,9.472836640932126e-05
1651,actual,13,2.3873887109570122e-05,12,2.7337155978977726e-05,1,9.472836640932127e-06
1704,ticket,13,2.3873887109570122e-05,10,2.2780963315814774e-05,3,2.8418509922796382e-05
1789,threatening,13,2.3873887109570122e-05,7,1.5946674321070342e-05,6,5.6837019845592764e-05
1843,note,13,2.3873887109570122e-05,4,9.11238532632591e-06,9,8.525552976838915e-05
1849,treatment,13,2.3873887109570122e-05,8,1.822477065265182e-05,5,4.736418320466063e-05
1852,lilly,13,2.3873887109570122e-05,0,0,13,0.00012314687633211766
1925,inspiration,13,2.3873887109570122e-05,6,1.3668577989488863e-05,7,6.63098564865249e-05
2011,natural,13,2.3873887109570122e-05,11,2.505905964739625e-05,2,1.8945673281864254e-05
2102,options,13,2.3873887109570122e-05,7,1.5946674321070342e-05,6,5.6837019845592764e-05
2188,adding,13,2.3873887109570122e-05,9,2.0502866984233294e-05,4,3.789134656372851e-05
2239,renew,13,2.3873887109570122e-05,5,1.1390481657907387e-05,8,7.578269312745701e-05
2259,storms,13,2.3873887109570122e-05,11,2.505905964739625e-05,2,1.8945673281864254e-05
2319,20th,13,2.3873887109570122e-05,12,2.7337155978977726e-05,1,9.472836640932127e-06
2384,williams,13,2.3873887109570122e-05,12,2.7337155978977726e-05,1,9.472836640932127e-06
2446,status,13,2.3873887109570122e-05,6,1.3668577989488863e-05,7,6.63098564865249e-05
2505,#peopleoverpolitics,13,2.3873887109570122e-05,0,0,13,0.00012314687633211766
2584,blocked,13,2.3873887109570122e-05,8,1.822477065265182e-05,5,4.736418320466063e-05
2903,drew,13,2.3873887109570122e-05,12,2.7337155978977726e-05,1,9.472836640932127e-06
3028,profits,13,2.3873887109570122e-05,3,6.8342889947444315e-06,10,9.472836640932126e-05
3151,central,13,2.3873887109570122e-05,10,2.2780963315814774e-05,3,2.8418509922796382e-05
3291,nelson,13,2.3873887109570122e-05,7,1.5946674321070342e-05,6,5.6837019845592764e-05
3330,capitol,13,2.3873887109570122e-05,9,2.0502866984233294e-05,4,3.789134656372851e-05
3436,charging,13,2.3873887109570122e-05,9,2.0502866984233294e-05,4,3.789134656372851e-05
3521,letting,13,2.3873887109570122e-05,11,2.505905964739625e-05,2,1.8945673281864254e-05
3560,bankrupt,13,2.3873887109570122e-05,0,0,13,0.00012314687633211766
3600,theyll,13,2.3873887109570122e-05,8,1.822477065265182e-05,5,4.736418320466063e-05
3674,daniel,13,2.3873887109570122e-05,11,2.505905964739625e-05,2,1.8945673281864254e-05
3685,waited,13,2.3873887109570122e-05,11,2.505905964739625e-05,2,1.8945673281864254e-05
3775,fuel,13,2.3873887109570122e-05,5,1.1390481657907387e-05,8,7.578269312745701e-05
3813,nor,13,2.3873887109570122e-05,12,2.7337155978977726e-05,1,9.472836640932127e-06
3811,accident,13,2.3873887109570122e-05,11,2.505905964739625e-05,2,1.8945673281864254e-05
3823,hot,13,2.3873887109570122e-05,10,2.2780963315814774e-05,3,2.8418509922796382e-05
3827,basketball,13,2.3873887109570122e-05,8,1.822477065265182e-05,5,4.736418320466063e-05
3832,ultimately,13,2.3873887109570122e-05,11,2.505905964739625e-05,2,1.8945673281864254e-05
3961,mother,13,2.3873887109570122e-05,4,9.11238532632591e-06,9,8.525552976838915e-05
4084,#nowisthetime,13,2.3873887109570122e-05,0,0,13,0.00012314687633211766
4262,nra,13,2.3873887109570122e-05,12,2.7337155978977726e-05,1,9.472836640932127e-06
4284,crashed,13,2.3873887109570122e-05,5,1.1390481657907387e-05,8,7.578269312745701e-05
4550,pa,13,2.3873887109570122e-05,11,2.505905964739625e-05,2,1.8945673281864254e-05
4555,pell,13,2.3873887109570122e-05,0,0,13,0.00012314687633211766
4571,boss,13,2.3873887109570122e-05,11,2.505905964739625e-05,2,1.8945673281864254e-05
4709,re-elect,13,2.3873887109570122e-05,4,9.11238532632591e-06,9,8.525552976838915e-05
4880,positions,13,2.3873887109570122e-05,5,1.1390481657907387e-05,8,7.578269312745701e-05
4883,article,13,2.3873887109570122e-05,12,2.7337155978977726e-05,1,9.472836640932127e-06
4914,range,13,2.3873887109570122e-05,12,2.7337155978977726e-05,1,9.472836640932127e-06
4943,daily,13,2.3873887109570122e-05,11,2.505905964739625e-05,2,1.8945673281864254e-05
4994,referring,13,2.3873887109570122e-05,12,2.7337155978977726e-05,1,9.472836640932127e-06
5027,newspaper,13,2.3873887109570122e-05,12,2.7337155978977726e-05,1,9.472836640932127e-06
5053,stick,13,2.3873887109570122e-05,11,2.505905964739625e-05,2,1.8945673281864254e-05
5157,wild,13,2.3873887109570122e-05,12,2.7337155978977726e-05,1,9.472836640932127e-06
5254,cop,13,2.3873887109570122e-05,12,2.7337155978977726e-05,1,9.472836640932127e-06
5276,couple,13,2.3873887109570122e-05,10,2.2780963315814774e-05,3,2.8418509922796382e-05
5362,fort,13,2.3873887109570122e-05,12,2.7337155978977726e-05,1,9.472836640932127e-06
5580,extended,13,2.3873887109570122e-05,12,2.7337155978977726e-05,1,9.472836640932127e-06
5717,associated,13,2.3873887109570122e-05,12,2.7337155978977726e-05,1,9.472836640932127e-06
6202,hat,13,2.3873887109570122e-05,4,9.11238532632591e-06,9,8.525552976838915e-05
6265,#dadt,13,2.3873887109570122e-05,0,0,13,0.00012314687633211766
6345,trading,13,2.3873887109570122e-05,8,1.822477065265182e-05,5,4.736418320466063e-05
6367,updates,13,2.3873887109570122e-05,9,2.0502866984233294e-05,4,3.789134656372851e-05
6554,culture,13,2.3873887109570122e-05,12,2.7337155978977726e-05,1,9.472836640932127e-06
6722,offered,13,2.3873887109570122e-05,12,2.7337155978977726e-05,1,9.472836640932127e-06
6760,caucus,13,2.3873887109570122e-05,11,2.505905964739625e-05,2,1.8945673281864254e-05
6975,11th,13,2.3873887109570122e-05,11,2.505905964739625e-05,2,1.8945673281864254e-05
7303,yorks,13,2.3873887109570122e-05,12,2.7337155978977726e-05,1,9.472836640932127e-06
7313,saddened,13,2.3873887109570122e-05,10,2.2780963315814774e-05,3,2.8418509922796382e-05
7426,asia,13,2.3873887109570122e-05,11,2.505905964739625e-05,2,1.8945673281864254e-05
7473,pundits,13,2.3873887109570122e-05,12,2.7337155978977726e-05,1,9.472836640932127e-06
7513,gulf,13,2.3873887109570122e-05,5,1.1390481657907387e-05,8,7.578269312745701e-05
7694,discussion,13,2.3873887109570122e-05,11,2.505905964739625e-05,2,1.8945673281864254e-05
7763,ben,13,2.3873887109570122e-05,12,2.7337155978977726e-05,1,9.472836640932127e-06
7863,exclusive,13,2.3873887109570122e-05,12,2.7337155978977726e-05,1,9.472836640932127e-06
8012,mortality,13,2.3873887109570122e-05,13,2.9615252310559205e-05,0,0
8083,pensacola,13,2.3873887109570122e-05,13,2.9615252310559205e-05,0,0
8094,wide,13,2.3873887109570122e-05,13,2.9615252310559205e-05,0,0
8127,expose,13,2.3873887109570122e-05,13,2.9615252310559205e-05,0,0
8145,horrendous,13,2.3873887109570122e-05,13,2.9615252310559205e-05,0,0
8183,broadcast,13,2.3873887109570122e-05,13,2.9615252310559205e-05,0,0
8266,dumped,13,2.3873887109570122e-05,13,2.9615252310559205e-05,0,0
8278,suburban,13,2.3873887109570122e-05,13,2.9615252310559205e-05,0,0
8289,exposing,13,2.3873887109570122e-05,13,2.9615252310559205e-05,0,0
8324,seeking,13,2.3873887109570122e-05,13,2.9615252310559205e-05,0,0
8356,forming,13,2.3873887109570122e-05,13,2.9615252310559205e-05,0,0
8401,cindy,13,2.3873887109570122e-05,13,2.9615252310559205e-05,0,0
8419,apprentice,13,2.3873887109570122e-05,13,2.9615252310559205e-05,0,0
8442,appointment,13,2.3873887109570122e-05,13,2.9615252310559205e-05,0,0
8531,murphy,13,2.3873887109570122e-05,13,2.9615252310559205e-05,0,0
8696,flake,13,2.3873887109570122e-05,13,2.9615252310559205e-05,0,0
8746,boom,13,2.3873887109570122e-05,13,2.9615252310559205e-05,0,0
8792,watergate,13,2.3873887109570122e-05,13,2.9615252310559205e-05,0,0
9045,calm,13,2.3873887109570122e-05,13,2.9615252310559205e-05,0,0
9050,friendly,13,2.3873887109570122e-05,13,2.9615252310559205e-05,0,0
9060,keith,13,2.3873887109570122e-05,13,2.9615252310559205e-05,0,0
9099,ashamed,13,2.3873887109570122e-05,13,2.9615252310559205e-05,0,0
9133,trumper,13,2.3873887109570122e-05,13,2.9615252310559205e-05,0,0
9129,falsely,13,2.3873887109570122e-05,13,2.9615252310559205e-05,0,0
9158,terminate,13,2.3873887109570122e-05,13,2.9615252310559205e-05,0,0
9191,obamabiden,13,2.3873887109570122e-05,13,2.9615252310559205e-05,0,0
9197,warriors,13,2.3873887109570122e-05,13,2.9615252310559205e-05,0,0
9295,predicted,13,2.3873887109570122e-05,13,2.9615252310559205e-05,0,0
9324,defends,13,2.3873887109570122e-05,13,2.9615252310559205e-05,0,0
9403,joes,13,2.3873887109570122e-05,13,2.9615252310559205e-05,0,0
9636,sue,13,2.3873887109570122e-05,13,2.9615252310559205e-05,0,0
9640,beaten,13,2.3873887109570122e-05,13,2.9615252310559205e-05,0,0
9686,commonwealth,13,2.3873887109570122e-05,13,2.9615252310559205e-05,0,0
9726,d,13,2.3873887109570122e-05,13,2.9615252310559205e-05,0,0
9811,rs,13,2.3873887109570122e-05,13,2.9615252310559205e-05,0,0
9866,pricing,13,2.3873887109570122e-05,13,2.9615252310559205e-05,0,0
10178,protests,13,2.3873887109570122e-05,13,2.9615252310559205e-05,0,0
10211,@bretbaier,13,2.3873887109570122e-05,13,2.9615252310559205e-05,0,0
10262,admiral,13,2.3873887109570122e-05,13,2.9615252310559205e-05,0,0
10380,concast,13,2.3873887109570122e-05,13,2.9615252310559205e-05,0,0
10396,although,13,2.3873887109570122e-05,13,2.9615252310559205e-05,0,0
10417,copy,13,2.3873887109570122e-05,13,2.9615252310559205e-05,0,0
10475,#lesm,13,2.3873887109570122e-05,13,2.9615252310559205e-05,0,0
10545,cbs,13,2.3873887109570122e-05,13,2.9615252310559205e-05,0,0
10652,unhinged,13,2.3873887109570122e-05,13,2.9615252310559205e-05,0,0
10716,whoever,13,2.3873887109570122e-05,13,2.9615252310559205e-05,0,0
10768,wacko,13,2.3873887109570122e-05,13,2.9615252310559205e-05,0,0
11045,anthony,13,2.3873887109570122e-05,13,2.9615252310559205e-05,0,0
11128,owner,13,2.3873887109570122e-05,13,2.9615252310559205e-05,0,0
11342,sheriffs,13,2.3873887109570122e-05,13,2.9615252310559205e-05,0,0
11367,brazil,13,2.3873887109570122e-05,13,2.9615252310559205e-05,0,0
11412,boris,13,2.3873887109570122e-05,13,2.9615252310559205e-05,0,0
11924,census,13,2.3873887109570122e-05,13,2.9615252310559205e-05,0,0
12121,target,13,2.3873887109570122e-05,13,2.9615252310559205e-05,0,0
12254,captured,13,2.3873887109570122e-05,13,2.9615252310559205e-05,0,0
12290,baker,13,2.3873887109570122e-05,13,2.9615252310559205e-05,0,0
12485,prosecutor,13,2.3873887109570122e-05,13,2.9615252310559205e-05,0,0
12678,sale,13,2.3873887109570122e-05,13,2.9615252310559205e-05,0,0
12699,spoken,13,2.3873887109570122e-05,13,2.9615252310559205e-05,0,0
12727,#2020,13,2.3873887109570122e-05,13,2.9615252310559205e-05,0,0
13377,horrific,13,2.3873887109570122e-05,13,2.9615252310559205e-05,0,0
13599,contact,13,2.3873887109570122e-05,13,2.9615252310559205e-05,0,0
14594,missile,13,2.3873887109570122e-05,13,2.9615252310559205e-05,0,0
14868,ocare,13,2.3873887109570122e-05,13,2.9615252310559205e-05,0,0
14872,bilateral,13,2.3873887109570122e-05,13,2.9615252310559205e-05,0,0
15012,gps,13,2.3873887109570122e-05,13,2.9615252310559205e-05,0,0
15813,resist,13,2.3873887109570122e-05,13,2.9615252310559205e-05,0,0
16752,midterms,13,2.3873887109570122e-05,13,2.9615252310559205e-05,0,0
17294,mcgahn,13,2.3873887109570122e-05,13,2.9615252310559205e-05,0,0
128,hottest,12,2.2037434254987807e-05,6,1.3668577989488863e-05,6,5.6837019845592764e-05
226,#dosomething,12,2.2037434254987807e-05,0,0,12,0.00011367403969118553
379,cemetery,12,2.2037434254987807e-05,10,2.2780963315814774e-05,2,1.8945673281864254e-05
383,icymi,12,2.2037434254987807e-05,0,0,12,0.00011367403969118553
472,consecutive,12,2.2037434254987807e-05,2,4.556192663162955e-06,10,9.472836640932126e-05
562,mayors,12,2.2037434254987807e-05,11,2.505905964739625e-05,1,9.472836640932127e-06
627,kicking,12,2.2037434254987807e-05,4,9.11238532632591e-06,8,7.578269312745701e-05
722,longest,12,2.2037434254987807e-05,6,1.3668577989488863e-05,6,5.6837019845592764e-05
1122,color,12,2.2037434254987807e-05,7,1.5946674321070342e-05,5,4.736418320466063e-05
1192,ourselves,12,2.2037434254987807e-05,2,4.556192663162955e-06,10,9.472836640932126e-05
1226,remarkable,12,2.2037434254987807e-05,8,1.822477065265182e-05,4,3.789134656372851e-05
1288,destiny,12,2.2037434254987807e-05,6,1.3668577989488863e-05,6,5.6837019845592764e-05
1313,sooner,12,2.2037434254987807e-05,10,2.2780963315814774e-05,2,1.8945673281864254e-05
1323,legislators,12,2.2037434254987807e-05,4,9.11238532632591e-06,8,7.578269312745701e-05
1390,devotion,12,2.2037434254987807e-05,11,2.505905964739625e-05,1,9.472836640932127e-06
1401,97,12,2.2037434254987807e-05,3,6.8342889947444315e-06,9,8.525552976838915e-05
1437,womans,12,2.2037434254987807e-05,0,0,12,0.00011367403969118553
1462,milestone,12,2.2037434254987807e-05,6,1.3668577989488863e-05,6,5.6837019845592764e-05
1506,correspondents,12,2.2037434254987807e-05,6,1.3668577989488863e-05,6,5.6837019845592764e-05
1524,blessed,12,2.2037434254987807e-05,9,2.0502866984233294e-05,3,2.8418509922796382e-05
1550,embrace,12,2.2037434254987807e-05,5,1.1390481657907387e-05,7,6.63098564865249e-05
1549,cherished,12,2.2037434254987807e-05,9,2.0502866984233294e-05,3,2.8418509922796382e-05
1559,rewarding,12,2.2037434254987807e-05,0,0,12,0.00011367403969118553
1581,youth,12,2.2037434254987807e-05,8,1.822477065265182e-05,4,3.789134656372851e-05
1607,50000,12,2.2037434254987807e-05,7,1.5946674321070342e-05,5,4.736418320466063e-05
1693,bold,12,2.2037434254987807e-05,9,2.0502866984233294e-05,3,2.8418509922796382e-05
1723,dignity,12,2.2037434254987807e-05,6,1.3668577989488863e-05,6,5.6837019845592764e-05
1748,girls,12,2.2037434254987807e-05,1,2.2780963315814773e-06,11,0.0001042012030502534
1851,ledbetter,12,2.2037434254987807e-05,0,0,12,0.00011367403969118553
1902,filled,12,2.2037434254987807e-05,5,1.1390481657907387e-05,7,6.63098564865249e-05
1913,breakthrough,12,2.2037434254987807e-05,7,1.5946674321070342e-05,5,4.736418320466063e-05
1950,2013,12,2.2037434254987807e-05,1,2.2780963315814773e-06,11,0.0001042012030502534
1978,healthy,12,2.2037434254987807e-05,7,1.5946674321070342e-05,5,4.736418320466063e-05
1991,grew,12,2.2037434254987807e-05,6,1.3668577989488863e-05,6,5.6837019845592764e-05
2056,acted,12,2.2037434254987807e-05,9,2.0502866984233294e-05,3,2.8418509922796382e-05
2168,weather,12,2.2037434254987807e-05,9,2.0502866984233294e-05,3,2.8418509922796382e-05
2180,improving,12,2.2037434254987807e-05,8,1.822477065265182e-05,4,3.789134656372851e-05
2293,burden,12,2.2037434254987807e-05,5,1.1390481657907387e-05,7,6.63098564865249e-05
2413,integrity,12,2.2037434254987807e-05,9,2.0502866984233294e-05,3,2.8418509922796382e-05
2481,hard-working,12,2.2037434254987807e-05,6,1.3668577989488863e-05,6,5.6837019845592764e-05
2539,personally,12,2.2037434254987807e-05,10,2.2780963315814774e-05,2,1.8945673281864254e-05
2541,mom,12,2.2037434254987807e-05,3,6.8342889947444315e-06,9,8.525552976838915e-05
2678,loving,12,2.2037434254987807e-05,11,2.505905964739625e-05,1,9.472836640932127e-06
2679,backs,12,2.2037434254987807e-05,6,1.3668577989488863e-05,6,5.6837019845592764e-05
2703,affect,12,2.2037434254987807e-05,2,4.556192663162955e-06,10,9.472836640932126e-05
2706,achieve,12,2.2037434254987807e-05,11,2.505905964739625e-05,1,9.472836640932127e-06
2838,potentially,12,2.2037434254987807e-05,9,2.0502866984233294e-05,3,2.8418509922796382e-05
3075,winter,12,2.2037434254987807e-05,8,1.822477065265182e-05,4,3.789134656372851e-05
3169,grant,12,2.2037434254987807e-05,7,1.5946674321070342e-05,5,4.736418320466063e-05
3204,15th,12,2.2037434254987807e-05,8,1.822477065265182e-05,4,3.789134656372851e-05
3339,epidemic,12,2.2037434254987807e-05,11,2.505905964739625e-05,1,9.472836640932127e-06
3505,prevention,12,2.2037434254987807e-05,3,6.8342889947444315e-06,9,8.525552976838915e-05
3533,49,12,2.2037434254987807e-05,9,2.0502866984233294e-05,3,2.8418509922796382e-05
3621,#mlkdream50,12,2.2037434254987807e-05,0,0,12,0.00011367403969118553
3647,soccer,12,2.2037434254987807e-05,6,1.3668577989488863e-05,6,5.6837019845592764e-05
3649,#makecollegeaffordable,12,2.2037434254987807e-05,0,0,12,0.00011367403969118553
3665,luxury,12,2.2037434254987807e-05,1,2.2780963315814773e-06,11,0.0001042012030502534
3708,feels,12,2.2037434254987807e-05,9,2.0502866984233294e-05,3,2.8418509922796382e-05
3741,phoenix,12,2.2037434254987807e-05,11,2.505905964739625e-05,1,9.472836640932127e-06
3855,environmental,12,2.2037434254987807e-05,9,2.0502866984233294e-05,3,2.8418509922796382e-05
3911,included,12,2.2037434254987807e-05,6,1.3668577989488863e-05,6,5.6837019845592764e-05
4018,finance,12,2.2037434254987807e-05,11,2.505905964739625e-05,1,9.472836640932127e-06
4085,92,12,2.2037434254987807e-05,5,1.1390481657907387e-05,7,6.63098564865249e-05
4169,severe,12,2.2037434254987807e-05,5,1.1390481657907387e-05,7,6.63098564865249e-05
4188,advance,12,2.2037434254987807e-05,6,1.3668577989488863e-05,6,5.6837019845592764e-05
4265,#jobsnow,12,2.2037434254987807e-05,0,0,12,0.00011367403969118553
4274,20000,12,2.2037434254987807e-05,10,2.2780963315814774e-05,2,1.8945673281864254e-05
4296,declare,12,2.2037434254987807e-05,7,1.5946674321070342e-05,5,4.736418320466063e-05
4303,moves,12,2.2037434254987807e-05,9,2.0502866984233294e-05,3,2.8418509922796382e-05
4361,exercise,12,2.2037434254987807e-05,11,2.505905964739625e-05,1,9.472836640932127e-06
4400,seek,12,2.2037434254987807e-05,10,2.2780963315814774e-05,2,1.8945673281864254e-05
4405,permanently,12,2.2037434254987807e-05,10,2.2780963315814774e-05,2,1.8945673281864254e-05
4460,danny,12,2.2037434254987807e-05,11,2.505905964739625e-05,1,9.472836640932127e-06
4480,chair,12,2.2037434254987807e-05,11,2.505905964739625e-05,1,9.472836640932127e-06
4587,voucher,12,2.2037434254987807e-05,0,0,12,0.00011367403969118553
4647,picked,12,2.2037434254987807e-05,8,1.822477065265182e-05,4,3.789134656372851e-05
4692,roof,12,2.2037434254987807e-05,8,1.822477065265182e-05,4,3.789134656372851e-05
5185,exports,12,2.2037434254987807e-05,8,1.822477065265182e-05,4,3.789134656372851e-05
5196,donations,12,2.2037434254987807e-05,2,4.556192663162955e-06,10,9.472836640932126e-05
5282,milwaukee,12,2.2037434254987807e-05,9,2.0502866984233294e-05,3,2.8418509922796382e-05
5312,donors,12,2.2037434254987807e-05,6,1.3668577989488863e-05,6,5.6837019845592764e-05
5369,committees,12,2.2037434254987807e-05,11,2.505905964739625e-05,1,9.472836640932127e-06
5442,@obama2012,12,2.2037434254987807e-05,0,0,12,0.00011367403969118553
5491,bailout,12,2.2037434254987807e-05,9,2.0502866984233294e-05,3,2.8418509922796382e-05
5769,nonsense,12,2.2037434254987807e-05,11,2.505905964739625e-05,1,9.472836640932127e-06
5984,lunch,12,2.2037434254987807e-05,9,2.0502866984233294e-05,3,2.8418509922796382e-05
6016,update,12,2.2037434254987807e-05,9,2.0502866984233294e-05,3,2.8418509922796382e-05
6050,p,12,2.2037434254987807e-05,11,2.505905964739625e-05,1,9.472836640932127e-06
6056,openly,12,2.2037434254987807e-05,8,1.822477065265182e-05,4,3.789134656372851e-05
6112,proposal,12,2.2037434254987807e-05,8,1.822477065265182e-05,4,3.789134656372851e-05
6148,nurses,12,2.2037434254987807e-05,10,2.2780963315814774e-05,2,1.8945673281864254e-05
6205,wear,12,2.2037434254987807e-05,9,2.0502866984233294e-05,3,2.8418509922796382e-05
6309,approximately,12,2.2037434254987807e-05,11,2.505905964739625e-05,1,9.472836640932127e-06
6368,#ilikeobamacare,12,2.2037434254987807e-05,0,0,12,0.00011367403969118553
6370,explained,12,2.2037434254987807e-05,11,2.505905964739625e-05,1,9.472836640932127e-06
6728,uranium,12,2.2037434254987807e-05,11,2.505905964739625e-05,1,9.472836640932127e-06
6808,main,12,2.2037434254987807e-05,10,2.2780963315814774e-05,2,1.8945673281864254e-05
6911,dedication,12,2.2037434254987807e-05,8,1.822477065265182e-05,4,3.789134656372851e-05
7661,plane,12,2.2037434254987807e-05,11,2.505905964739625e-05,1,9.472836640932127e-06
7666,significant,12,2.2037434254987807e-05,11,2.505905964739625e-05,1,9.472836640932127e-06
7872,attend,12,2.2037434254987807e-05,10,2.2780963315814774e-05,2,1.8945673281864254e-05
7892,arab,12,2.2037434254987807e-05,12,2.7337155978977726e-05,0,0
7959,consent,12,2.2037434254987807e-05,12,2.7337155978977726e-05,0,0
8030,flip,12,2.2037434254987807e-05,12,2.7337155978977726e-05,0,0
8067,square,12,2.2037434254987807e-05,12,2.7337155978977726e-05,0,0
8095,embarrassed,12,2.2037434254987807e-05,12,2.7337155978977726e-05,0,0
8103,watcher,12,2.2037434254987807e-05,12,2.7337155978977726e-05,0,0
8282,interviews,12,2.2037434254987807e-05,12,2.7337155978977726e-05,0,0
8431,unhappy,12,2.2037434254987807e-05,12,2.7337155978977726e-05,0,0
8607,harry,12,2.2037434254987807e-05,12,2.7337155978977726e-05,0,0
8622,arkansas,12,2.2037434254987807e-05,12,2.7337155978977726e-05,0,0
8663,suspended,12,2.2037434254987807e-05,12,2.7337155978977726e-05,0,0
8688,underway,12,2.2037434254987807e-05,12,2.7337155978977726e-05,0,0
8699,liddle,12,2.2037434254987807e-05,12,2.7337155978977726e-05,0,0
8717,ocean,12,2.2037434254987807e-05,12,2.7337155978977726e-05,0,0
8837,taxed,12,2.2037434254987807e-05,12,2.7337155978977726e-05,0,0
8948,maria,12,2.2037434254987807e-05,12,2.7337155978977726e-05,0,0
8954,laura,12,2.2037434254987807e-05,12,2.7337155978977726e-05,0,0
9002,senior,12,2.2037434254987807e-05,12,2.7337155978977726e-05,0,0
9043,herself,12,2.2037434254987807e-05,12,2.7337155978977726e-05,0,0
9097,admits,12,2.2037434254987807e-05,12,2.7337155978977726e-05,0,0
9152,deadly,12,2.2037434254987807e-05,12,2.7337155978977726e-05,0,0
9249,soleimani,12,2.2037434254987807e-05,12,2.7337155978977726e-05,0,0
9274,relations,12,2.2037434254987807e-05,12,2.7337155978977726e-05,0,0
9305,franklin,12,2.2037434254987807e-05,12,2.7337155978977726e-05,0,0
9328,seal,12,2.2037434254987807e-05,12,2.7337155978977726e-05,0,0
9417,religion,12,2.2037434254987807e-05,12,2.7337155978977726e-05,0,0
9498,fishing,12,2.2037434254987807e-05,12,2.7337155978977726e-05,0,0
9527,de,12,2.2037434254987807e-05,12,2.7337155978977726e-05,0,0
9612,pure,12,2.2037434254987807e-05,12,2.7337155978977726e-05,0,0
9708,colluded,12,2.2037434254987807e-05,12,2.7337155978977726e-05,0,0
9740,weakness,12,2.2037434254987807e-05,12,2.7337155978977726e-05,0,0
9762,mildly,12,2.2037434254987807e-05,12,2.7337155978977726e-05,0,0
9784,pages,12,2.2037434254987807e-05,12,2.7337155978977726e-05,0,0
9797,slowly,12,2.2037434254987807e-05,12,2.7337155978977726e-05,0,0
9810,negotiated,12,2.2037434254987807e-05,12,2.7337155978977726e-05,0,0
9854,massively,12,2.2037434254987807e-05,12,2.7337155978977726e-05,0,0
9863,unpopular,12,2.2037434254987807e-05,12,2.7337155978977726e-05,0,0
9944,murder,12,2.2037434254987807e-05,12,2.7337155978977726e-05,0,0
9992,territory,12,2.2037434254987807e-05,12,2.7337155978977726e-05,0,0
10053,journalists,12,2.2037434254987807e-05,12,2.7337155978977726e-05,0,0
10081,friendship,12,2.2037434254987807e-05,12,2.7337155978977726e-05,0,0
10105,phones,12,2.2037434254987807e-05,12,2.7337155978977726e-05,0,0
10125,ایران,12,2.2037434254987807e-05,12,2.7337155978977726e-05,0,0
10212,organizations,12,2.2037434254987807e-05,12,2.7337155978977726e-05,0,0
10271,sounds,12,2.2037434254987807e-05,12,2.7337155978977726e-05,0,0
10373,intention,12,2.2037434254987807e-05,12,2.7337155978977726e-05,0,0
10516,foolish,12,2.2037434254987807e-05,12,2.7337155978977726e-05,0,0
10539,cable,12,2.2037434254987807e-05,12,2.7337155978977726e-05,0,0
10679,comcast,12,2.2037434254987807e-05,12,2.7337155978977726e-05,0,0
10752,macron,12,2.2037434254987807e-05,12,2.7337155978977726e-05,0,0
10790,steyer,12,2.2037434254987807e-05,12,2.7337155978977726e-05,0,0
10922,limbaugh,12,2.2037434254987807e-05,12,2.7337155978977726e-05,0,0
10949,switzerland,12,2.2037434254987807e-05,12,2.7337155978977726e-05,0,0
10978,carter,12,2.2037434254987807e-05,12,2.7337155978977726e-05,0,0
11227,lightweight,12,2.2037434254987807e-05,12,2.7337155978977726e-05,0,0
11243,endure,12,2.2037434254987807e-05,12,2.7337155978977726e-05,0,0
11281,enthusiastic,12,2.2037434254987807e-05,12,2.7337155978977726e-05,0,0
11334,flying,12,2.2037434254987807e-05,12,2.7337155978977726e-05,0,0
11362,impeaching,12,2.2037434254987807e-05,12,2.7337155978977726e-05,0,0
11938,releasing,12,2.2037434254987807e-05,12,2.7337155978977726e-05,0,0
11972,@nycmayor,12,2.2037434254987807e-05,12,2.7337155978977726e-05,0,0
11987,threats,12,2.2037434254987807e-05,12,2.7337155978977726e-05,0,0
12286,@netanyahu,12,2.2037434254987807e-05,12,2.7337155978977726e-05,0,0
12350,leak,12,2.2037434254987807e-05,12,2.7337155978977726e-05,0,0
12487,defeated,12,2.2037434254987807e-05,12,2.7337155978977726e-05,0,0
12548,muellers,12,2.2037434254987807e-05,12,2.7337155978977726e-05,0,0
12550,language,12,2.2037434254987807e-05,12,2.7337155978977726e-05,0,0
12655,smith,12,2.2037434254987807e-05,12,2.7337155978977726e-05,0,0
12741,inspector,12,2.2037434254987807e-05,12,2.7337155978977726e-05,0,0
12790,magic,12,2.2037434254987807e-05,12,2.7337155978977726e-05,0,0
12866,opec,12,2.2037434254987807e-05,12,2.7337155978977726e-05,0,0
12879,shootings,12,2.2037434254987807e-05,12,2.7337155978977726e-05,0,0
12979,merely,12,2.2037434254987807e-05,12,2.7337155978977726e-05,0,0
13163,traffickers,12,2.2037434254987807e-05,12,2.7337155978977726e-05,0,0
13705,unrelated,12,2.2037434254987807e-05,12,2.7337155978977726e-05,0,0
13910,harvard,12,2.2037434254987807e-05,12,2.7337155978977726e-05,0,0
14068,pols,12,2.2037434254987807e-05,12,2.7337155978977726e-05,0,0
14531,maxine,12,2.2037434254987807e-05,12,2.7337155978977726e-05,0,0
14593,desantis,12,2.2037434254987807e-05,12,2.7337155978977726e-05,0,0
14752,lobbyist,12,2.2037434254987807e-05,12,2.7337155978977726e-05,0,0
15132,deductibles,12,2.2037434254987807e-05,12,2.7337155978977726e-05,0,0
15148,hurricanes,12,2.2037434254987807e-05,12,2.7337155978977726e-05,0,0
15676,mrs,12,2.2037434254987807e-05,12,2.7337155978977726e-05,0,0
15694,ceasefire,12,2.2037434254987807e-05,12,2.7337155978977726e-05,0,0
16638,migrants,12,2.2037434254987807e-05,12,2.7337155978977726e-05,0,0
17025,florence,12,2.2037434254987807e-05,12,2.7337155978977726e-05,0,0
19259,dorian,12,2.2037434254987807e-05,12,2.7337155978977726e-05,0,0
110,door,11,2.0200981400405488e-05,8,1.822477065265182e-05,3,2.8418509922796382e-05
452,station,11,2.0200981400405488e-05,9,2.0502866984233294e-05,2,1.8945673281864254e-05
480,#leadonleave,11,2.0200981400405488e-05,0,0,11,0.0001042012030502534
793,dropping,11,2.0200981400405488e-05,10,2.2780963315814774e-05,1,9.472836640932127e-06
1047,issued,11,2.0200981400405488e-05,8,1.822477065265182e-05,3,2.8418509922796382e-05
1410,sacrifices,11,2.0200981400405488e-05,4,9.11238532632591e-06,7,6.63098564865249e-05
1710,#selma50,11,2.0200981400405488e-05,0,0,11,0.0001042012030502534
1803,determine,11,2.0200981400405488e-05,7,1.5946674321070342e-05,4,3.789134656372851e-05
1923,resolve,11,2.0200981400405488e-05,4,9.11238532632591e-06,7,6.63098564865249e-05
1979,ball,11,2.0200981400405488e-05,8,1.822477065265182e-05,3,2.8418509922796382e-05
2058,op-ed,11,2.0200981400405488e-05,5,1.1390481657907387e-05,6,5.6837019845592764e-05
2067,marketplace,11,2.0200981400405488e-05,0,0,11,0.0001042012030502534
2077,statue,11,2.0200981400405488e-05,8,1.822477065265182e-05,3,2.8418509922796382e-05
2125,stars,11,2.0200981400405488e-05,8,1.822477065265182e-05,3,2.8418509922796382e-05
2133,welcoming,11,2.0200981400405488e-05,6,1.3668577989488863e-05,5,4.736418320466063e-05
2267,condemn,11,2.0200981400405488e-05,9,2.0502866984233294e-05,2,1.8945673281864254e-05
2279,loudly,11,2.0200981400405488e-05,9,2.0502866984233294e-05,2,1.8945673281864254e-05
2333,54,11,2.0200981400405488e-05,4,9.11238532632591e-06,7,6.63098564865249e-05
2426,sons,11,2.0200981400405488e-05,3,6.8342889947444315e-06,8,7.578269312745701e-05
2428,wed,11,2.0200981400405488e-05,3,6.8342889947444315e-06,8,7.578269312745701e-05
2492,hitting,11,2.0200981400405488e-05,9,2.0502866984233294e-05,2,1.8945673281864254e-05
2600,opens,11,2.0200981400405488e-05,8,1.822477065265182e-05,3,2.8418509922796382e-05
2630,honors,11,2.0200981400405488e-05,4,9.11238532632591e-06,7,6.63098564865249e-05
2715,44,11,2.0200981400405488e-05,6,1.3668577989488863e-05,5,4.736418320466063e-05
2745,77,11,2.0200981400405488e-05,7,1.5946674321070342e-05,4,3.789134656372851e-05
2864,strengthening,11,2.0200981400405488e-05,7,1.5946674321070342e-05,4,3.789134656372851e-05
2901,nationwide,11,2.0200981400405488e-05,6,1.3668577989488863e-05,5,4.736418320466063e-05
2925,wednesday,11,2.0200981400405488e-05,8,1.822477065265182e-05,3,2.8418509922796382e-05
2989,restoring,11,2.0200981400405488e-05,4,9.11238532632591e-06,7,6.63098564865249e-05
3173,training,11,2.0200981400405488e-05,6,1.3668577989488863e-05,5,4.736418320466063e-05
3179,unacceptable,11,2.0200981400405488e-05,9,2.0502866984233294e-05,2,1.8945673281864254e-05
3273,educators,11,2.0200981400405488e-05,5,1.1390481657907387e-05,6,5.6837019845592764e-05
3355,proposing,11,2.0200981400405488e-05,5,1.1390481657907387e-05,6,5.6837019845592764e-05
3414,individuals,11,2.0200981400405488e-05,9,2.0502866984233294e-05,2,1.8945673281864254e-05
3433,#marriageequality,11,2.0200981400405488e-05,0,0,11,0.0001042012030502534
3530,demands,11,2.0200981400405488e-05,10,2.2780963315814774e-05,1,9.472836640932127e-06
3567,tears,11,2.0200981400405488e-05,9,2.0502866984233294e-05,2,1.8945673281864254e-05
3629,sought,11,2.0200981400405488e-05,10,2.2780963315814774e-05,1,9.472836640932127e-06
3635,belong,11,2.0200981400405488e-05,7,1.5946674321070342e-05,4,3.789134656372851e-05
3809,concrete,11,2.0200981400405488e-05,8,1.822477065265182e-05,3,2.8418509922796382e-05
3870,breaks,11,2.0200981400405488e-05,2,4.556192663162955e-06,9,8.525552976838915e-05
3954,hr,11,2.0200981400405488e-05,10,2.2780963315814774e-05,1,9.472836640932127e-06
4031,appreciation,11,2.0200981400405488e-05,7,1.5946674321070342e-05,4,3.789134656372851e-05
4065,listened,11,2.0200981400405488e-05,9,2.0502866984233294e-05,2,1.8945673281864254e-05
4139,precious,11,2.0200981400405488e-05,8,1.822477065265182e-05,3,2.8418509922796382e-05
4214,#jobsnotcuts,11,2.0200981400405488e-05,0,0,11,0.0001042012030502534
4251,victim,11,2.0200981400405488e-05,9,2.0502866984233294e-05,2,1.8945673281864254e-05
4315,reminds,11,2.0200981400405488e-05,7,1.5946674321070342e-05,4,3.789134656372851e-05
4369,understood,11,2.0200981400405488e-05,10,2.2780963315814774e-05,1,9.472836640932127e-06
4409,150,11,2.0200981400405488e-05,10,2.2780963315814774e-05,1,9.472836640932127e-06
4413,extra,11,2.0200981400405488e-05,2,4.556192663162955e-06,9,8.525552976838915e-05
4421,hikes,11,2.0200981400405488e-05,7,1.5946674321070342e-05,4,3.789134656372851e-05
4445,complex,11,2.0200981400405488e-05,10,2.2780963315814774e-05,1,9.472836640932127e-06
4465,250000,11,2.0200981400405488e-05,2,4.556192663162955e-06,9,8.525552976838915e-05
4493,email,11,2.0200981400405488e-05,8,1.822477065265182e-05,3,2.8418509922796382e-05
4521,campaigned,11,2.0200981400405488e-05,10,2.2780963315814774e-05,1,9.472836640932127e-06
4568,ordered,11,2.0200981400405488e-05,9,2.0502866984233294e-05,2,1.8945673281864254e-05
4564,bin,11,2.0200981400405488e-05,5,1.1390481657907387e-05,6,5.6837019845592764e-05
4664,ought,11,2.0200981400405488e-05,8,1.822477065265182e-05,3,2.8418509922796382e-05
4799,yourselves,11,2.0200981400405488e-05,10,2.2780963315814774e-05,1,9.472836640932127e-06
4812,chant,11,2.0200981400405488e-05,8,1.822477065265182e-05,3,2.8418509922796382e-05
4863,#promisekept,11,2.0200981400405488e-05,0,0,11,0.0001042012030502534
4869,nov,11,2.0200981400405488e-05,7,1.5946674321070342e-05,4,3.789134656372851e-05
4959,overturn,11,2.0200981400405488e-05,10,2.2780963315814774e-05,1,9.472836640932127e-06
5065,morgan,11,2.0200981400405488e-05,7,1.5946674321070342e-05,4,3.789134656372851e-05
5127,#regtovote,11,2.0200981400405488e-05,0,0,11,0.0001042012030502534
5311,percentage,11,2.0200981400405488e-05,9,2.0502866984233294e-05,2,1.8945673281864254e-05
5337,guest,11,2.0200981400405488e-05,5,1.1390481657907387e-05,6,5.6837019845592764e-05
5359,palm,11,2.0200981400405488e-05,10,2.2780963315814774e-05,1,9.472836640932127e-06
5367,campaigns,11,2.0200981400405488e-05,8,1.822477065265182e-05,3,2.8418509922796382e-05
5536,400000,11,2.0200981400405488e-05,6,1.3668577989488863e-05,5,4.736418320466063e-05
5561,#women2012,11,2.0200981400405488e-05,0,0,11,0.0001042012030502534
5576,subsidies,11,2.0200981400405488e-05,5,1.1390481657907387e-05,6,5.6837019845592764e-05
5864,criticized,11,2.0200981400405488e-05,9,2.0502866984233294e-05,2,1.8945673281864254e-05
5989,outcome,11,2.0200981400405488e-05,9,2.0502866984233294e-05,2,1.8945673281864254e-05
6195,pacific,11,2.0200981400405488e-05,10,2.2780963315814774e-05,1,9.472836640932127e-06
6253,announces,11,2.0200981400405488e-05,4,9.11238532632591e-06,7,6.63098564865249e-05
6313,forum,11,2.0200981400405488e-05,9,2.0502866984233294e-05,2,1.8945673281864254e-05
6333,buffett,11,2.0200981400405488e-05,0,0,11,0.0001042012030502534
6713,intellectual,11,2.0200981400405488e-05,10,2.2780963315814774e-05,1,9.472836640932127e-06
6904,#passthebill,11,2.0200981400405488e-05,2,4.556192663162955e-06,9,8.525552976838915e-05
7230,francisco,11,2.0200981400405488e-05,10,2.2780963315814774e-05,1,9.472836640932127e-06
7245,#uswnt,11,2.0200981400405488e-05,0,0,11,0.0001042012030502534
7397,patriotic,11,2.0200981400405488e-05,10,2.2780963315814774e-05,1,9.472836640932127e-06
7468,box,11,2.0200981400405488e-05,10,2.2780963315814774e-05,1,9.472836640932127e-06
7557,option,11,2.0200981400405488e-05,9,2.0502866984233294e-05,2,1.8945673281864254e-05
7639,passion,11,2.0200981400405488e-05,10,2.2780963315814774e-05,1,9.472836640932127e-06
7708,possibility,11,2.0200981400405488e-05,10,2.2780963315814774e-05,1,9.472836640932127e-06
7737,nominate,11,2.0200981400405488e-05,10,2.2780963315814774e-05,1,9.472836640932127e-06
7773,partnership,11,2.0200981400405488e-05,10,2.2780963315814774e-05,1,9.472836640932127e-06
7846,disinformation,11,2.0200981400405488e-05,10,2.2780963315814774e-05,1,9.472836640932127e-06
7869,virtual,11,2.0200981400405488e-05,10,2.2780963315814774e-05,1,9.472836640932127e-06
7979,12th,11,2.0200981400405488e-05,11,2.505905964739625e-05,0,0
8029,envelopes,11,2.0200981400405488e-05,11,2.505905964739625e-05,0,0
8047,daytime,11,2.0200981400405488e-05,11,2.505905964739625e-05,0,0
8082,trending,11,2.0200981400405488e-05,11,2.505905964739625e-05,0,0
8192,commissioner,11,2.0200981400405488e-05,11,2.505905964739625e-05,0,0
8263,rudy,11,2.0200981400405488e-05,11,2.505905964739625e-05,0,0
8493,treasonous,11,2.0200981400405488e-05,11,2.505905964739625e-05,0,0
8627,zone,11,2.0200981400405488e-05,11,2.505905964739625e-05,0,0
8634,e,11,2.0200981400405488e-05,11,2.505905964739625e-05,0,0
8807,visa,11,2.0200981400405488e-05,11,2.505905964739625e-05,0,0
8858,unified,11,2.0200981400405488e-05,11,2.505905964739625e-05,0,0
8925,@cdcgov,11,2.0200981400405488e-05,11,2.505905964739625e-05,0,0
8939,violated,11,2.0200981400405488e-05,11,2.505905964739625e-05,0,0
8940,cooperation,11,2.0200981400405488e-05,11,2.505905964739625e-05,0,0
8978,g,11,2.0200981400405488e-05,11,2.505905964739625e-05,0,0
8995,ally,11,2.0200981400405488e-05,11,2.505905964739625e-05,0,0
9016,treasure,11,2.0200981400405488e-05,11,2.505905964739625e-05,0,0
9026,entry,11,2.0200981400405488e-05,11,2.505905964739625e-05,0,0
9103,lt,11,2.0200981400405488e-05,11,2.505905964739625e-05,0,0
9122,@marthamaccallum,11,2.0200981400405488e-05,11,2.505905964739625e-05,0,0
9190,gallup,11,2.0200981400405488e-05,11,2.505905964739625e-05,0,0
9217,factories,11,2.0200981400405488e-05,11,2.505905964739625e-05,0,0
9363,legendary,11,2.0200981400405488e-05,11,2.505905964739625e-05,0,0
9444,somewhat,11,2.0200981400405488e-05,11,2.505905964739625e-05,0,0
9476,ruined,11,2.0200981400405488e-05,11,2.505905964739625e-05,0,0
9473,depleted,11,2.0200981400405488e-05,11,2.505905964739625e-05,0,0
9623,races,11,2.0200981400405488e-05,11,2.505905964739625e-05,0,0
9649,hacking,11,2.0200981400405488e-05,11,2.505905964739625e-05,0,0
9815,@wsj,11,2.0200981400405488e-05,11,2.505905964739625e-05,0,0
9834,obstructionist,11,2.0200981400405488e-05,11,2.505905964739625e-05,0,0
9883,unwilling,11,2.0200981400405488e-05,11,2.505905964739625e-05,0,0
9920,requests,11,2.0200981400405488e-05,11,2.505905964739625e-05,0,0
10002,squad,11,2.0200981400405488e-05,11,2.505905964739625e-05,0,0
10136,را,11,2.0200981400405488e-05,11,2.505905964739625e-05,0,0
10260,connecticut,11,2.0200981400405488e-05,11,2.505905964739625e-05,0,0
10355,easing,11,2.0200981400405488e-05,11,2.505905964739625e-05,0,0
10385,helicopter,11,2.0200981400405488e-05,11,2.505905964739625e-05,0,0
10452,jury,11,2.0200981400405488e-05,11,2.505905964739625e-05,0,0
10583,supposedly,11,2.0200981400405488e-05,11,2.505905964739625e-05,0,0
10614,frame,11,2.0200981400405488e-05,11,2.505905964739625e-05,0,0
10662,chiefs,11,2.0200981400405488e-05,11,2.505905964739625e-05,0,0
10732,propaganda,11,2.0200981400405488e-05,11,2.505905964739625e-05,0,0
10743,@greggutfeld,11,2.0200981400405488e-05,11,2.505905964739625e-05,0,0
11019,agriculture,11,2.0200981400405488e-05,11,2.505905964739625e-05,0,0
11037,disparage,11,2.0200981400405488e-05,11,2.505905964739625e-05,0,0
11056,stupidity,11,2.0200981400405488e-05,11,2.505905964739625e-05,0,0
11109,van,11,2.0200981400405488e-05,11,2.505905964739625e-05,0,0
11284,beating,11,2.0200981400405488e-05,11,2.505905964739625e-05,0,0
11286,stiff,11,2.0200981400405488e-05,11,2.505905964739625e-05,0,0
11535,mar-a-lago,11,2.0200981400405488e-05,11,2.505905964739625e-05,0,0
11611,mourn,11,2.0200981400405488e-05,11,2.505905964739625e-05,0,0
11745,manafort,11,2.0200981400405488e-05,11,2.505905964739625e-05,0,0
11851,doral,11,2.0200981400405488e-05,11,2.505905964739625e-05,0,0
11865,ruled,11,2.0200981400405488e-05,11,2.505905964739625e-05,0,0
12000,@ainsleyearhardt,11,2.0200981400405488e-05,11,2.505905964739625e-05,0,0
12190,theft,11,2.0200981400405488e-05,11,2.505905964739625e-05,0,0
12493,crew,11,2.0200981400405488e-05,11,2.505905964739625e-05,0,0
12862,declaration,11,2.0200981400405488e-05,11,2.505905964739625e-05,0,0
12871,rod,11,2.0200981400405488e-05,11,2.505905964739625e-05,0,0
12961,quote,11,2.0200981400405488e-05,11,2.505905964739625e-05,0,0
13047,foolishly,11,2.0200981400405488e-05,11,2.505905964739625e-05,0,0
13087,jerusalem,11,2.0200981400405488e-05,11,2.505905964739625e-05,0,0
13349,fraction,11,2.0200981400405488e-05,11,2.505905964739625e-05,0,0
13356,@trishregan,11,2.0200981400405488e-05,11,2.505905964739625e-05,0,0
13780,disappeared,11,2.0200981400405488e-05,11,2.505905964739625e-05,0,0
13859,correctly,11,2.0200981400405488e-05,11,2.505905964739625e-05,0,0
13932,mexican,11,2.0200981400405488e-05,11,2.505905964739625e-05,0,0
14056,salvador,11,2.0200981400405488e-05,11,2.505905964739625e-05,0,0
14126,hostile,11,2.0200981400405488e-05,11,2.505905964739625e-05,0,0
14212,counter,11,2.0200981400405488e-05,11,2.505905964739625e-05,0,0
14351,ambassadors,11,2.0200981400405488e-05,11,2.505905964739625e-05,0,0
14804,tiger,11,2.0200981400405488e-05,11,2.505905964739625e-05,0,0
15438,sc,11,2.0200981400405488e-05,11,2.505905964739625e-05,0,0
15605,leakers,11,2.0200981400405488e-05,11,2.505905964739625e-05,0,0
16298,brunson,11,2.0200981400405488e-05,11,2.505905964739625e-05,0,0
16414,hilton,11,2.0200981400405488e-05,11,2.505905964739625e-05,0,0
17450,dirt,11,2.0200981400405488e-05,11,2.505905964739625e-05,0,0
17843,memos,11,2.0200981400405488e-05,11,2.505905964739625e-05,0,0
109,donation,10,1.8364528545823173e-05,1,2.2780963315814773e-06,9,8.525552976838915e-05
123,momentum,10,1.8364528545823173e-05,4,9.11238532632591e-06,6,5.6837019845592764e-05
435,rejected,10,1.8364528545823173e-05,9,2.0502866984233294e-05,1,9.472836640932127e-06
436,effects,10,1.8364528545823173e-05,2,4.556192663162955e-06,8,7.578269312745701e-05
444,41,10,1.8364528545823173e-05,9,2.0502866984233294e-05,1,9.472836640932127e-06
461,pipeline,10,1.8364528545823173e-05,3,6.8342889947444315e-06,7,6.63098564865249e-05
827,controversial,10,1.8364528545823173e-05,4,9.11238532632591e-06,6,5.6837019845592764e-05
838,99,10,1.8364528545823173e-05,7,1.5946674321070342e-05,3,2.8418509922796382e-05
862,graduate,10,1.8364528545823173e-05,7,1.5946674321070342e-05,3,2.8418509922796382e-05
891,marines,10,1.8364528545823173e-05,8,1.822477065265182e-05,2,1.8945673281864254e-05
926,65,10,1.8364528545823173e-05,3,6.8342889947444315e-06,7,6.63098564865249e-05
960,challenged,10,1.8364528545823173e-05,7,1.5946674321070342e-05,3,2.8418509922796382e-05
980,maintain,10,1.8364528545823173e-05,7,1.5946674321070342e-05,3,2.8418509922796382e-05
1079,entirely,10,1.8364528545823173e-05,9,2.0502866984233294e-05,1,9.472836640932127e-06
1092,zones,10,1.8364528545823173e-05,8,1.822477065265182e-05,2,1.8945673281864254e-05
1228,56,10,1.8364528545823173e-05,7,1.5946674321070342e-05,3,2.8418509922796382e-05
1305,backwards,10,1.8364528545823173e-05,4,9.11238532632591e-06,6,5.6837019845592764e-05
1389,claimed,10,1.8364528545823173e-05,7,1.5946674321070342e-05,3,2.8418509922796382e-05
1418,mad,10,1.8364528545823173e-05,8,1.822477065265182e-05,2,1.8945673281864254e-05
1429,killer,10,1.8364528545823173e-05,9,2.0502866984233294e-05,1,9.472836640932127e-06
1487,runs,10,1.8364528545823173e-05,9,2.0502866984233294e-05,1,9.472836640932127e-06
1492,inspire,10,1.8364528545823173e-05,8,1.822477065265182e-05,2,1.8945673281864254e-05
1502,lynch,10,1.8364528545823173e-05,8,1.822477065265182e-05,2,1.8945673281864254e-05
1514,meant,10,1.8364528545823173e-05,7,1.5946674321070342e-05,3,2.8418509922796382e-05
1617,flight,10,1.8364528545823173e-05,8,1.822477065265182e-05,2,1.8945673281864254e-05
1775,manufactured,10,1.8364528545823173e-05,7,1.5946674321070342e-05,3,2.8418509922796382e-05
1898,constant,10,1.8364528545823173e-05,9,2.0502866984233294e-05,1,9.472836640932127e-06
2023,enroll,10,1.8364528545823173e-05,0,0,10,9.472836640932126e-05
2025,preserve,10,1.8364528545823173e-05,9,2.0502866984233294e-05,1,9.472836640932127e-06
2032,moral,10,1.8364528545823173e-05,3,6.8342889947444315e-06,7,6.63098564865249e-05
2039,undocumented,10,1.8364528545823173e-05,2,4.556192663162955e-06,8,7.578269312745701e-05
2109,economies,10,1.8364528545823173e-05,7,1.5946674321070342e-05,3,2.8418509922796382e-05
2139,#womensucceed,10,1.8364528545823173e-05,0,0,10,9.472836640932126e-05
2429,belongs,10,1.8364528545823173e-05,5,1.1390481657907387e-05,5,4.736418320466063e-05
2444,hardest,10,1.8364528545823173e-05,3,6.8342889947444315e-06,7,6.63098564865249e-05
2496,several,10,1.8364528545823173e-05,7,1.5946674321070342e-05,3,2.8418509922796382e-05
2531,counts,10,1.8364528545823173e-05,8,1.822477065265182e-05,2,1.8945673281864254e-05
2533,#familiessucceed,10,1.8364528545823173e-05,0,0,10,9.472836640932126e-05
2546,decent,10,1.8364528545823173e-05,3,6.8342889947444315e-06,7,6.63098564865249e-05
2564,unthinkable,10,1.8364528545823173e-05,9,2.0502866984233294e-05,1,9.472836640932127e-06
2576,dad,10,1.8364528545823173e-05,4,9.11238532632591e-06,6,5.6837019845592764e-05
2618,expansion,10,1.8364528545823173e-05,2,4.556192663162955e-06,8,7.578269312745701e-05
2656,museum,10,1.8364528545823173e-05,6,1.3668577989488863e-05,4,3.789134656372851e-05
2752,23,10,1.8364528545823173e-05,5,1.1390481657907387e-05,5,4.736418320466063e-05
2815,bought,10,1.8364528545823173e-05,7,1.5946674321070342e-05,3,2.8418509922796382e-05
2879,sits,10,1.8364528545823173e-05,6,1.3668577989488863e-05,4,3.789134656372851e-05
2884,speeches,10,1.8364528545823173e-05,7,1.5946674321070342e-05,3,2.8418509922796382e-05
2899,prepare,10,1.8364528545823173e-05,6,1.3668577989488863e-05,4,3.789134656372851e-05
2944,plays,10,1.8364528545823173e-05,7,1.5946674321070342e-05,3,2.8418509922796382e-05
2957,airports,10,1.8364528545823173e-05,8,1.822477065265182e-05,2,1.8945673281864254e-05
3141,roe,10,1.8364528545823173e-05,2,4.556192663162955e-06,8,7.578269312745701e-05
3142,wade,10,1.8364528545823173e-05,2,4.556192663162955e-06,8,7.578269312745701e-05
3292,traveled,10,1.8364528545823173e-05,3,6.8342889947444315e-06,7,6.63098564865249e-05
3391,philippines,10,1.8364528545823173e-05,9,2.0502866984233294e-05,1,9.472836640932127e-06
3487,tea,10,1.8364528545823173e-05,0,0,10,9.472836640932126e-05
3576,46,10,1.8364528545823173e-05,7,1.5946674321070342e-05,3,2.8418509922796382e-05
3641,shared,10,1.8364528545823173e-05,6,1.3668577989488863e-05,4,3.789134656372851e-05
3657,spreading,10,1.8364528545823173e-05,9,2.0502866984233294e-05,1,9.472836640932127e-06
3654,@barackobama,10,1.8364528545823173e-05,0,0,10,9.472836640932126e-05
3740,ultimate,10,1.8364528545823173e-05,8,1.822477065265182e-05,2,1.8945673281864254e-05
3768,meaningless,10,1.8364528545823173e-05,8,1.822477065265182e-05,2,1.8945673281864254e-05
3899,b,10,1.8364528545823173e-05,8,1.822477065265182e-05,2,1.8945673281864254e-05
3917,houston,10,1.8364528545823173e-05,9,2.0502866984233294e-05,1,9.472836640932127e-06
4025,ties,10,1.8364528545823173e-05,9,2.0502866984233294e-05,1,9.472836640932127e-06
4263,brutal,10,1.8364528545823173e-05,9,2.0502866984233294e-05,1,9.472836640932127e-06
4264,magnet,10,1.8364528545823173e-05,2,4.556192663162955e-06,8,7.578269312745701e-05
4524,7pm,10,1.8364528545823173e-05,6,1.3668577989488863e-05,4,3.789134656372851e-05
4584,grace,10,1.8364528545823173e-05,6,1.3668577989488863e-05,4,3.789134656372851e-05
4611,obama-biden,10,1.8364528545823173e-05,3,6.8342889947444315e-06,7,6.63098564865249e-05
4651,romney-ryan,10,1.8364528545823173e-05,0,0,10,9.472836640932126e-05
4693,compete,10,1.8364528545823173e-05,7,1.5946674321070342e-05,3,2.8418509922796382e-05
4764,collapse,10,1.8364528545823173e-05,7,1.5946674321070342e-05,3,2.8418509922796382e-05
4779,banning,10,1.8364528545823173e-05,5,1.1390481657907387e-05,5,4.736418320466063e-05
4814,sticking,10,1.8364528545823173e-05,4,9.11238532632591e-06,6,5.6837019845592764e-05
4839,fred,10,1.8364528545823173e-05,9,2.0502866984233294e-05,1,9.472836640932127e-06
4891,laden,10,1.8364528545823173e-05,5,1.1390481657907387e-05,5,4.736418320466063e-05
4941,qualified,10,1.8364528545823173e-05,8,1.822477065265182e-05,2,1.8945673281864254e-05
4946,stance,10,1.8364528545823173e-05,8,1.822477065265182e-05,2,1.8945673281864254e-05
5041,explains,10,1.8364528545823173e-05,0,0,10,9.472836640932126e-05
5109,overturned,10,1.8364528545823173e-05,9,2.0502866984233294e-05,1,9.472836640932127e-06
5133,registration,10,1.8364528545823173e-05,3,6.8342889947444315e-06,7,6.63098564865249e-05
5205,button,10,1.8364528545823173e-05,6,1.3668577989488863e-05,4,3.789134656372851e-05
5284,hiding,10,1.8364528545823173e-05,7,1.5946674321070342e-05,3,2.8418509922796382e-05
5396,kick,10,1.8364528545823173e-05,6,1.3668577989488863e-05,4,3.789134656372851e-05
5405,alive,10,1.8364528545823173e-05,8,1.822477065265182e-05,2,1.8945673281864254e-05
5413,#pride2012,10,1.8364528545823173e-05,0,0,10,9.472836640932126e-05
5470,necessity,10,1.8364528545823173e-05,4,9.11238532632591e-06,6,5.6837019845592764e-05
5514,545,10,1.8364528545823173e-05,9,2.0502866984233294e-05,1,9.472836640932127e-06
5549,recipients,10,1.8364528545823173e-05,8,1.822477065265182e-05,2,1.8945673281864254e-05
5687,determination,10,1.8364528545823173e-05,9,2.0502866984233294e-05,1,9.472836640932127e-06
5759,pledged,10,1.8364528545823173e-05,6,1.3668577989488863e-05,4,3.789134656372851e-05
5843,worship,10,1.8364528545823173e-05,9,2.0502866984233294e-05,1,9.472836640932127e-06
5883,earnings,10,1.8364528545823173e-05,8,1.822477065265182e-05,2,1.8945673281864254e-05
6013,5000,10,1.8364528545823173e-05,9,2.0502866984233294e-05,1,9.472836640932127e-06
6076,#romneyeconomics,10,1.8364528545823173e-05,0,0,10,9.472836640932126e-05
6104,stores,10,1.8364528545823173e-05,8,1.822477065265182e-05,2,1.8945673281864254e-05
6272,stops,10,1.8364528545823173e-05,9,2.0502866984233294e-05,1,9.472836640932127e-06
6471,#wecantwait,10,1.8364528545823173e-05,0,0,10,9.472836640932126e-05
6552,chosen,10,1.8364528545823173e-05,8,1.822477065265182e-05,2,1.8945673281864254e-05
6594,enjoyed,10,1.8364528545823173e-05,8,1.822477065265182e-05,2,1.8945673281864254e-05
6652,submitted,10,1.8364528545823173e-05,9,2.0502866984233294e-05,1,9.472836640932127e-06
6668,unchecked,10,1.8364528545823173e-05,9,2.0502866984233294e-05,1,9.472836640932127e-06
6698,recommended,10,1.8364528545823173e-05,9,2.0502866984233294e-05,1,9.472836640932127e-06
6746,fashion,10,1.8364528545823173e-05,9,2.0502866984233294e-05,1,9.472836640932127e-06
6987,outrage,10,1.8364528545823173e-05,9,2.0502866984233294e-05,1,9.472836640932127e-06
7067,nuts,10,1.8364528545823173e-05,9,2.0502866984233294e-05,1,9.472836640932127e-06
7336,#hcr,10,1.8364528545823173e-05,0,0,10,9.472836640932126e-05
7359,govt,10,1.8364528545823173e-05,9,2.0502866984233294e-05,1,9.472836640932127e-06
7360,battles,10,1.8364528545823173e-05,9,2.0502866984233294e-05,1,9.472836640932127e-06
7388,silence,10,1.8364528545823173e-05,7,1.5946674321070342e-05,3,2.8418509922796382e-05
7390,wing,10,1.8364528545823173e-05,7,1.5946674321070342e-05,3,2.8418509922796382e-05
7411,jews,10,1.8364528545823173e-05,9,2.0502866984233294e-05,1,9.472836640932127e-06
7706,pictures,10,1.8364528545823173e-05,9,2.0502866984233294e-05,1,9.472836640932127e-06
7723,gratitude,10,1.8364528545823173e-05,8,1.822477065265182e-05,2,1.8945673281864254e-05
7790,pearl,10,1.8364528545823173e-05,9,2.0502866984233294e-05,1,9.472836640932127e-06
7799,editor,10,1.8364528545823173e-05,9,2.0502866984233294e-05,1,9.472836640932127e-06
7884,unsolicited,10,1.8364528545823173e-05,10,2.2780963315814774e-05,0,0
7893,bahrain,10,1.8364528545823173e-05,10,2.2780963315814774e-05,0,0
7909,#vote,10,1.8364528545823173e-05,10,2.2780963315814774e-05,0,0
7929,@repdougcollins,10,1.8364528545823173e-05,10,2.2780963315814774e-05,0,0
7949,@sendavidperdue,10,1.8364528545823173e-05,10,2.2780963315814774e-05,0,0
7961,recount,10,1.8364528545823173e-05,10,2.2780963315814774e-05,0,0
7964,floyd,10,1.8364528545823173e-05,10,2.2780963315814774e-05,0,0
7999,laughed,10,1.8364528545823173e-05,10,2.2780963315814774e-05,0,0
8052,4000,10,1.8364528545823173e-05,10,2.2780963315814774e-05,0,0
8053,fulton,10,1.8364528545823173e-05,10,2.2780963315814774e-05,0,0
8119,@randpaul,10,1.8364528545823173e-05,10,2.2780963315814774e-05,0,0
8190,newly,10,1.8364528545823173e-05,10,2.2780963315814774e-05,0,0
8249,@secpompeo,10,1.8364528545823173e-05,10,2.2780963315814774e-05,0,0
8296,margin,10,1.8364528545823173e-05,10,2.2780963315814774e-05,0,0
8322,monitor,10,1.8364528545823173e-05,10,2.2780963315814774e-05,0,0
8340,tony,10,1.8364528545823173e-05,10,2.2780963315814774e-05,0,0
8434,coordination,10,1.8364528545823173e-05,10,2.2780963315814774e-05,0,0
8472,cure,10,1.8364528545823173e-05,10,2.2780963315814774e-05,0,0
8509,larry,10,1.8364528545823173e-05,10,2.2780963315814774e-05,0,0
8507,flawed,10,1.8364528545823173e-05,10,2.2780963315814774e-05,0,0
8546,analysis,10,1.8364528545823173e-05,10,2.2780963315814774e-05,0,0
8567,unsafe,10,1.8364528545823173e-05,10,2.2780963315814774e-05,0,0
8577,overrated,10,1.8364528545823173e-05,10,2.2780963315814774e-05,0,0
8651,liability,10,1.8364528545823173e-05,10,2.2780963315814774e-05,0,0
8653,bail,10,1.8364528545823173e-05,10,2.2780963315814774e-05,0,0
8684,roaring,10,1.8364528545823173e-05,10,2.2780963315814774e-05,0,0
8728,hacked,10,1.8364528545823173e-05,10,2.2780963315814774e-05,0,0
8729,lowlife,10,1.8364528545823173e-05,10,2.2780963315814774e-05,0,0
8759,empty,10,1.8364528545823173e-05,10,2.2780963315814774e-05,0,0
8953,engaged,10,1.8364528545823173e-05,10,2.2780963315814774e-05,0,0
8958,rinos,10,1.8364528545823173e-05,10,2.2780963315814774e-05,0,0
9073,kneeling,10,1.8364528545823173e-05,10,2.2780963315814774e-05,0,0
9140,reductions,10,1.8364528545823173e-05,10,2.2780963315814774e-05,0,0
9177,incorrectly,10,1.8364528545823173e-05,10,2.2780963315814774e-05,0,0
9243,accountability,10,1.8364528545823173e-05,10,2.2780963315814774e-05,0,0
9576,kenosha,10,1.8364528545823173e-05,10,2.2780963315814774e-05,0,0
9607,lake,10,1.8364528545823173e-05,10,2.2780963315814774e-05,0,0
9618,katie,10,1.8364528545823173e-05,10,2.2780963315814774e-05,0,0
9720,dana,10,1.8364528545823173e-05,10,2.2780963315814774e-05,0,0
9766,concerns,10,1.8364528545823173e-05,10,2.2780963315814774e-05,0,0
9839,hawley,10,1.8364528545823173e-05,10,2.2780963315814774e-05,0,0
9848,presented,10,1.8364528545823173e-05,10,2.2780963315814774e-05,0,0
10148,و,10,1.8364528545823173e-05,10,2.2780963315814774e-05,0,0
10160,@chuckgrassley,10,1.8364528545823173e-05,10,2.2780963315814774e-05,0,0
10172,hunts,10,1.8364528545823173e-05,10,2.2780963315814774e-05,0,0
10200,thereby,10,1.8364528545823173e-05,10,2.2780963315814774e-05,0,0
10435,sweden,10,1.8364528545823173e-05,10,2.2780963315814774e-05,0,0
10467,taliban,10,1.8364528545823173e-05,10,2.2780963315814774e-05,0,0
10484,command,10,1.8364528545823173e-05,10,2.2780963315814774e-05,0,0
10619,employed,10,1.8364528545823173e-05,10,2.2780963315814774e-05,0,0
10653,criticize,10,1.8364528545823173e-05,10,2.2780963315814774e-05,0,0
10684,247365,10,1.8364528545823173e-05,10,2.2780963315814774e-05,0,0
10796,rapid,10,1.8364528545823173e-05,10,2.2780963315814774e-05,0,0
10944,heavy,10,1.8364528545823173e-05,10,2.2780963315814774e-05,0,0
10948,davos,10,1.8364528545823173e-05,10,2.2780963315814774e-05,0,0
11033,ripping,10,1.8364528545823173e-05,10,2.2780963315814774e-05,0,0
11046,begged,10,1.8364528545823173e-05,10,2.2780963315814774e-05,0,0
11061,assets,10,1.8364528545823173e-05,10,2.2780963315814774e-05,0,0
11216,iron,10,1.8364528545823173e-05,10,2.2780963315814774e-05,0,0
11320,blow,10,1.8364528545823173e-05,10,2.2780963315814774e-05,0,0
11372,nj,10,1.8364528545823173e-05,10,2.2780963315814774e-05,0,0
11445,misconduct,10,1.8364528545823173e-05,10,2.2780963315814774e-05,0,0
11472,catastrophic,10,1.8364528545823173e-05,10,2.2780963315814774e-05,0,0
11531,suggest,10,1.8364528545823173e-05,10,2.2780963315814774e-05,0,0
11597,districts,10,1.8364528545823173e-05,10,2.2780963315814774e-05,0,0
11696,directed,10,1.8364528545823173e-05,10,2.2780963315814774e-05,0,0
12116,parkland,10,1.8364528545823173e-05,10,2.2780963315814774e-05,0,0
12169,abandoned,10,1.8364528545823173e-05,10,2.2780963315814774e-05,0,0
12511,replacement,10,1.8364528545823173e-05,10,2.2780963315814774e-05,0,0
12512,gregg,10,1.8364528545823173e-05,10,2.2780963315814774e-05,0,0
12589,jet,10,1.8364528545823173e-05,10,2.2780963315814774e-05,0,0
12598,mob,10,1.8364528545823173e-05,10,2.2780963315814774e-05,0,0
12650,handed,10,1.8364528545823173e-05,10,2.2780963315814774e-05,0,0
12753,pro-life,10,1.8364528545823173e-05,10,2.2780963315814774e-05,0,0
12964,memo,10,1.8364528545823173e-05,10,2.2780963315814774e-05,0,0
13007,sympathies,10,1.8364528545823173e-05,10,2.2780963315814774e-05,0,0
13054,accused,10,1.8364528545823173e-05,10,2.2780963315814774e-05,0,0
13059,brandon,10,1.8364528545823173e-05,10,2.2780963315814774e-05,0,0
13062,dark,10,1.8364528545823173e-05,10,2.2780963315814774e-05,0,0
13112,dialogue,10,1.8364528545823173e-05,10,2.2780963315814774e-05,0,0
13139,fashioned,10,1.8364528545823173e-05,10,2.2780963315814774e-05,0,0
13804,reciprocal,10,1.8364528545823173e-05,10,2.2780963315814774e-05,0,0
14102,richer,10,1.8364528545823173e-05,10,2.2780963315814774e-05,0,0
14173,subpoena,10,1.8364528545823173e-05,10,2.2780963315814774e-05,0,0
14679,outlets,10,1.8364528545823173e-05,10,2.2780963315814774e-05,0,0
14847,obstructionists,10,1.8364528545823173e-05,10,2.2780963315814774e-05,0,0
15044,#taxreform,10,1.8364528545823173e-05,10,2.2780963315814774e-05,0,0
15147,electric,10,1.8364528545823173e-05,10,2.2780963315814774e-05,0,0
15192,ms,10,1.8364528545823173e-05,10,2.2780963315814774e-05,0,0
16392,guatemala,10,1.8364528545823173e-05,10,2.2780963315814774e-05,0,0
16766,#magarally,10,1.8364528545823173e-05,10,2.2780963315814774e-05,0,0
16818,#jobsnotmobs,10,1.8364528545823173e-05,10,2.2780963315814774e-05,0,0
16876,apprehended,10,1.8364528545823173e-05,10,2.2780963315814774e-05,0,0
16915,barletta,10,1.8364528545823173e-05,10,2.2780963315814774e-05,0,0
17100,@tigerwoods,10,1.8364528545823173e-05,10,2.2780963315814774e-05,0,0
17276,bongino,10,1.8364528545823173e-05,10,2.2780963315814774e-05,0,0
18761,inquiry,10,1.8364528545823173e-05,10,2.2780963315814774e-05,0,0
18901,tate,10,1.8364528545823173e-05,10,2.2780963315814774e-05,0,0
19490,bahamas,10,1.8364528545823173e-05,10,2.2780963315814774e-05,0,0
89,holidays,9,1.6528075691240854e-05,3,6.8342889947444315e-06,6,5.6837019845592764e-05
138,lasting,9,1.6528075691240854e-05,5,1.1390481657907387e-05,4,3.789134656372851e-05
309,circumstances,9,1.6528075691240854e-05,6,1.3668577989488863e-05,3,2.8418509922796382e-05
393,active,9,1.6528075691240854e-05,5,1.1390481657907387e-05,4,3.789134656372851e-05
545,eligible,9,1.6528075691240854e-05,1,2.2780963315814773e-06,8,7.578269312745701e-05
604,cheaper,9,1.6528075691240854e-05,5,1.1390481657907387e-05,4,3.789134656372851e-05
659,lays,9,1.6528075691240854e-05,0,0,9,8.525552976838915e-05
724,streak,9,1.6528075691240854e-05,3,6.8342889947444315e-06,6,5.6837019845592764e-05
751,permanent,9,1.6528075691240854e-05,6,1.3668577989488863e-05,3,2.8418509922796382e-05
846,homeowners,9,1.6528075691240854e-05,1,2.2780963315814773e-06,8,7.578269312745701e-05
848,creates,9,1.6528075691240854e-05,6,1.3668577989488863e-05,3,2.8418509922796382e-05
1010,commander-in-chief,9,1.6528075691240854e-05,4,9.11238532632591e-06,5,4.736418320466063e-05
1115,nine,9,1.6528075691240854e-05,2,4.556192663162955e-06,7,6.63098564865249e-05
1134,salary,9,1.6528075691240854e-05,8,1.822477065265182e-05,1,9.472836640932127e-06
1218,64,9,1.6528075691240854e-05,5,1.1390481657907387e-05,4,3.789134656372851e-05
1244,sight,9,1.6528075691240854e-05,6,1.3668577989488863e-05,3,2.8418509922796382e-05
1255,clock,9,1.6528075691240854e-05,4,9.11238532632591e-06,5,4.736418320466063e-05
1292,differences,9,1.6528075691240854e-05,2,4.556192663162955e-06,7,6.63098564865249e-05
1296,regardless,9,1.6528075691240854e-05,7,1.5946674321070342e-05,2,1.8945673281864254e-05
1421,workplace,9,1.6528075691240854e-05,2,4.556192663162955e-06,7,6.63098564865249e-05
1442,nasa,9,1.6528075691240854e-05,5,1.1390481657907387e-05,4,3.789134656372851e-05
1471,retirement,9,1.6528075691240854e-05,4,9.11238532632591e-06,5,4.736418320466063e-05
1534,invested,9,1.6528075691240854e-05,4,9.11238532632591e-06,5,4.736418320466063e-05
1542,pentagon,9,1.6528075691240854e-05,7,1.5946674321070342e-05,2,1.8945673281864254e-05
1574,priorities,9,1.6528075691240854e-05,6,1.3668577989488863e-05,3,2.8418509922796382e-05
1624,bridges,9,1.6528075691240854e-05,5,1.1390481657907387e-05,4,3.789134656372851e-05
1709,#marchon,9,1.6528075691240854e-05,0,0,9,8.525552976838915e-05
1717,glorious,9,1.6528075691240854e-05,8,1.822477065265182e-05,1,9.472836640932127e-06
1737,patriotism,9,1.6528075691240854e-05,5,1.1390481657907387e-05,4,3.789134656372851e-05
1768,#netneutrality,9,1.6528075691240854e-05,0,0,9,8.525552976838915e-05
1814,#itsonus,9,1.6528075691240854e-05,0,0,9,8.525552976838915e-05
1841,focusing,9,1.6528075691240854e-05,6,1.3668577989488863e-05,3,2.8418509922796382e-05
1864,#americaleads,9,1.6528075691240854e-05,0,0,9,8.525552976838915e-05
1890,15000,9,1.6528075691240854e-05,6,1.3668577989488863e-05,3,2.8418509922796382e-05
2007,cuba,9,1.6528075691240854e-05,8,1.822477065265182e-05,1,9.472836640932127e-06
2029,childhood,9,1.6528075691240854e-05,0,0,9,8.525552976838915e-05
2033,dreamers,9,1.6528075691240854e-05,1,2.2780963315814773e-06,8,7.578269312745701e-05
2147,1010,9,1.6528075691240854e-05,0,0,9,8.525552976838915e-05
2174,measures,9,1.6528075691240854e-05,5,1.1390481657907387e-05,4,3.789134656372851e-05
2187,epa,9,1.6528075691240854e-05,8,1.822477065265182e-05,1,9.472836640932127e-06
2195,prize,9,1.6528075691240854e-05,7,1.5946674321070342e-05,2,1.8945673281864254e-05
2235,awareness,9,1.6528075691240854e-05,3,6.8342889947444315e-06,6,5.6837019845592764e-05
2260,wildfires,9,1.6528075691240854e-05,7,1.5946674321070342e-05,2,1.8945673281864254e-05
2290,founding,9,1.6528075691240854e-05,5,1.1390481657907387e-05,4,3.789134656372851e-05
2305,#neverforget,9,1.6528075691240854e-05,8,1.822477065265182e-05,1,9.472836640932127e-06
2353,backward,9,1.6528075691240854e-05,0,0,9,8.525552976838915e-05
2372,earning,9,1.6528075691240854e-05,0,0,9,8.525552976838915e-05
2431,@ustreasury,9,1.6528075691240854e-05,8,1.822477065265182e-05,1,9.472836640932127e-06
2448,wasteful,9,1.6528075691240854e-05,6,1.3668577989488863e-05,3,2.8418509922796382e-05
2452,impressed,9,1.6528075691240854e-05,8,1.822477065265182e-05,1,9.472836640932127e-06
2454,stayed,9,1.6528075691240854e-05,7,1.5946674321070342e-05,2,1.8945673281864254e-05
2466,whenever,9,1.6528075691240854e-05,6,1.3668577989488863e-05,3,2.8418509922796382e-05
2595,pursue,9,1.6528075691240854e-05,5,1.1390481657907387e-05,4,3.789134656372851e-05
2609,70th,9,1.6528075691240854e-05,8,1.822477065265182e-05,1,9.472836640932127e-06
2660,thrive,9,1.6528075691240854e-05,8,1.822477065265182e-05,1,9.472836640932127e-06
2696,abandon,9,1.6528075691240854e-05,6,1.3668577989488863e-05,3,2.8418509922796382e-05
2699,limit,9,1.6528075691240854e-05,2,4.556192663162955e-06,7,6.63098564865249e-05
2716,christians,9,1.6528075691240854e-05,6,1.3668577989488863e-05,3,2.8418509922796382e-05
2751,#fairfuturenow,9,1.6528075691240854e-05,0,0,9,8.525552976838915e-05
2781,movie,9,1.6528075691240854e-05,5,1.1390481657907387e-05,4,3.789134656372851e-05
2786,soldier,9,1.6528075691240854e-05,7,1.5946674321070342e-05,2,1.8945673281864254e-05
2788,71,9,1.6528075691240854e-05,5,1.1390481657907387e-05,4,3.789134656372851e-05
2792,autism,9,1.6528075691240854e-05,6,1.3668577989488863e-05,3,2.8418509922796382e-05
2835,#lastcall2014,9,1.6528075691240854e-05,0,0,9,8.525552976838915e-05
2843,hurts,9,1.6528075691240854e-05,7,1.5946674321070342e-05,2,1.8945673281864254e-05
2946,minority,9,1.6528075691240854e-05,6,1.3668577989488863e-05,3,2.8418509922796382e-05
2966,34,9,1.6528075691240854e-05,5,1.1390481657907387e-05,4,3.789134656372851e-05
3009,fulfill,9,1.6528075691240854e-05,5,1.1390481657907387e-05,4,3.789134656372851e-05
3144,#enda,9,1.6528075691240854e-05,0,0,9,8.525552976838915e-05
3188,0,9,1.6528075691240854e-05,6,1.3668577989488863e-05,3,2.8418509922796382e-05
3200,sharing,9,1.6528075691240854e-05,3,6.8342889947444315e-06,6,5.6837019845592764e-05
3212,shopping,9,1.6528075691240854e-05,3,6.8342889947444315e-06,6,5.6837019845592764e-05
3275,newtown,9,1.6528075691240854e-05,1,2.2780963315814773e-06,8,7.578269312745701e-05
3428,aware,9,1.6528075691240854e-05,8,1.822477065265182e-05,1,9.472836640932127e-06
3465,visited,9,1.6528075691240854e-05,6,1.3668577989488863e-05,3,2.8418509922796382e-05
3469,#shutdown,9,1.6528075691240854e-05,0,0,9,8.525552976838915e-05
3481,#endthisnow,9,1.6528075691240854e-05,0,0,9,8.525552976838915e-05
3584,score,9,1.6528075691240854e-05,5,1.1390481657907387e-05,4,3.789134656372851e-05
3601,36,9,1.6528075691240854e-05,5,1.1390481657907387e-05,4,3.789134656372851e-05
3672,#whatwillittake,9,1.6528075691240854e-05,0,0,9,8.525552976838915e-05
3686,#standwithourfuture,9,1.6528075691240854e-05,0,0,9,8.525552976838915e-05
3749,purchase,9,1.6528075691240854e-05,8,1.822477065265182e-05,1,9.472836640932127e-06
3797,disadvantage,9,1.6528075691240854e-05,8,1.822477065265182e-05,1,9.472836640932127e-06
3819,familys,9,1.6528075691240854e-05,1,2.2780963315814773e-06,8,7.578269312745701e-05
3845,thomas,9,1.6528075691240854e-05,7,1.5946674321070342e-05,2,1.8945673281864254e-05
3856,gina,9,1.6528075691240854e-05,8,1.822477065265182e-05,1,9.472836640932127e-06
3906,confront,9,1.6528075691240854e-05,8,1.822477065265182e-05,1,9.472836640932127e-06
3915,25000,9,1.6528075691240854e-05,8,1.822477065265182e-05,1,9.472836640932127e-06
3957,represents,9,1.6528075691240854e-05,7,1.5946674321070342e-05,2,1.8945673281864254e-05
3983,overwhelmingly,9,1.6528075691240854e-05,8,1.822477065265182e-05,1,9.472836640932127e-06
4243,mentally,9,1.6528075691240854e-05,8,1.822477065265182e-05,1,9.472836640932127e-06
4340,allegiance,9,1.6528075691240854e-05,8,1.822477065265182e-05,1,9.472836640932127e-06
4356,principle,9,1.6528075691240854e-05,5,1.1390481657907387e-05,4,3.789134656372851e-05
4470,33,9,1.6528075691240854e-05,7,1.5946674321070342e-05,2,1.8945673281864254e-05
4494,hashtag,9,1.6528075691240854e-05,1,2.2780963315814773e-06,8,7.578269312745701e-05
4497,fails,9,1.6528075691240854e-05,8,1.822477065265182e-05,1,9.472836640932127e-06
4518,hq,9,1.6528075691240854e-05,2,4.556192663162955e-06,7,6.63098564865249e-05
4573,borrow,9,1.6528075691240854e-05,6,1.3668577989488863e-05,3,2.8418509922796382e-05
4581,madison,9,1.6528075691240854e-05,6,1.3668577989488863e-05,3,2.8418509922796382e-05
4586,letters,9,1.6528075691240854e-05,5,1.1390481657907387e-05,4,3.789134656372851e-05
4610,vet,9,1.6528075691240854e-05,8,1.822477065265182e-05,1,9.472836640932127e-06
4630,3600,9,1.6528075691240854e-05,1,2.2780963315814773e-06,8,7.578269312745701e-05
4684,resistance,9,1.6528075691240854e-05,8,1.822477065265182e-05,1,9.472836640932127e-06
4737,toledo,9,1.6528075691240854e-05,4,9.11238532632591e-06,5,4.736418320466063e-05
4776,severely,9,1.6528075691240854e-05,4,9.11238532632591e-06,5,4.736418320466063e-05
4808,tampa,9,1.6528075691240854e-05,7,1.5946674321070342e-05,2,1.8945673281864254e-05
4815,winds,9,1.6528075691240854e-05,8,1.822477065265182e-05,1,9.472836640932127e-06
4897,commander,9,1.6528075691240854e-05,1,2.2780963315814773e-06,8,7.578269312745701e-05
4913,map,9,1.6528075691240854e-05,3,6.8342889947444315e-06,6,5.6837019845592764e-05
4934,attacked,9,1.6528075691240854e-05,8,1.822477065265182e-05,1,9.472836640932127e-06
4956,parenthood,9,1.6528075691240854e-05,2,4.556192663162955e-06,7,6.63098564865249e-05
4964,specific,9,1.6528075691240854e-05,5,1.1390481657907387e-05,4,3.789134656372851e-05
4993,model,9,1.6528075691240854e-05,7,1.5946674321070342e-05,2,1.8945673281864254e-05
5046,compare,9,1.6528075691240854e-05,6,1.3668577989488863e-05,3,2.8418509922796382e-05
5074,@joebiden,9,1.6528075691240854e-05,2,4.556192663162955e-06,7,6.63098564865249e-05
5101,convince,9,1.6528075691240854e-05,6,1.3668577989488863e-05,3,2.8418509922796382e-05
5113,disagree,9,1.6528075691240854e-05,7,1.5946674321070342e-05,2,1.8945673281864254e-05
5220,37,9,1.6528075691240854e-05,5,1.1390481657907387e-05,4,3.789134656372851e-05
5224,profit,9,1.6528075691240854e-05,5,1.1390481657907387e-05,4,3.789134656372851e-05
5223,expense,9,1.6528075691240854e-05,6,1.3668577989488863e-05,3,2.8418509922796382e-05
5230,writes,9,1.6528075691240854e-05,7,1.5946674321070342e-05,2,1.8945673281864254e-05
5354,#dnc2012,9,1.6528075691240854e-05,0,0,9,8.525552976838915e-05
5383,700000,9,1.6528075691240854e-05,8,1.822477065265182e-05,1,9.472836640932127e-06
5493,bonuses,9,1.6528075691240854e-05,7,1.5946674321070342e-05,2,1.8945673281864254e-05
5501,platform,9,1.6528075691240854e-05,8,1.822477065265182e-05,1,9.472836640932127e-06
5513,rnc,9,1.6528075691240854e-05,8,1.822477065265182e-05,1,9.472836640932127e-06
5571,strengthens,9,1.6528075691240854e-05,4,9.11238532632591e-06,5,4.736418320466063e-05
5704,developed,9,1.6528075691240854e-05,8,1.822477065265182e-05,1,9.472836640932127e-06
5750,sally,9,1.6528075691240854e-05,8,1.822477065265182e-05,1,9.472836640932127e-06
5894,maximum,9,1.6528075691240854e-05,8,1.822477065265182e-05,1,9.472836640932127e-06
5910,imposed,9,1.6528075691240854e-05,8,1.822477065265182e-05,1,9.472836640932127e-06
6014,block,9,1.6528075691240854e-05,5,1.1390481657907387e-05,4,3.789134656372851e-05
6017,barrett,9,1.6528075691240854e-05,8,1.822477065265182e-05,1,9.472836640932127e-06
6037,art,9,1.6528075691240854e-05,6,1.3668577989488863e-05,3,2.8418509922796382e-05
6047,size,9,1.6528075691240854e-05,8,1.822477065265182e-05,1,9.472836640932127e-06
6166,mo,9,1.6528075691240854e-05,8,1.822477065265182e-05,1,9.472836640932127e-06
6245,holocaust,9,1.6528075691240854e-05,8,1.822477065265182e-05,1,9.472836640932127e-06
6311,hopes,9,1.6528075691240854e-05,7,1.5946674321070342e-05,2,1.8945673281864254e-05
6508,outrageous,9,1.6528075691240854e-05,8,1.822477065265182e-05,1,9.472836640932127e-06
6548,university,9,1.6528075691240854e-05,6,1.3668577989488863e-05,3,2.8418509922796382e-05
6550,extension,9,1.6528075691240854e-05,7,1.5946674321070342e-05,2,1.8945673281864254e-05
6567,boeing,9,1.6528075691240854e-05,7,1.5946674321070342e-05,2,1.8945673281864254e-05
6568,neighborhood,9,1.6528075691240854e-05,7,1.5946674321070342e-05,2,1.8945673281864254e-05
6697,departments,9,1.6528075691240854e-05,8,1.822477065265182e-05,1,9.472836640932127e-06
6738,quotes,9,1.6528075691240854e-05,8,1.822477065265182e-05,1,9.472836640932127e-06
6799,william,9,1.6528075691240854e-05,8,1.822477065265182e-05,1,9.472836640932127e-06
6854,mouth,9,1.6528075691240854e-05,8,1.822477065265182e-05,1,9.472836640932127e-06
6867,centers,9,1.6528075691240854e-05,8,1.822477065265182e-05,1,9.472836640932127e-06
7014,10th,9,1.6528075691240854e-05,8,1.822477065265182e-05,1,9.472836640932127e-06
7020,impacted,9,1.6528075691240854e-05,8,1.822477065265182e-05,1,9.472836640932127e-06
7229,respects,9,1.6528075691240854e-05,8,1.822477065265182e-05,1,9.472836640932127e-06
7247,penalties,9,1.6528075691240854e-05,8,1.822477065265182e-05,1,9.472836640932127e-06
7439,committing,9,1.6528075691240854e-05,8,1.822477065265182e-05,1,9.472836640932127e-06
7479,producing,9,1.6528075691240854e-05,8,1.822477065265182e-05,1,9.472836640932127e-06
7497,burning,9,1.6528075691240854e-05,8,1.822477065265182e-05,1,9.472836640932127e-06
7514,ruin,9,1.6528075691240854e-05,8,1.822477065265182e-05,1,9.472836640932127e-06
7762,secretly,9,1.6528075691240854e-05,8,1.822477065265182e-05,1,9.472836640932127e-06
7789,harbor,9,1.6528075691240854e-05,8,1.822477065265182e-05,1,9.472836640932127e-06
7797,participate,9,1.6528075691240854e-05,7,1.5946674321070342e-05,2,1.8945673281864254e-05
7911,certify,9,1.6528075691240854e-05,9,2.0502866984233294e-05,0,0
7948,@kloeffler,9,1.6528075691240854e-05,9,2.0502866984233294e-05,0,0
7960,decree,9,1.6528075691240854e-05,9,2.0502866984233294e-05,0,0
7968,cheating,9,1.6528075691240854e-05,9,2.0502866984233294e-05,0,0
7998,fda,9,1.6528075691240854e-05,9,2.0502866984233294e-05,0,0
8049,activity,9,1.6528075691240854e-05,9,2.0502866984233294e-05,0,0
8086,irregularities,9,1.6528075691240854e-05,9,2.0502866984233294e-05,0,0
8132,perdue,9,1.6528075691240854e-05,9,2.0502866984233294e-05,0,0
8226,atlanta,9,1.6528075691240854e-05,9,2.0502866984233294e-05,0,0
8271,darrell,9,1.6528075691240854e-05,9,2.0502866984233294e-05,0,0
8344,fauci,9,1.6528075691240854e-05,9,2.0502866984233294e-05,0,0
8363,wsj,9,1.6528075691240854e-05,9,2.0502866984233294e-05,0,0
8420,guests,9,1.6528075691240854e-05,9,2.0502866984233294e-05,0,0
8432,anchor,9,1.6528075691240854e-05,9,2.0502866984233294e-05,0,0
8436,crushing,9,1.6528075691240854e-05,9,2.0502866984233294e-05,0,0
8482,counties,9,1.6528075691240854e-05,9,2.0502866984233294e-05,0,0
8541,detail,9,1.6528075691240854e-05,9,2.0502866984233294e-05,0,0
8582,tradition,9,1.6528075691240854e-05,9,2.0502866984233294e-05,0,0
8655,projected,9,1.6528075691240854e-05,9,2.0502866984233294e-05,0,0
8707,cheat,9,1.6528075691240854e-05,9,2.0502866984233294e-05,0,0
8741,@nygovcuomo,9,1.6528075691240854e-05,9,2.0502866984233294e-05,0,0
8754,tainted,9,1.6528075691240854e-05,9,2.0502866984233294e-05,0,0
8773,termination,9,1.6528075691240854e-05,9,2.0502866984233294e-05,0,0
8776,scum,9,1.6528075691240854e-05,9,2.0502866984233294e-05,0,0
8799,hardly,9,1.6528075691240854e-05,9,2.0502866984233294e-05,0,0
8906,@stevedaines,9,1.6528075691240854e-05,9,2.0502866984233294e-05,0,0
8926,@secazar,9,1.6528075691240854e-05,9,2.0502866984233294e-05,0,0
8937,assume,9,1.6528075691240854e-05,9,2.0502866984233294e-05,0,0
8963,atlantic,9,1.6528075691240854e-05,9,2.0502866984233294e-05,0,0
9012,socialists,9,1.6528075691240854e-05,9,2.0502866984233294e-05,0,0
9020,catastrophe,9,1.6528075691240854e-05,9,2.0502866984233294e-05,0,0
9102,@geoffduncanga,9,1.6528075691240854e-05,9,2.0502866984233294e-05,0,0
9104,notes,9,1.6528075691240854e-05,9,2.0502866984233294e-05,0,0
9145,normal,9,1.6528075691240854e-05,9,2.0502866984233294e-05,0,0
9147,elsewhere,9,1.6528075691240854e-05,9,2.0502866984233294e-05,0,0
9228,interfere,9,1.6528075691240854e-05,9,2.0502866984233294e-05,0,0
9252,dramatically,9,1.6528075691240854e-05,9,2.0502866984233294e-05,0,0
9377,proceed,9,1.6528075691240854e-05,9,2.0502866984233294e-05,0,0
9406,perpetrated,9,1.6528075691240854e-05,9,2.0502866984233294e-05,0,0
9407,besides,9,1.6528075691240854e-05,9,2.0502866984233294e-05,0,0
9520,regs,9,1.6528075691240854e-05,9,2.0502866984233294e-05,0,0
9634,accusations,9,1.6528075691240854e-05,9,2.0502866984233294e-05,0,0
9675,flags,9,1.6528075691240854e-05,9,2.0502866984233294e-05,0,0
9812,flowing,9,1.6528075691240854e-05,9,2.0502866984233294e-05,0,0
9836,developing,9,1.6528075691240854e-05,9,2.0502866984233294e-05,0,0
9892,rand,9,1.6528075691240854e-05,9,2.0502866984233294e-05,0,0
9908,#maga2020,9,1.6528075691240854e-05,9,2.0502866984233294e-05,0,0
10073,plot,9,1.6528075691240854e-05,9,2.0502866984233294e-05,0,0
10078,directions,9,1.6528075691240854e-05,9,2.0502866984233294e-05,0,0
10189,unnamed,9,1.6528075691240854e-05,9,2.0502866984233294e-05,0,0
10253,sued,9,1.6528075691240854e-05,9,2.0502866984233294e-05,0,0
10466,manner,9,1.6528075691240854e-05,9,2.0502866984233294e-05,0,0
10535,funeral,9,1.6528075691240854e-05,9,2.0502866984233294e-05,0,0
10625,replacing,9,1.6528075691240854e-05,9,2.0502866984233294e-05,0,0
10667,proving,9,1.6528075691240854e-05,9,2.0502866984233294e-05,0,0
10747,vacation,9,1.6528075691240854e-05,9,2.0502866984233294e-05,0,0
10805,@stevedoocy,9,1.6528075691240854e-05,9,2.0502866984233294e-05,0,0
10822,pilot,9,1.6528075691240854e-05,9,2.0502866984233294e-05,0,0
10853,activities,9,1.6528075691240854e-05,9,2.0502866984233294e-05,0,0
10870,facilities,9,1.6528075691240854e-05,9,2.0502866984233294e-05,0,0
10881,blakeman,9,1.6528075691240854e-05,9,2.0502866984233294e-05,0,0
11089,hater,9,1.6528075691240854e-05,9,2.0502866984233294e-05,0,0
11115,founders,9,1.6528075691240854e-05,9,2.0502866984233294e-05,0,0
11142,yearly,9,1.6528075691240854e-05,9,2.0502866984233294e-05,0,0
11234,hillarys,9,1.6528075691240854e-05,9,2.0502866984233294e-05,0,0
11406,begging,9,1.6528075691240854e-05,9,2.0502866984233294e-05,0,0
11418,hated,9,1.6528075691240854e-05,9,2.0502866984233294e-05,0,0
11440,corey,9,1.6528075691240854e-05,9,2.0502866984233294e-05,0,0
11466,@gavinnewsom,9,1.6528075691240854e-05,9,2.0502866984233294e-05,0,0
11478,exoneration,9,1.6528075691240854e-05,9,2.0502866984233294e-05,0,0
11571,zelensky,9,1.6528075691240854e-05,9,2.0502866984233294e-05,0,0
11645,@petestauber,9,1.6528075691240854e-05,9,2.0502866984233294e-05,0,0
11658,annapolis,9,1.6528075691240854e-05,9,2.0502866984233294e-05,0,0
11895,arrest,9,1.6528075691240854e-05,9,2.0502866984233294e-05,0,0
11942,@uscg,9,1.6528075691240854e-05,9,2.0502866984233294e-05,0,0
12061,syndrome,9,1.6528075691240854e-05,9,2.0502866984233294e-05,0,0
12115,australia,9,1.6528075691240854e-05,9,2.0502866984233294e-05,0,0
12118,soul,9,1.6528075691240854e-05,9,2.0502866984233294e-05,0,0
12119,admin,9,1.6528075691240854e-05,9,2.0502866984233294e-05,0,0
12204,pakistan,9,1.6528075691240854e-05,9,2.0502866984233294e-05,0,0
12272,filthy,9,1.6528075691240854e-05,9,2.0502866984233294e-05,0,0
12299,ralph,9,1.6528075691240854e-05,9,2.0502866984233294e-05,0,0
12368,behavior,9,1.6528075691240854e-05,9,2.0502866984233294e-05,0,0
12410,trick,9,1.6528075691240854e-05,9,2.0502866984233294e-05,0,0
12557,churches,9,1.6528075691240854e-05,9,2.0502866984233294e-05,0,0
12718,40000000,9,1.6528075691240854e-05,9,2.0502866984233294e-05,0,0
12722,acknowledge,9,1.6528075691240854e-05,9,2.0502866984233294e-05,0,0
12796,guts,9,1.6528075691240854e-05,9,2.0502866984233294e-05,0,0
12797,managed,9,1.6528075691240854e-05,9,2.0502866984233294e-05,0,0
12847,hanoi,9,1.6528075691240854e-05,9,2.0502866984233294e-05,0,0
12865,internal,9,1.6528075691240854e-05,9,2.0502866984233294e-05,0,0
13055,dept,9,1.6528075691240854e-05,9,2.0502866984233294e-05,0,0
13274,@,9,1.6528075691240854e-05,9,2.0502866984233294e-05,0,0
13360,backed,9,1.6528075691240854e-05,9,2.0502866984233294e-05,0,0
13479,और,9,1.6528075691240854e-05,9,2.0502866984233294e-05,0,0
13562,respectful,9,1.6528075691240854e-05,9,2.0502866984233294e-05,0,0
14442,trillions,9,1.6528075691240854e-05,9,2.0502866984233294e-05,0,0
14548,violations,9,1.6528075691240854e-05,9,2.0502866984233294e-05,0,0
14591,leakin,9,1.6528075691240854e-05,9,2.0502866984233294e-05,0,0
14649,omarosa,9,1.6528075691240854e-05,9,2.0502866984233294e-05,0,0
14719,acid,9,1.6528075691240854e-05,9,2.0502866984233294e-05,0,0
14773,jinping,9,1.6528075691240854e-05,9,2.0502866984233294e-05,0,0
15173,tanked,9,1.6528075691240854e-05,9,2.0502866984233294e-05,0,0
15259,otto,9,1.6528075691240854e-05,9,2.0502866984233294e-05,0,0
15287,starving,9,1.6528075691240854e-05,9,2.0502866984233294e-05,0,0
16602,jarrett,9,1.6528075691240854e-05,9,2.0502866984233294e-05,0,0
16624,broward,9,1.6528075691240854e-05,9,2.0502866984233294e-05,0,0
16666,opposing,9,1.6528075691240854e-05,9,2.0502866984233294e-05,0,0
16700,envy,9,1.6528075691240854e-05,9,2.0502866984233294e-05,0,0
16821,opinions,9,1.6528075691240854e-05,9,2.0502866984233294e-05,0,0
17059,7th,9,1.6528075691240854e-05,9,2.0502866984233294e-05,0,0
17558,94,9,1.6528075691240854e-05,9,2.0502866984233294e-05,0,0
18002,informant,9,1.6528075691240854e-05,9,2.0502866984233294e-05,0,0
18733,cartels,9,1.6528075691240854e-05,9,2.0502866984233294e-05,0,0
19187,@byronyork,9,1.6528075691240854e-05,9,2.0502866984233294e-05,0,0
19389,@kthopkins,9,1.6528075691240854e-05,9,2.0502866984233294e-05,0,0
136,cheer,8,1.4691622836658537e-05,2,4.556192663162955e-06,6,5.6837019845592764e-05
174,prosperous,8,1.4691622836658537e-05,7,1.5946674321070342e-05,1,9.472836640932127e-06
232,loophole,8,1.4691622836658537e-05,4,9.11238532632591e-06,4,3.789134656372851e-05
377,arlington,8,1.4691622836658537e-05,6,1.3668577989488863e-05,2,1.8945673281864254e-05
433,#keystonexl,8,1.4691622836658537e-05,0,0,8,7.578269312745701e-05
537,applaud,8,1.4691622836658537e-05,4,9.11238532632591e-06,4,3.789134656372851e-05
559,cleaner,8,1.4691622836658537e-05,1,2.2780963315814773e-06,7,6.63098564865249e-05
568,emissions,8,1.4691622836658537e-05,4,9.11238532632591e-06,4,3.789134656372851e-05
590,2007,8,1.4691622836658537e-05,0,0,8,7.578269312745701e-05
705,ht,8,1.4691622836658537e-05,0,0,8,7.578269312745701e-05
851,renewable,8,1.4691622836658537e-05,0,0,8,7.578269312745701e-05
917,fundamental,8,1.4691622836658537e-05,1,2.2780963315814773e-06,7,6.63098564865249e-05
965,carefully,8,1.4691622836658537e-05,7,1.5946674321070342e-05,1,9.472836640932127e-06
1011,@ofas,8,1.4691622836658537e-05,0,0,8,7.578269312745701e-05
1016,cap,8,1.4691622836658537e-05,3,6.8342889947444315e-06,5,4.736418320466063e-05
1051,highlights,8,1.4691622836658537e-05,0,0,8,7.578269312745701e-05
1091,treating,8,1.4691622836658537e-05,5,1.1390481657907387e-05,3,2.8418509922796382e-05
1112,african-american,8,1.4691622836658537e-05,6,1.3668577989488863e-05,2,1.8945673281864254e-05
1123,detained,8,1.4691622836658537e-05,7,1.5946674321070342e-05,1,9.472836640932127e-06
1140,fit,8,1.4691622836658537e-05,7,1.5946674321070342e-05,1,9.472836640932127e-06
1142,locked,8,1.4691622836658537e-05,7,1.5946674321070342e-05,1,9.472836640932127e-06
1237,educate,8,1.4691622836658537e-05,0,0,8,7.578269312745701e-05
1264,houses,8,1.4691622836658537e-05,2,4.556192663162955e-06,6,5.6837019845592764e-05
1295,equally,8,1.4691622836658537e-05,4,9.11238532632591e-06,4,3.789134656372851e-05
1301,historical,8,1.4691622836658537e-05,7,1.5946674321070342e-05,1,9.472836640932127e-06
1321,attacking,8,1.4691622836658537e-05,6,1.3668577989488863e-05,2,1.8945673281864254e-05
1406,dave,8,1.4691622836658537e-05,6,1.3668577989488863e-05,2,1.8945673281864254e-05
1473,ignored,8,1.4691622836658537e-05,6,1.3668577989488863e-05,2,1.8945673281864254e-05
1475,everyones,8,1.4691622836658537e-05,3,6.8342889947444315e-06,5,4.736418320466063e-05
1480,ability,8,1.4691622836658537e-05,5,1.1390481657907387e-05,3,2.8418509922796382e-05
1555,seize,8,1.4691622836658537e-05,2,4.556192663162955e-06,6,5.6837019845592764e-05
1620,brothers,8,1.4691622836658537e-05,3,6.8342889947444315e-06,5,4.736418320466063e-05
1644,automatically,8,1.4691622836658537e-05,3,6.8342889947444315e-06,5,4.736418320466063e-05
1650,fifth,8,1.4691622836658537e-05,6,1.3668577989488863e-05,2,1.8945673281864254e-05
1678,saint,8,1.4691622836658537e-05,7,1.5946674321070342e-05,1,9.472836640932127e-06
1677,patricks,8,1.4691622836658537e-05,2,4.556192663162955e-06,6,5.6837019845592764e-05
1714,walked,8,1.4691622836658537e-05,5,1.1390481657907387e-05,3,2.8418509922796382e-05
1821,sake,8,1.4691622836658537e-05,5,1.1390481657907387e-05,3,2.8418509922796382e-05
1823,rewarded,8,1.4691622836658537e-05,4,9.11238532632591e-06,4,3.789134656372851e-05
1874,gay,8,1.4691622836658537e-05,0,0,8,7.578269312745701e-05
2024,blessings,8,1.4691622836658537e-05,6,1.3668577989488863e-05,2,1.8945673281864254e-05
2036,net,8,1.4691622836658537e-05,5,1.1390481657907387e-05,3,2.8418509922796382e-05
2190,achievements,8,1.4691622836658537e-05,7,1.5946674321070342e-05,1,9.472836640932127e-06
2256,offering,8,1.4691622836658537e-05,5,1.1390481657907387e-05,3,2.8418509922796382e-05
2265,title,8,1.4691622836658537e-05,3,6.8342889947444315e-06,5,4.736418320466063e-05
2310,tall,8,1.4691622836658537e-05,6,1.3668577989488863e-05,2,1.8945673281864254e-05
2401,smile,8,1.4691622836658537e-05,1,2.2780963315814773e-06,7,6.63098564865249e-05
2430,delayed,8,1.4691622836658537e-05,7,1.5946674321070342e-05,1,9.472836640932127e-06
2486,measure,8,1.4691622836658537e-05,3,6.8342889947444315e-06,5,4.736418320466063e-05
2488,austin,8,1.4691622836658537e-05,6,1.3668577989488863e-05,2,1.8945673281864254e-05
2550,youd,8,1.4691622836658537e-05,3,6.8342889947444315e-06,5,4.736418320466063e-05
2617,slowest,8,1.4691622836658537e-05,4,9.11238532632591e-06,4,3.789134656372851e-05
2648,#whatrepealmeans,8,1.4691622836658537e-05,0,0,8,7.578269312745701e-05
2688,ii,8,1.4691622836658537e-05,7,1.5946674321070342e-05,1,9.472836640932127e-06
2794,#7millionandcounting,8,1.4691622836658537e-05,0,0,8,7.578269312745701e-05
2803,literally,8,1.4691622836658537e-05,3,6.8342889947444315e-06,5,4.736418320466063e-05
2812,tactics,8,1.4691622836658537e-05,6,1.3668577989488863e-05,2,1.8945673281864254e-05
2839,tight,8,1.4691622836658537e-05,6,1.3668577989488863e-05,2,1.8945673281864254e-05
2845,colleges,8,1.4691622836658537e-05,2,4.556192663162955e-06,6,5.6837019845592764e-05
2866,grab,8,1.4691622836658537e-05,4,9.11238532632591e-06,4,3.789134656372851e-05
2883,floor,8,1.4691622836658537e-05,3,6.8342889947444315e-06,5,4.736418320466063e-05
2907,cute,8,1.4691622836658537e-05,7,1.5946674321070342e-05,1,9.472836640932127e-06
2940,rural,8,1.4691622836658537e-05,6,1.3668577989488863e-05,2,1.8945673281864254e-05
2947,suffer,8,1.4691622836658537e-05,6,1.3668577989488863e-05,2,1.8945673281864254e-05
3020,#ff,8,1.4691622836658537e-05,0,0,8,7.578269312745701e-05
3030,theirs,8,1.4691622836658537e-05,2,4.556192663162955e-06,6,5.6837019845592764e-05
3040,golden,8,1.4691622836658537e-05,5,1.1390481657907387e-05,3,2.8418509922796382e-05
3058,seekers,8,1.4691622836658537e-05,0,0,8,7.578269312745701e-05
3097,cory,8,1.4691622836658537e-05,7,1.5946674321070342e-05,1,9.472836640932127e-06
3110,entrepreneurs,8,1.4691622836658537e-05,1,2.2780963315814773e-06,7,6.63098564865249e-05
3120,preparing,8,1.4691622836658537e-05,5,1.1390481657907387e-05,3,2.8418509922796382e-05
3130,humanity,8,1.4691622836658537e-05,5,1.1390481657907387e-05,3,2.8418509922796382e-05
3298,tree,8,1.4691622836658537e-05,5,1.1390481657907387e-05,3,2.8418509922796382e-05
3335,confident,8,1.4691622836658537e-05,4,9.11238532632591e-06,4,3.789134656372851e-05
3426,fiscal,8,1.4691622836658537e-05,3,6.8342889947444315e-06,5,4.736418320466063e-05
3434,@obamacare,8,1.4691622836658537e-05,0,0,8,7.578269312745701e-05
3463,required,8,1.4691622836658537e-05,6,1.3668577989488863e-05,2,1.8945673281864254e-05
3520,extremists,8,1.4691622836658537e-05,3,6.8342889947444315e-06,5,4.736418320466063e-05
3589,efficiency,8,1.4691622836658537e-05,1,2.2780963315814773e-06,7,6.63098564865249e-05
3614,29,8,1.4691622836658537e-05,4,9.11238532632591e-06,4,3.789134656372851e-05
3664,imperative,8,1.4691622836658537e-05,4,9.11238532632591e-06,4,3.789134656372851e-05
3738,lay,8,1.4691622836658537e-05,3,6.8342889947444315e-06,5,4.736418320466063e-05
3777,recess,8,1.4691622836658537e-05,1,2.2780963315814773e-06,7,6.63098564865249e-05
3798,essential,8,1.4691622836658537e-05,6,1.3668577989488863e-05,2,1.8945673281864254e-05
3878,dependence,8,1.4691622836658537e-05,0,0,8,7.578269312745701e-05
3903,firefighter,8,1.4691622836658537e-05,5,1.1390481657907387e-05,3,2.8418509922796382e-05
3910,epic,8,1.4691622836658537e-05,6,1.3668577989488863e-05,2,1.8945673281864254e-05
4043,tornadoes,8,1.4691622836658537e-05,7,1.5946674321070342e-05,1,9.472836640932127e-06
4146,hey,8,1.4691622836658537e-05,1,2.2780963315814773e-06,7,6.63098564865249e-05
4144,---,8,1.4691622836658537e-05,4,9.11238532632591e-06,4,3.789134656372851e-05
4208,impose,8,1.4691622836658537e-05,7,1.5946674321070342e-05,1,9.472836640932127e-06
4225,chose,8,1.4691622836658537e-05,4,9.11238532632591e-06,4,3.789134656372851e-05
4261,74,8,1.4691622836658537e-05,3,6.8342889947444315e-06,5,4.736418320466063e-05
4290,chapter,8,1.4691622836658537e-05,4,9.11238532632591e-06,4,3.789134656372851e-05
4341,blood,8,1.4691622836658537e-05,7,1.5946674321070342e-05,1,9.472836640932127e-06
4379,parade,8,1.4691622836658537e-05,7,1.5946674321070342e-05,1,9.472836640932127e-06
4404,row,8,1.4691622836658537e-05,4,9.11238532632591e-06,4,3.789134656372851e-05
4430,immediate,8,1.4691622836658537e-05,7,1.5946674321070342e-05,1,9.472836640932127e-06
4469,hanukkah,8,1.4691622836658537e-05,4,9.11238532632591e-06,4,3.789134656372851e-05
4528,9pm,8,1.4691622836658537e-05,1,2.2780963315814773e-06,7,6.63098564865249e-05
4554,fl,8,1.4691622836658537e-05,5,1.1390481657907387e-05,3,2.8418509922796382e-05
4590,practices,8,1.4691622836658537e-05,5,1.1390481657907387e-05,3,2.8418509922796382e-05
4595,partys,8,1.4691622836658537e-05,6,1.3668577989488863e-05,2,1.8945673281864254e-05
4644,definitely,8,1.4691622836658537e-05,7,1.5946674321070342e-05,1,9.472836640932127e-06
4655,misleading,8,1.4691622836658537e-05,6,1.3668577989488863e-05,2,1.8945673281864254e-05
4676,booth,8,1.4691622836658537e-05,5,1.1390481657907387e-05,3,2.8418509922796382e-05
4706,wi,8,1.4691622836658537e-05,4,9.11238532632591e-06,4,3.789134656372851e-05
4718,cross,8,1.4691622836658537e-05,6,1.3668577989488863e-05,2,1.8945673281864254e-05
4720,91,8,1.4691622836658537e-05,7,1.5946674321070342e-05,1,9.472836640932127e-06
4746,bunch,8,1.4691622836658537e-05,5,1.1390481657907387e-05,3,2.8418509922796382e-05
4748,ma,8,1.4691622836658537e-05,1,2.2780963315814773e-06,7,6.63098564865249e-05
4754,co,8,1.4691622836658537e-05,2,4.556192663162955e-06,6,5.6837019845592764e-05
4761,#americaforward,8,1.4691622836658537e-05,0,0,8,7.578269312745701e-05
4800,capable,8,1.4691622836658537e-05,5,1.1390481657907387e-05,3,2.8418509922796382e-05
4809,breakfast,8,1.4691622836658537e-05,6,1.3668577989488863e-05,2,1.8945673281864254e-05
4829,intended,8,1.4691622836658537e-05,6,1.3668577989488863e-05,2,1.8945673281864254e-05
4850,billionaires,8,1.4691622836658537e-05,0,0,8,7.578269312745701e-05
4861,adds,8,1.4691622836658537e-05,5,1.1390481657907387e-05,3,2.8418509922796382e-05
4928,facing,8,1.4691622836658537e-05,5,1.1390481657907387e-05,3,2.8418509922796382e-05
4974,solid,8,1.4691622836658537e-05,7,1.5946674321070342e-05,1,9.472836640932127e-06
5024,oppose,8,1.4691622836658537e-05,7,1.5946674321070342e-05,1,9.472836640932127e-06
5080,dedicated,8,1.4691622836658537e-05,6,1.3668577989488863e-05,2,1.8945673281864254e-05
5176,worried,8,1.4691622836658537e-05,7,1.5946674321070342e-05,1,9.472836640932127e-06
5206,donate,8,1.4691622836658537e-05,5,1.1390481657907387e-05,3,2.8418509922796382e-05
5252,theory,8,1.4691622836658537e-05,5,1.1390481657907387e-05,3,2.8418509922796382e-05
5262,acceptance,8,1.4691622836658537e-05,3,6.8342889947444315e-06,5,4.736418320466063e-05
5269,dismissed,8,1.4691622836658537e-05,7,1.5946674321070342e-05,1,9.472836640932127e-06
5280,43,8,1.4691622836658537e-05,7,1.5946674321070342e-05,1,9.472836640932127e-06
5287,revealing,8,1.4691622836658537e-05,7,1.5946674321070342e-05,1,9.472836640932127e-06
5421,accepted,8,1.4691622836658537e-05,7,1.5946674321070342e-05,1,9.472836640932127e-06
5446,charlotte,8,1.4691622836658537e-05,6,1.3668577989488863e-05,2,1.8945673281864254e-05
5523,organize,8,1.4691622836658537e-05,0,0,8,7.578269312745701e-05
5591,reasonable,8,1.4691622836658537e-05,7,1.5946674321070342e-05,1,9.472836640932127e-06
5683,sends,8,1.4691622836658537e-05,7,1.5946674321070342e-05,1,9.472836640932127e-06
5719,marching,8,1.4691622836658537e-05,7,1.5946674321070342e-05,1,9.472836640932127e-06
5725,beneficiaries,8,1.4691622836658537e-05,6,1.3668577989488863e-05,2,1.8945673281864254e-05
5727,employee,8,1.4691622836658537e-05,7,1.5946674321070342e-05,1,9.472836640932127e-06
5749,ride,8,1.4691622836658537e-05,6,1.3668577989488863e-05,2,1.8945673281864254e-05
5758,skill,8,1.4691622836658537e-05,7,1.5946674321070342e-05,1,9.472836640932127e-06
5777,honesty,8,1.4691622836658537e-05,7,1.5946674321070342e-05,1,9.472836640932127e-06
5790,incoming,8,1.4691622836658537e-05,7,1.5946674321070342e-05,1,9.472836640932127e-06
5812,listed,8,1.4691622836658537e-05,7,1.5946674321070342e-05,1,9.472836640932127e-06
5858,accounts,8,1.4691622836658537e-05,7,1.5946674321070342e-05,1,9.472836640932127e-06
5923,organizing,8,1.4691622836658537e-05,1,2.2780963315814773e-06,7,6.63098564865249e-05
6018,passes,8,1.4691622836658537e-05,2,4.556192663162955e-06,6,5.6837019845592764e-05
6086,1994,8,1.4691622836658537e-05,7,1.5946674321070342e-05,1,9.472836640932127e-06
6217,honorable,8,1.4691622836658537e-05,6,1.3668577989488863e-05,2,1.8945673281864254e-05
6222,fly,8,1.4691622836658537e-05,7,1.5946674321070342e-05,1,9.472836640932127e-06
6235,jimmy,8,1.4691622836658537e-05,6,1.3668577989488863e-05,2,1.8945673281864254e-05
6465,davis,8,1.4691622836658537e-05,7,1.5946674321070342e-05,1,9.472836640932127e-06
6531,jennifer,8,1.4691622836658537e-05,6,1.3668577989488863e-05,2,1.8945673281864254e-05
6572,facility,8,1.4691622836658537e-05,7,1.5946674321070342e-05,1,9.472836640932127e-06
6626,guidelines,8,1.4691622836658537e-05,7,1.5946674321070342e-05,1,9.472836640932127e-06
6664,stable,8,1.4691622836658537e-05,6,1.3668577989488863e-05,2,1.8945673281864254e-05
6685,inspiring,8,1.4691622836658537e-05,5,1.1390481657907387e-05,3,2.8418509922796382e-05
6726,mining,8,1.4691622836658537e-05,6,1.3668577989488863e-05,2,1.8945673281864254e-05
6730,phrase,8,1.4691622836658537e-05,7,1.5946674321070342e-05,1,9.472836640932127e-06
6872,sums,8,1.4691622836658537e-05,7,1.5946674321070342e-05,1,9.472836640932127e-06
6901,removal,8,1.4691622836658537e-05,7,1.5946674321070342e-05,1,9.472836640932127e-06
6963,assembly,8,1.4691622836658537e-05,7,1.5946674321070342e-05,1,9.472836640932127e-06
6967,awarded,8,1.4691622836658537e-05,7,1.5946674321070342e-05,1,9.472836640932127e-06
7035,bowl,8,1.4691622836658537e-05,7,1.5946674321070342e-05,1,9.472836640932127e-06
7055,civilian,8,1.4691622836658537e-05,6,1.3668577989488863e-05,2,1.8945673281864254e-05
7275,plate,8,1.4691622836658537e-05,7,1.5946674321070342e-05,1,9.472836640932127e-06
7305,driven,8,1.4691622836658537e-05,7,1.5946674321070342e-05,1,9.472836640932127e-06
7349,ceos,8,1.4691622836658537e-05,7,1.5946674321070342e-05,1,9.472836640932127e-06
7350,buildings,8,1.4691622836658537e-05,7,1.5946674321070342e-05,1,9.472836640932127e-06
7356,dare,8,1.4691622836658537e-05,7,1.5946674321070342e-05,1,9.472836640932127e-06
7448,@donnabrazile,8,1.4691622836658537e-05,7,1.5946674321070342e-05,1,9.472836640932127e-06
7517,customers,8,1.4691622836658537e-05,7,1.5946674321070342e-05,1,9.472836640932127e-06
7540,advertising,8,1.4691622836658537e-05,7,1.5946674321070342e-05,1,9.472836640932127e-06
7594,avenue,8,1.4691622836658537e-05,7,1.5946674321070342e-05,1,9.472836640932127e-06
7603,obligations,8,1.4691622836658537e-05,7,1.5946674321070342e-05,1,9.472836640932127e-06
7731,nightmare,8,1.4691622836658537e-05,7,1.5946674321070342e-05,1,9.472836640932127e-06
7787,meltdown,8,1.4691622836658537e-05,7,1.5946674321070342e-05,1,9.472836640932127e-06
7800,economist,8,1.4691622836658537e-05,7,1.5946674321070342e-05,1,9.472836640932127e-06
7878,100th,8,1.4691622836658537e-05,7,1.5946674321070342e-05,1,9.472836640932127e-06
7934,@usfda,8,1.4691622836658537e-05,8,1.822477065265182e-05,0,0
7981,boxes,8,1.4691622836658537e-05,8,1.822477065265182e-05,0,0
7995,stole,8,1.4691622836658537e-05,8,1.822477065265182e-05,0,0
8000,pfizer,8,1.4691622836658537e-05,8,1.822477065265182e-05,0,0
8009,85,8,1.4691622836658537e-05,8,1.822477065265182e-05,0,0
8022,@secretservice,8,1.4691622836658537e-05,8,1.822477065265182e-05,0,0
8037,travesty,8,1.4691622836658537e-05,8,1.822477065265182e-05,0,0
8056,lockdowns,8,1.4691622836658537e-05,8,1.822477065265182e-05,0,0
8092,computer,8,1.4691622836658537e-05,8,1.822477065265182e-05,0,0
8105,redo,8,1.4691622836658537e-05,8,1.822477065265182e-05,0,0
8106,uses,8,1.4691622836658537e-05,8,1.822477065265182e-05,0,0
8111,giuliani,8,1.4691622836658537e-05,8,1.822477065265182e-05,0,0
8146,sailors,8,1.4691622836658537e-05,8,1.822477065265182e-05,0,0
8165,parnell,8,1.4691622836658537e-05,8,1.822477065265182e-05,0,0
8206,surprisingly,8,1.4691622836658537e-05,8,1.822477065265182e-05,0,0
8211,miners,8,1.4691622836658537e-05,8,1.822477065265182e-05,0,0
8268,700pm,8,1.4691622836658537e-05,8,1.822477065265182e-05,0,0
8299,g-20,8,1.4691622836658537e-05,8,1.822477065265182e-05,0,0
8318,therapeutics,8,1.4691622836658537e-05,8,1.822477065265182e-05,0,0
8319,appeals,8,1.4691622836658537e-05,8,1.822477065265182e-05,0,0
8345,masks,8,1.4691622836658537e-05,8,1.822477065265182e-05,0,0
8430,liz,8,1.4691622836658537e-05,8,1.822477065265182e-05,0,0
8471,cheated,8,1.4691622836658537e-05,8,1.822477065265182e-05,0,0
8510,@cnbc,8,1.4691622836658537e-05,8,1.822477065265182e-05,0,0
8514,handlers,8,1.4691622836658537e-05,8,1.822477065265182e-05,0,0
8516,conduct,8,1.4691622836658537e-05,8,1.822477065265182e-05,0,0
8528,abused,8,1.4691622836658537e-05,8,1.822477065265182e-05,0,0
8533,drudge,8,1.4691622836658537e-05,8,1.822477065265182e-05,0,0
8549,systems,8,1.4691622836658537e-05,8,1.822477065265182e-05,0,0
8611,jesse,8,1.4691622836658537e-05,8,1.822477065265182e-05,0,0
8648,ndaa,8,1.4691622836658537e-05,8,1.822477065265182e-05,0,0
8693,practically,8,1.4691622836658537e-05,8,1.822477065265182e-05,0,0
8724,@cspan,8,1.4691622836658537e-05,8,1.822477065265182e-05,0,0
8733,attention,8,1.4691622836658537e-05,8,1.822477065265182e-05,0,0
8748,amy,8,1.4691622836658537e-05,8,1.822477065265182e-05,0,0
8752,carried,8,1.4691622836658537e-05,8,1.822477065265182e-05,0,0
8757,radicals,8,1.4691622836658537e-05,8,1.822477065265182e-05,0,0
8756,far-left,8,1.4691622836658537e-05,8,1.822477065265182e-05,0,0
8825,hired,8,1.4691622836658537e-05,8,1.822477065265182e-05,0,0
8874,left-wing,8,1.4691622836658537e-05,8,1.822477065265182e-05,0,0
8885,pleasure,8,1.4691622836658537e-05,8,1.822477065265182e-05,0,0
8890,taylor,8,1.4691622836658537e-05,8,1.822477065265182e-05,0,0
8889,conjunction,8,1.4691622836658537e-05,8,1.822477065265182e-05,0,0
8922,filed,8,1.4691622836658537e-05,8,1.822477065265182e-05,0,0
8972,donna,8,1.4691622836658537e-05,8,1.822477065265182e-05,0,0
8992,complaint,8,1.4691622836658537e-05,8,1.822477065265182e-05,0,0
9022,gross,8,1.4691622836658537e-05,8,1.822477065265182e-05,0,0
9029,refugees,8,1.4691622836658537e-05,8,1.822477065265182e-05,0,0
9063,riots,8,1.4691622836658537e-05,8,1.822477065265182e-05,0,0
9072,sports,8,1.4691622836658537e-05,8,1.822477065265182e-05,0,0
9137,shipped,8,1.4691622836658537e-05,8,1.822477065265182e-05,0,0
9188,tapes,8,1.4691622836658537e-05,8,1.822477065265182e-05,0,0
9193,satisfied,8,1.4691622836658537e-05,8,1.822477065265182e-05,0,0
9353,consideration,8,1.4691622836658537e-05,8,1.822477065265182e-05,0,0
9358,approvals,8,1.4691622836658537e-05,8,1.822477065265182e-05,0,0
9395,killers,8,1.4691622836658537e-05,8,1.822477065265182e-05,0,0
9440,frank,8,1.4691622836658537e-05,8,1.822477065265182e-05,0,0
9470,noble,8,1.4691622836658537e-05,8,1.822477065265182e-05,0,0
9518,shots,8,1.4691622836658537e-05,8,1.822477065265182e-05,0,0
9570,producer,8,1.4691622836658537e-05,8,1.822477065265182e-05,0,0
9572,hypocrites,8,1.4691622836658537e-05,8,1.822477065265182e-05,0,0
9594,700pme,8,1.4691622836658537e-05,8,1.822477065265182e-05,0,0
9639,nursing,8,1.4691622836658537e-05,8,1.822477065265182e-05,0,0
9645,unions,8,1.4691622836658537e-05,8,1.822477065265182e-05,0,0
9747,screaming,8,1.4691622836658537e-05,8,1.822477065265182e-05,0,0
9787,goodbye,8,1.4691622836658537e-05,8,1.822477065265182e-05,0,0
9813,frankly,8,1.4691622836658537e-05,8,1.822477065265182e-05,0,0
9886,@jimjordan,8,1.4691622836658537e-05,8,1.822477065265182e-05,0,0
10029,restaurants,8,1.4691622836658537e-05,8,1.822477065265182e-05,0,0
10061,kamala,8,1.4691622836658537e-05,8,1.822477065265182e-05,0,0
10094,@senategop,8,1.4691622836658537e-05,8,1.822477065265182e-05,0,0
10117,yates,8,1.4691622836658537e-05,8,1.822477065265182e-05,0,0
10122,است,8,1.4691622836658537e-05,8,1.822477065265182e-05,0,0
10171,attending,8,1.4691622836658537e-05,8,1.822477065265182e-05,0,0
10256,pulled,8,1.4691622836658537e-05,8,1.822477065265182e-05,0,0
10269,manchin,8,1.4691622836658537e-05,8,1.822477065265182e-05,0,0
10284,trained,8,1.4691622836658537e-05,8,1.822477065265182e-05,0,0
10295,bases,8,1.4691622836658537e-05,8,1.822477065265182e-05,0,0
10409,findings,8,1.4691622836658537e-05,8,1.822477065265182e-05,0,0
10468,bosses,8,1.4691622836658537e-05,8,1.822477065265182e-05,0,0
10501,complaints,8,1.4691622836658537e-05,8,1.822477065265182e-05,0,0
10504,expectations,8,1.4691622836658537e-05,8,1.822477065265182e-05,0,0
10526,conferences,8,1.4691622836658537e-05,8,1.822477065265182e-05,0,0
10528,type,8,1.4691622836658537e-05,8,1.822477065265182e-05,0,0
10548,sites,8,1.4691622836658537e-05,8,1.822477065265182e-05,0,0
10604,cuban,8,1.4691622836658537e-05,8,1.822477065265182e-05,0,0
10629,re-elected,8,1.4691622836658537e-05,8,1.822477065265182e-05,0,0
10656,jerome,8,1.4691622836658537e-05,8,1.822477065265182e-05,0,0
10703,highway,8,1.4691622836658537e-05,8,1.822477065265182e-05,0,0
10762,praying,8,1.4691622836658537e-05,8,1.822477065265182e-05,0,0
10835,admitting,8,1.4691622836658537e-05,8,1.822477065265182e-05,0,0
10867,goodwin,8,1.4691622836658537e-05,8,1.822477065265182e-05,0,0
10918,dean,8,1.4691622836658537e-05,8,1.822477065265182e-05,0,0
11026,@devinnunes,8,1.4691622836658537e-05,8,1.822477065265182e-05,0,0
11049,horribly,8,1.4691622836658537e-05,8,1.822477065265182e-05,0,0
11064,magazine,8,1.4691622836658537e-05,8,1.822477065265182e-05,0,0
11114,whatsoever,8,1.4691622836658537e-05,8,1.822477065265182e-05,0,0
11119,@stevescalise,8,1.4691622836658537e-05,8,1.822477065265182e-05,0,0
11139,sgt,8,1.4691622836658537e-05,8,1.822477065265182e-05,0,0
11152,l,8,1.4691622836658537e-05,8,1.822477065265182e-05,0,0
11240,animal,8,1.4691622836658537e-05,8,1.822477065265182e-05,0,0
11318,vladimir,8,1.4691622836658537e-05,8,1.822477065265182e-05,0,0
11333,distinguished,8,1.4691622836658537e-05,8,1.822477065265182e-05,0,0
11532,accord,8,1.4691622836658537e-05,8,1.822477065265182e-05,0,0
11575,loses,8,1.4691622836658537e-05,8,1.822477065265182e-05,0,0
11589,sham,8,1.4691622836658537e-05,8,1.822477065265182e-05,0,0
11600,currencies,8,1.4691622836658537e-05,8,1.822477065265182e-05,0,0
11656,club,8,1.4691622836658537e-05,8,1.822477065265182e-05,0,0
11692,aircraft,8,1.4691622836658537e-05,8,1.822477065265182e-05,0,0
11859,tied,8,1.4691622836658537e-05,8,1.822477065265182e-05,0,0
11866,@justintrudeau,8,1.4691622836658537e-05,8,1.822477065265182e-05,0,0
11916,division,8,1.4691622836658537e-05,8,1.822477065265182e-05,0,0
11929,eventually,8,1.4691622836658537e-05,8,1.822477065265182e-05,0,0
11971,relationships,8,1.4691622836658537e-05,8,1.822477065265182e-05,0,0
12086,entering,8,1.4691622836658537e-05,8,1.822477065265182e-05,0,0
12090,prosecuted,8,1.4691622836658537e-05,8,1.822477065265182e-05,0,0
12161,@narendramodi,8,1.4691622836658537e-05,8,1.822477065265182e-05,0,0
12175,self,8,1.4691622836658537e-05,8,1.822477065265182e-05,0,0
12399,solidarity,8,1.4691622836658537e-05,8,1.822477065265182e-05,0,0
12401,despicable,8,1.4691622836658537e-05,8,1.822477065265182e-05,0,0
12494,deception,8,1.4691622836658537e-05,8,1.822477065265182e-05,0,0
12496,heartfelt,8,1.4691622836658537e-05,8,1.822477065265182e-05,0,0
12533,disrespecting,8,1.4691622836658537e-05,8,1.822477065265182e-05,0,0
12535,napolitano,8,1.4691622836658537e-05,8,1.822477065265182e-05,0,0
12536,existence,8,1.4691622836658537e-05,8,1.822477065265182e-05,0,0
12677,@robertjeffress,8,1.4691622836658537e-05,8,1.822477065265182e-05,0,0
12730,@repmarkmeadows,8,1.4691622836658537e-05,8,1.822477065265182e-05,0,0
12774,scream,8,1.4691622836658537e-05,8,1.822477065265182e-05,0,0
12827,sinister,8,1.4691622836658537e-05,8,1.822477065265182e-05,0,0
12850,arrests,8,1.4691622836658537e-05,8,1.822477065265182e-05,0,0
12912,intent,8,1.4691622836658537e-05,8,1.822477065265182e-05,0,0
13039,californias,8,1.4691622836658537e-05,8,1.822477065265182e-05,0,0
13089,kimberly,8,1.4691622836658537e-05,8,1.822477065265182e-05,0,0
13124,sloppy,8,1.4691622836658537e-05,8,1.822477065265182e-05,0,0
13294,buys,8,1.4691622836658537e-05,8,1.822477065265182e-05,0,0
13304,angela,8,1.4691622836658537e-05,8,1.822477065265182e-05,0,0
13742,@nextrevfnc,8,1.4691622836658537e-05,8,1.822477065265182e-05,0,0
13755,resignation,8,1.4691622836658537e-05,8,1.822477065265182e-05,0,0
13768,untrue,8,1.4691622836658537e-05,8,1.822477065265182e-05,0,0
13829,roundtable,8,1.4691622836658537e-05,8,1.822477065265182e-05,0,0
14082,comparison,8,1.4691622836658537e-05,8,1.822477065265182e-05,0,0
14098,competitors,8,1.4691622836658537e-05,8,1.822477065265182e-05,0,0
14154,interviewing,8,1.4691622836658537e-05,8,1.822477065265182e-05,0,0
14330,heather,8,1.4691622836658537e-05,8,1.822477065265182e-05,0,0
14337,crossings,8,1.4691622836658537e-05,8,1.822477065265182e-05,0,0
14441,economically,8,1.4691622836658537e-05,8,1.822477065265182e-05,0,0
14512,forest,8,1.4691622836658537e-05,8,1.822477065265182e-05,0,0
14607,confirmation,8,1.4691622836658537e-05,8,1.822477065265182e-05,0,0
14622,gillespie,8,1.4691622836658537e-05,8,1.822477065265182e-05,0,0
14650,hence,8,1.4691622836658537e-05,8,1.822477065265182e-05,0,0
14670,trophy,8,1.4691622836658537e-05,8,1.822477065265182e-05,0,0
14725,lawful,8,1.4691622836658537e-05,8,1.822477065265182e-05,0,0
14732,rex,8,1.4691622836658537e-05,8,1.822477065265182e-05,0,0
14734,tillerson,8,1.4691622836658537e-05,8,1.822477065265182e-05,0,0
14762,destructive,8,1.4691622836658537e-05,8,1.822477065265182e-05,0,0
14783,index,8,1.4691622836658537e-05,8,1.822477065265182e-05,0,0
15043,#americafirst🇺🇸,8,1.4691622836658537e-05,8,1.822477065265182e-05,0,0
15054,proclaims,8,1.4691622836658537e-05,8,1.822477065265182e-05,0,0
15135,fronts,8,1.4691622836658537e-05,8,1.822477065265182e-05,0,0
15406,#hurricaneharvey,8,1.4691622836658537e-05,8,1.822477065265182e-05,0,0
15729,strategic,8,1.4691622836658537e-05,8,1.822477065265182e-05,0,0
16553,document,8,1.4691622836658537e-05,8,1.822477065265182e-05,0,0
16575,fentanyl,8,1.4691622836658537e-05,8,1.822477065265182e-05,0,0
16582,conclusion,8,1.4691622836658537e-05,8,1.822477065265182e-05,0,0
16608,spygate,8,1.4691622836658537e-05,8,1.822477065265182e-05,0,0
16645,french,8,1.4691622836658537e-05,8,1.822477065265182e-05,0,0
16861,targeting,8,1.4691622836658537e-05,8,1.822477065265182e-05,0,0
17075,kanye,8,1.4691622836658537e-05,8,1.822477065265182e-05,0,0
17287,@judicialwatch,8,1.4691622836658537e-05,8,1.822477065265182e-05,0,0
18410,bust,8,1.4691622836658537e-05,8,1.822477065265182e-05,0,0
18671,unlawful,8,1.4691622836658537e-05,8,1.822477065265182e-05,0,0
19116,telephone,8,1.4691622836658537e-05,8,1.822477065265182e-05,0,0
19810,aap,8,1.4691622836658537e-05,8,1.822477065265182e-05,0,0
20141,megan,8,1.4691622836658537e-05,8,1.822477065265182e-05,0,0
20336,delusion,8,1.4691622836658537e-05,8,1.822477065265182e-05,0,0
50,gear,7,1.285516998207622e-05,4,9.11238532632591e-06,3,2.8418509922796382e-05
73,suit,7,1.285516998207622e-05,5,1.1390481657907387e-05,2,1.8945673281864254e-05
328,long-term,7,1.285516998207622e-05,2,4.556192663162955e-06,5,4.736418320466063e-05
340,guaranteed,7,1.285516998207622e-05,3,6.8342889947444315e-06,4,3.789134656372851e-05
457,rejecting,7,1.285516998207622e-05,2,4.556192663162955e-06,5,4.736418320466063e-05
529,dyk,7,1.285516998207622e-05,0,0,7,6.63098564865249e-05
550,polluters,7,1.285516998207622e-05,2,4.556192663162955e-06,5,4.736418320466063e-05
560,improved,7,1.285516998207622e-05,3,6.8342889947444315e-06,4,3.789134656372851e-05
783,resilience,7,1.285516998207622e-05,3,6.8342889947444315e-06,4,3.789134656372851e-05
963,repeatedly,7,1.285516998207622e-05,5,1.1390481657907387e-05,2,1.8945673281864254e-05
1038,newest,7,1.285516998207622e-05,5,1.1390481657907387e-05,2,1.8945673281864254e-05
1065,mile,7,1.285516998207622e-05,6,1.3668577989488863e-05,1,9.472836640932127e-06
1211,graduation,7,1.285516998207622e-05,3,6.8342889947444315e-06,4,3.789134656372851e-05
1236,#acaworks,7,1.285516998207622e-05,0,0,7,6.63098564865249e-05
1280,tirelessly,7,1.285516998207622e-05,5,1.1390481657907387e-05,2,1.8945673281864254e-05
1282,belief,7,1.285516998207622e-05,4,9.11238532632591e-06,3,2.8418509922796382e-05
1283,ordinary,7,1.285516998207622e-05,0,0,7,6.63098564865249e-05
1309,settled,7,1.285516998207622e-05,3,6.8342889947444315e-06,4,3.789134656372851e-05
1349,character,7,1.285516998207622e-05,5,1.1390481657907387e-05,2,1.8945673281864254e-05
1356,leaves,7,1.285516998207622e-05,2,4.556192663162955e-06,5,4.736418320466063e-05
1403,glory,7,1.285516998207622e-05,5,1.1390481657907387e-05,2,1.8945673281864254e-05
1413,warming,7,1.285516998207622e-05,4,9.11238532632591e-06,3,2.8418509922796382e-05
1454,62,7,1.285516998207622e-05,5,1.1390481657907387e-05,2,1.8945673281864254e-05
1565,ensuring,7,1.285516998207622e-05,3,6.8342889947444315e-06,4,3.789134656372851e-05
1568,everybodys,7,1.285516998207622e-05,3,6.8342889947444315e-06,4,3.789134656372851e-05
1613,solving,7,1.285516998207622e-05,3,6.8342889947444315e-06,4,3.789134656372851e-05
1672,judgement,7,1.285516998207622e-05,6,1.3668577989488863e-05,1,9.472836640932127e-06
1700,imagination,7,1.285516998207622e-05,4,9.11238532632591e-06,3,2.8418509922796382e-05
1724,blacks,7,1.285516998207622e-05,6,1.3668577989488863e-05,1,9.472836640932127e-06
1779,sat,7,1.285516998207622e-05,4,9.11238532632591e-06,3,2.8418509922796382e-05
1830,1990s,7,1.285516998207622e-05,1,2.2780963315814773e-06,6,5.6837019845592764e-05
1846,medicine,7,1.285516998207622e-05,5,1.1390481657907387e-05,2,1.8945673281864254e-05
1845,disease,7,1.285516998207622e-05,5,1.1390481657907387e-05,2,1.8945673281864254e-05
1921,kings,7,1.285516998207622e-05,2,4.556192663162955e-06,5,4.736418320466063e-05
1953,decline,7,1.285516998207622e-05,3,6.8342889947444315e-06,4,3.789134656372851e-05
1990,vowed,7,1.285516998207622e-05,6,1.3668577989488863e-05,1,9.472836640932127e-06
2041,nashville,7,1.285516998207622e-05,6,1.3668577989488863e-05,1,9.472836640932127e-06
2040,immigrant,7,1.285516998207622e-05,4,9.11238532632591e-06,3,2.8418509922796382e-05
2099,nows,7,1.285516998207622e-05,0,0,7,6.63098564865249e-05
2142,fields,7,1.285516998207622e-05,5,1.1390481657907387e-05,2,1.8945673281864254e-05
2172,abroad,7,1.285516998207622e-05,3,6.8342889947444315e-06,4,3.789134656372851e-05
2206,55,7,1.285516998207622e-05,4,9.11238532632591e-06,3,2.8418509922796382e-05
2232,stretch,7,1.285516998207622e-05,1,2.2780963315814773e-06,6,5.6837019845592764e-05
2236,breast,7,1.285516998207622e-05,2,4.556192663162955e-06,5,4.736418320466063e-05
2252,answering,7,1.285516998207622e-05,3,6.8342889947444315e-06,4,3.789134656372851e-05
2254,insurers,7,1.285516998207622e-05,0,0,7,6.63098564865249e-05
2308,hateful,7,1.285516998207622e-05,6,1.3668577989488863e-05,1,9.472836640932127e-06
2456,#readytowork,7,1.285516998207622e-05,0,0,7,6.63098564865249e-05
2467,wherever,7,1.285516998207622e-05,3,6.8342889947444315e-06,4,3.789134656372851e-05
2475,transportation,7,1.285516998207622e-05,5,1.1390481657907387e-05,2,1.8945673281864254e-05
2495,14500,7,1.285516998207622e-05,0,0,7,6.63098564865249e-05
2544,babies,7,1.285516998207622e-05,4,9.11238532632591e-06,3,2.8418509922796382e-05
2547,tuition,7,1.285516998207622e-05,1,2.2780963315814773e-06,6,5.6837019845592764e-05
2555,flexibility,7,1.285516998207622e-05,5,1.1390481657907387e-05,2,1.8945673281864254e-05
2560,legislature,7,1.285516998207622e-05,4,9.11238532632591e-06,3,2.8418509922796382e-05
2596,degrees,7,1.285516998207622e-05,3,6.8342889947444315e-06,4,3.789134656372851e-05
2614,first-ever,7,1.285516998207622e-05,5,1.1390481657907387e-05,2,1.8945673281864254e-05
2626,worthy,7,1.285516998207622e-05,5,1.1390481657907387e-05,2,1.8945673281864254e-05
2690,pope,7,1.285516998207622e-05,4,9.11238532632591e-06,3,2.8418509922796382e-05
2722,employers,7,1.285516998207622e-05,2,4.556192663162955e-06,5,4.736418320466063e-05
2814,31st,7,1.285516998207622e-05,1,2.2780963315814773e-06,6,5.6837019845592764e-05
2822,7000,7,1.285516998207622e-05,5,1.1390481657907387e-05,2,1.8945673281864254e-05
2865,chances,7,1.285516998207622e-05,6,1.3668577989488863e-05,1,9.472836640932127e-06
2933,#mybrotherskeeper,7,1.285516998207622e-05,0,0,7,6.63098564865249e-05
2984,savings,7,1.285516998207622e-05,2,4.556192663162955e-06,5,4.736418320466063e-05
2999,2025,7,1.285516998207622e-05,3,6.8342889947444315e-06,4,3.789134656372851e-05
3010,#sciencesaysso,7,1.285516998207622e-05,0,0,7,6.63098564865249e-05
3069,athletes,7,1.285516998207622e-05,3,6.8342889947444315e-06,4,3.789134656372851e-05
3096,1950s,7,1.285516998207622e-05,0,0,7,6.63098564865249e-05
3177,revolution,7,1.285516998207622e-05,6,1.3668577989488863e-05,1,9.472836640932127e-06
3220,ray,7,1.285516998207622e-05,6,1.3668577989488863e-05,1,9.472836640932127e-06
3397,physical,7,1.285516998207622e-05,6,1.3668577989488863e-05,1,9.472836640932127e-06
3408,denying,7,1.285516998207622e-05,2,4.556192663162955e-06,5,4.736418320466063e-05
3483,#teapartyshutdown,7,1.285516998207622e-05,0,0,7,6.63098564865249e-05
3491,shutting,7,1.285516998207622e-05,4,9.11238532632591e-06,3,2.8418509922796382e-05
3497,domestic,7,1.285516998207622e-05,6,1.3668577989488863e-05,1,9.472836640932127e-06
3508,800000,7,1.285516998207622e-05,3,6.8342889947444315e-06,4,3.789134656372851e-05
3681,aurora,7,1.285516998207622e-05,1,2.2780963315814773e-06,6,5.6837019845592764e-05
3692,ups,7,1.285516998207622e-05,6,1.3668577989488863e-05,1,9.472836640932127e-06
3726,corps,7,1.285516998207622e-05,4,9.11238532632591e-06,3,2.8418509922796382e-05
3795,u,7,1.285516998207622e-05,6,1.3668577989488863e-05,1,9.472836640932127e-06
3838,occasion,7,1.285516998207622e-05,5,1.1390481657907387e-05,2,1.8945673281864254e-05
3989,bacon,7,1.285516998207622e-05,5,1.1390481657907387e-05,2,1.8945673281864254e-05
4002,promising,7,1.285516998207622e-05,4,9.11238532632591e-06,3,2.8418509922796382e-05
4006,smartest,7,1.285516998207622e-05,6,1.3668577989488863e-05,1,9.472836640932127e-06
4019,rely,7,1.285516998207622e-05,4,9.11238532632591e-06,3,2.8418509922796382e-05
4108,shattered,7,1.285516998207622e-05,6,1.3668577989488863e-05,1,9.472836640932127e-06
4116,designed,7,1.285516998207622e-05,4,9.11238532632591e-06,3,2.8418509922796382e-05
4170,spring,7,1.285516998207622e-05,3,6.8342889947444315e-06,4,3.789134656372851e-05
4174,sacrificed,7,1.285516998207622e-05,2,4.556192663162955e-06,5,4.736418320466063e-05
4220,corporations,7,1.285516998207622e-05,4,9.11238532632591e-06,3,2.8418509922796382e-05
4224,substance,7,1.285516998207622e-05,6,1.3668577989488863e-05,1,9.472836640932127e-06
4260,pain,7,1.285516998207622e-05,6,1.3668577989488863e-05,1,9.472836640932127e-06
4381,familiar,7,1.285516998207622e-05,2,4.556192663162955e-06,5,4.736418320466063e-05
4424,reid,7,1.285516998207622e-05,6,1.3668577989488863e-05,1,9.472836640932127e-06
4429,smaller,7,1.285516998207622e-05,6,1.3668577989488863e-05,1,9.472836640932127e-06
4498,sees,7,1.285516998207622e-05,5,1.1390481657907387e-05,2,1.8945673281864254e-05
4500,toughest,7,1.285516998207622e-05,4,9.11238532632591e-06,3,2.8418509922796382e-05
4507,rain,7,1.285516998207622e-05,3,6.8342889947444315e-06,4,3.789134656372851e-05
4522,#teamobama,7,1.285516998207622e-05,0,0,7,6.63098564865249e-05
4543,z,7,1.285516998207622e-05,3,6.8342889947444315e-06,4,3.789134656372851e-05
4569,osama,7,1.285516998207622e-05,3,6.8342889947444315e-06,4,3.789134656372851e-05
4608,nc,7,1.285516998207622e-05,5,1.1390481657907387e-05,2,1.8945673281864254e-05
4650,steven,7,1.285516998207622e-05,6,1.3668577989488863e-05,1,9.472836640932127e-06
4654,knock,7,1.285516998207622e-05,2,4.556192663162955e-06,5,4.736418320466063e-05
4677,endorses,7,1.285516998207622e-05,3,6.8342889947444315e-06,4,3.789134656372851e-05
4681,sec,7,1.285516998207622e-05,5,1.1390481657907387e-05,2,1.8945673281864254e-05
4680,retired,7,1.285516998207622e-05,5,1.1390481657907387e-05,2,1.8945673281864254e-05
4704,bears,7,1.285516998207622e-05,5,1.1390481657907387e-05,2,1.8945673281864254e-05
4742,fees,7,1.285516998207622e-05,4,9.11238532632591e-06,3,2.8418509922796382e-05
4750,underestimate,7,1.285516998207622e-05,5,1.1390481657907387e-05,2,1.8945673281864254e-05
4762,believing,7,1.285516998207622e-05,3,6.8342889947444315e-06,4,3.789134656372851e-05
4803,eye,7,1.285516998207622e-05,5,1.1390481657907387e-05,2,1.8945673281864254e-05
4831,withdraw,7,1.285516998207622e-05,5,1.1390481657907387e-05,2,1.8945673281864254e-05
4840,denver,7,1.285516998207622e-05,1,2.2780963315814773e-06,6,5.6837019845592764e-05
4903,#strongerwithobama,7,1.285516998207622e-05,0,0,7,6.63098564865249e-05
4915,resort,7,1.285516998207622e-05,4,9.11238532632591e-06,3,2.8418509922796382e-05
4924,develop,7,1.285516998207622e-05,5,1.1390481657907387e-05,2,1.8945673281864254e-05
4957,appoint,7,1.285516998207622e-05,5,1.1390481657907387e-05,2,1.8945673281864254e-05
4995,#sketchydeal,7,1.285516998207622e-05,0,0,7,6.63098564865249e-05
5013,efficient,7,1.285516998207622e-05,4,9.11238532632591e-06,3,2.8418509922796382e-05
5076,tireless,7,1.285516998207622e-05,4,9.11238532632591e-06,3,2.8418509922796382e-05
5077,experienced,7,1.285516998207622e-05,6,1.3668577989488863e-05,1,9.472836640932127e-06
5162,goodness,7,1.285516998207622e-05,5,1.1390481657907387e-05,2,1.8945673281864254e-05
5164,blowing,7,1.285516998207622e-05,6,1.3668577989488863e-05,1,9.472836640932127e-06
5184,delivery,7,1.285516998207622e-05,6,1.3668577989488863e-05,1,9.472836640932127e-06
5186,imports,7,1.285516998207622e-05,4,9.11238532632591e-06,3,2.8418509922796382e-05
5207,touch,7,1.285516998207622e-05,5,1.1390481657907387e-05,2,1.8945673281864254e-05
5341,mixed,7,1.285516998207622e-05,6,1.3668577989488863e-05,1,9.472836640932127e-06
5422,jill,7,1.285516998207622e-05,6,1.3668577989488863e-05,1,9.472836640932127e-06
5460,solemn,7,1.285516998207622e-05,6,1.3668577989488863e-05,1,9.472836640932127e-06
5462,distant,7,1.285516998207622e-05,6,1.3668577989488863e-05,1,9.472836640932127e-06
5497,core,7,1.285516998207622e-05,5,1.1390481657907387e-05,2,1.8945673281864254e-05
5542,reaction,7,1.285516998207622e-05,6,1.3668577989488863e-05,1,9.472836640932127e-06
5595,forms,7,1.285516998207622e-05,4,9.11238532632591e-06,3,2.8418509922796382e-05
5600,fundamentally,7,1.285516998207622e-05,1,2.2780963315814773e-06,6,5.6837019845592764e-05
5618,manager,7,1.285516998207622e-05,6,1.3668577989488863e-05,1,9.472836640932127e-06
5647,female,7,1.285516998207622e-05,5,1.1390481657907387e-05,2,1.8945673281864254e-05
5689,hair,7,1.285516998207622e-05,5,1.1390481657907387e-05,2,1.8945673281864254e-05
5706,judy,7,1.285516998207622e-05,4,9.11238532632591e-06,3,2.8418509922796382e-05
5718,buyout,7,1.285516998207622e-05,0,0,7,6.63098564865249e-05
5738,unwavering,7,1.285516998207622e-05,6,1.3668577989488863e-05,1,9.472836640932127e-06
5779,everyday,7,1.285516998207622e-05,5,1.1390481657907387e-05,2,1.8945673281864254e-05
5813,publicly,7,1.285516998207622e-05,6,1.3668577989488863e-05,1,9.472836640932127e-06
5820,rapids,7,1.285516998207622e-05,6,1.3668577989488863e-05,1,9.472836640932127e-06
5874,laptop,7,1.285516998207622e-05,5,1.1390481657907387e-05,2,1.8945673281864254e-05
5887,1500,7,1.285516998207622e-05,2,4.556192663162955e-06,5,4.736418320466063e-05
5899,invitation,7,1.285516998207622e-05,6,1.3668577989488863e-05,1,9.472836640932127e-06
5934,reminded,7,1.285516998207622e-05,4,9.11238532632591e-06,3,2.8418509922796382e-05
5999,@thedemocrats,7,1.285516998207622e-05,0,0,7,6.63098564865249e-05
6022,urges,7,1.285516998207622e-05,1,2.2780963315814773e-06,6,5.6837019845592764e-05
6041,sotomayor,7,1.285516998207622e-05,1,2.2780963315814773e-06,6,5.6837019845592764e-05
6177,thousand,7,1.285516998207622e-05,6,1.3668577989488863e-05,1,9.472836640932127e-06
6216,monthly,7,1.285516998207622e-05,3,6.8342889947444315e-06,4,3.789134656372851e-05
6277,manipulation,7,1.285516998207622e-05,6,1.3668577989488863e-05,1,9.472836640932127e-06
6354,picks,7,1.285516998207622e-05,3,6.8342889947444315e-06,4,3.789134656372851e-05
6588,arriving,7,1.285516998207622e-05,6,1.3668577989488863e-05,1,9.472836640932127e-06
6600,270,7,1.285516998207622e-05,5,1.1390481657907387e-05,2,1.8945673281864254e-05
6693,keystone,7,1.285516998207622e-05,4,9.11238532632591e-06,3,2.8418509922796382e-05
6870,updated,7,1.285516998207622e-05,5,1.1390481657907387e-05,2,1.8945673281864254e-05
6886,writers,7,1.285516998207622e-05,6,1.3668577989488863e-05,1,9.472836640932127e-06
6905,senates,7,1.285516998207622e-05,4,9.11238532632591e-06,3,2.8418509922796382e-05
6908,fence,7,1.285516998207622e-05,6,1.3668577989488863e-05,1,9.472836640932127e-06
6912,agreements,7,1.285516998207622e-05,6,1.3668577989488863e-05,1,9.472836640932127e-06
6964,reception,7,1.285516998207622e-05,6,1.3668577989488863e-05,1,9.472836640932127e-06
7044,particularly,7,1.285516998207622e-05,5,1.1390481657907387e-05,2,1.8945673281864254e-05
7134,#compromise,7,1.285516998207622e-05,0,0,7,6.63098564865249e-05
7261,abraham,7,1.285516998207622e-05,6,1.3668577989488863e-05,1,9.472836640932127e-06
7312,remembered,7,1.285516998207622e-05,6,1.3668577989488863e-05,1,9.472836640932127e-06
7383,cutter,7,1.285516998207622e-05,6,1.3668577989488863e-05,1,9.472836640932127e-06
7498,contrary,7,1.285516998207622e-05,6,1.3668577989488863e-05,1,9.472836640932127e-06
7543,spill,7,1.285516998207622e-05,0,0,7,6.63098564865249e-05
7560,#usa,7,1.285516998207622e-05,6,1.3668577989488863e-05,1,9.472836640932127e-06
7643,commencement,7,1.285516998207622e-05,6,1.3668577989488863e-05,1,9.472836640932127e-06
7650,undermine,7,1.285516998207622e-05,6,1.3668577989488863e-05,1,9.472836640932127e-06
7795,seasons,7,1.285516998207622e-05,6,1.3668577989488863e-05,1,9.472836640932127e-06
7943,interference,7,1.285516998207622e-05,7,1.5946674321070342e-05,0,0
7993,finds,7,1.285516998207622e-05,7,1.5946674321070342e-05,0,0
8059,@usmc,7,1.285516998207622e-05,7,1.5946674321070342e-05,0,0
8060,@marshablackburn,7,1.285516998207622e-05,7,1.5946674321070342e-05,0,0
8128,stepping,7,1.285516998207622e-05,7,1.5946674321070342e-05,0,0
8163,wayne,7,1.285516998207622e-05,7,1.5946674321070342e-05,0,0
8161,harassed,7,1.285516998207622e-05,7,1.5946674321070342e-05,0,0
8173,disrespected,7,1.285516998207622e-05,7,1.5946674321070342e-05,0,0
8187,1200,7,1.285516998207622e-05,7,1.5946674321070342e-05,0,0
8197,harass,7,1.285516998207622e-05,7,1.5946674321070342e-05,0,0
8212,sand,7,1.285516998207622e-05,7,1.5946674321070342e-05,0,0
8214,figures,7,1.285516998207622e-05,7,1.5946674321070342e-05,0,0
8228,obtained,7,1.285516998207622e-05,7,1.5946674321070342e-05,0,0
8321,intentions,7,1.285516998207622e-05,7,1.5946674321070342e-05,0,0
8421,indian,7,1.285516998207622e-05,7,1.5946674321070342e-05,0,0
8494,@dougducey,7,1.285516998207622e-05,7,1.5946674321070342e-05,0,0
8543,27,7,1.285516998207622e-05,7,1.5946674321070342e-05,0,0
8561,randy,7,1.285516998207622e-05,7,1.5946674321070342e-05,0,0
8657,@washtimes,7,1.285516998207622e-05,7,1.5946674321070342e-05,0,0
8667,marc,7,1.285516998207622e-05,7,1.5946674321070342e-05,0,0
8676,burgess,7,1.285516998207622e-05,7,1.5946674321070342e-05,0,0
8747,lockdown,7,1.285516998207622e-05,7,1.5946674321070342e-05,0,0
8767,joseph,7,1.285516998207622e-05,7,1.5946674321070342e-05,0,0
8764,digenova,7,1.285516998207622e-05,7,1.5946674321070342e-05,0,0
8778,brooks,7,1.285516998207622e-05,7,1.5946674321070342e-05,0,0
8786,insane,7,1.285516998207622e-05,7,1.5946674321070342e-05,0,0
8798,formed,7,1.285516998207622e-05,7,1.5946674321070342e-05,0,0
8805,native,7,1.285516998207622e-05,7,1.5946674321070342e-05,0,0
8811,salaries,7,1.285516998207622e-05,7,1.5946674321070342e-05,0,0
8861,@rudygiuliani,7,1.285516998207622e-05,7,1.5946674321070342e-05,0,0
8898,lowlifes,7,1.285516998207622e-05,7,1.5946674321070342e-05,0,0
8987,dues,7,1.285516998207622e-05,7,1.5946674321070342e-05,0,0
8989,lawrence,7,1.285516998207622e-05,7,1.5946674321070342e-05,0,0
9139,5g,7,1.285516998207622e-05,7,1.5946674321070342e-05,0,0
9203,dry,7,1.285516998207622e-05,7,1.5946674321070342e-05,0,0
9211,promote,7,1.285516998207622e-05,7,1.5946674321070342e-05,0,0
9232,looting,7,1.285516998207622e-05,7,1.5946674321070342e-05,0,0
9272,thus,7,1.285516998207622e-05,7,1.5946674321070342e-05,0,0
9319,oregon,7,1.285516998207622e-05,7,1.5946674321070342e-05,0,0
9365,approves,7,1.285516998207622e-05,7,1.5946674321070342e-05,0,0
9408,favored,7,1.285516998207622e-05,7,1.5946674321070342e-05,0,0
9413,arsonists,7,1.285516998207622e-05,7,1.5946674321070342e-05,0,0
9419,late-term,7,1.285516998207622e-05,7,1.5946674321070342e-05,0,0
9461,genius,7,1.285516998207622e-05,7,1.5946674321070342e-05,0,0
9475,inner,7,1.285516998207622e-05,7,1.5946674321070342e-05,0,0
9509,wto,7,1.285516998207622e-05,7,1.5946674321070342e-05,0,0
9552,tommy,7,1.285516998207622e-05,7,1.5946674321070342e-05,0,0
9580,vile,7,1.285516998207622e-05,7,1.5946674321070342e-05,0,0
9616,breitbart,7,1.285516998207622e-05,7,1.5946674321070342e-05,0,0
9632,amnesty,7,1.285516998207622e-05,7,1.5946674321070342e-05,0,0
9659,cyber,7,1.285516998207622e-05,7,1.5946674321070342e-05,0,0
9669,disappear,7,1.285516998207622e-05,7,1.5946674321070342e-05,0,0
9670,historically,7,1.285516998207622e-05,7,1.5946674321070342e-05,0,0
9687,hereby,7,1.285516998207622e-05,7,1.5946674321070342e-05,0,0
9730,whitaker,7,1.285516998207622e-05,7,1.5946674321070342e-05,0,0
9736,boy,7,1.285516998207622e-05,7,1.5946674321070342e-05,0,0
9767,hundred,7,1.285516998207622e-05,7,1.5946674321070342e-05,0,0
9808,miller,7,1.285516998207622e-05,7,1.5946674321070342e-05,0,0
9868,portion,7,1.285516998207622e-05,7,1.5946674321070342e-05,0,0
9882,inaccurately,7,1.285516998207622e-05,7,1.5946674321070342e-05,0,0
9885,@hawleymo,7,1.285516998207622e-05,7,1.5946674321070342e-05,0,0
9915,ease,7,1.285516998207622e-05,7,1.5946674321070342e-05,0,0
9924,@clewandowski,7,1.285516998207622e-05,7,1.5946674321070342e-05,0,0
9935,simpson,7,1.285516998207622e-05,7,1.5946674321070342e-05,0,0
9956,ratcliffe,7,1.285516998207622e-05,7,1.5946674321070342e-05,0,0
9978,gasoline,7,1.285516998207622e-05,7,1.5946674321070342e-05,0,0
9983,theresa,7,1.285516998207622e-05,7,1.5946674321070342e-05,0,0
10013,queen,7,1.285516998207622e-05,7,1.5946674321070342e-05,0,0
10057,monster,7,1.285516998207622e-05,7,1.5946674321070342e-05,0,0
10145,می,7,1.285516998207622e-05,7,1.5946674321070342e-05,0,0
10168,ethanol,7,1.285516998207622e-05,7,1.5946674321070342e-05,0,0
10203,naval,7,1.285516998207622e-05,7,1.5946674321070342e-05,0,0
10261,at&t,7,1.285516998207622e-05,7,1.5946674321070342e-05,0,0
10424,testifying,7,1.285516998207622e-05,7,1.5946674321070342e-05,0,0
10432,denmark,7,1.285516998207622e-05,7,1.5946674321070342e-05,0,0
10464,departed,7,1.285516998207622e-05,7,1.5946674321070342e-05,0,0
10491,14th,7,1.285516998207622e-05,7,1.5946674321070342e-05,0,0
10505,blatant,7,1.285516998207622e-05,7,1.5946674321070342e-05,0,0
10576,@mayorbowser,7,1.285516998207622e-05,7,1.5946674321070342e-05,0,0
10582,sells,7,1.285516998207622e-05,7,1.5946674321070342e-05,0,0
10610,wilson,7,1.285516998207622e-05,7,1.5946674321070342e-05,0,0
10623,crossing,7,1.285516998207622e-05,7,1.5946674321070342e-05,0,0
10640,league,7,1.285516998207622e-05,7,1.5946674321070342e-05,0,0
10649,bomb,7,1.285516998207622e-05,7,1.5946674321070342e-05,0,0
10668,@alandersh,7,1.285516998207622e-05,7,1.5946674321070342e-05,0,0
10692,protestors,7,1.285516998207622e-05,7,1.5946674321070342e-05,0,0
10705,tulsa,7,1.285516998207622e-05,7,1.5946674321070342e-05,0,0
10720,mika,7,1.285516998207622e-05,7,1.5946674321070342e-05,0,0
10722,deserved,7,1.285516998207622e-05,7,1.5946674321070342e-05,0,0
10724,pirro,7,1.285516998207622e-05,7,1.5946674321070342e-05,0,0
10740,disgruntled,7,1.285516998207622e-05,7,1.5946674321070342e-05,0,0
10751,lebanon,7,1.285516998207622e-05,7,1.5946674321070342e-05,0,0
10818,@mikegarcia2020,7,1.285516998207622e-05,7,1.5946674321070342e-05,0,0
10925,hydroxychloroquine,7,1.285516998207622e-05,7,1.5946674321070342e-05,0,0
10926,#makeamericagreatagain,7,1.285516998207622e-05,7,1.5946674321070342e-05,0,0
11028,icig,7,1.285516998207622e-05,7,1.5946674321070342e-05,0,0
11206,writer,7,1.285516998207622e-05,7,1.5946674321070342e-05,0,0
11238,prince,7,1.285516998207622e-05,7,1.5946674321070342e-05,0,0
11251,stuck,7,1.285516998207622e-05,7,1.5946674321070342e-05,0,0
11253,@cvpayne,7,1.285516998207622e-05,7,1.5946674321070342e-05,0,0
11263,exonerated,7,1.285516998207622e-05,7,1.5946674321070342e-05,0,0
11278,sudden,7,1.285516998207622e-05,7,1.5946674321070342e-05,0,0
11381,hong,7,1.285516998207622e-05,7,1.5946674321070342e-05,0,0
11382,kong,7,1.285516998207622e-05,7,1.5946674321070342e-05,0,0
11413,brexit,7,1.285516998207622e-05,7,1.5946674321070342e-05,0,0
11433,anytime,7,1.285516998207622e-05,7,1.5946674321070342e-05,0,0
11515,mick,7,1.285516998207622e-05,7,1.5946674321070342e-05,0,0
11517,northern,7,1.285516998207622e-05,7,1.5946674321070342e-05,0,0
11538,apprehend,7,1.285516998207622e-05,7,1.5946674321070342e-05,0,0
11588,chaffetz,7,1.285516998207622e-05,7,1.5946674321070342e-05,0,0
11624,upside,7,1.285516998207622e-05,7,1.5946674321070342e-05,0,0
11666,dealers,7,1.285516998207622e-05,7,1.5946674321070342e-05,0,0
11721,lewis,7,1.285516998207622e-05,7,1.5946674321070342e-05,0,0
11728,awarding,7,1.285516998207622e-05,7,1.5946674321070342e-05,0,0
11774,dairy,7,1.285516998207622e-05,7,1.5946674321070342e-05,0,0
11831,happily,7,1.285516998207622e-05,7,1.5946674321070342e-05,0,0
11894,rosendale,7,1.285516998207622e-05,7,1.5946674321070342e-05,0,0
11896,statues,7,1.285516998207622e-05,7,1.5946674321070342e-05,0,0
11978,factor,7,1.285516998207622e-05,7,1.5946674321070342e-05,0,0
12060,derangement,7,1.285516998207622e-05,7,1.5946674321070342e-05,0,0
12064,pulitzer,7,1.285516998207622e-05,7,1.5946674321070342e-05,0,0
12062,awards,7,1.285516998207622e-05,7,1.5946674321070342e-05,0,0
12109,designating,7,1.285516998207622e-05,7,1.5946674321070342e-05,0,0
12151,believed,7,1.285516998207622e-05,7,1.5946674321070342e-05,0,0
12228,airlines,7,1.285516998207622e-05,7,1.5946674321070342e-05,0,0
12241,lindsey,7,1.285516998207622e-05,7,1.5946674321070342e-05,0,0
12378,immunity,7,1.285516998207622e-05,7,1.5946674321070342e-05,0,0
12390,@nra,7,1.285516998207622e-05,7,1.5946674321070342e-05,0,0
12474,flourish,7,1.285516998207622e-05,7,1.5946674321070342e-05,0,0
12500,@tatereeves,7,1.285516998207622e-05,7,1.5946674321070342e-05,0,0
12505,maduro,7,1.285516998207622e-05,7,1.5946674321070342e-05,0,0
12527,sorts,7,1.285516998207622e-05,7,1.5946674321070342e-05,0,0
12567,indianapolis,7,1.285516998207622e-05,7,1.5946674321070342e-05,0,0
12664,bonds,7,1.285516998207622e-05,7,1.5946674321070342e-05,0,0
12811,dealt,7,1.285516998207622e-05,7,1.5946674321070342e-05,0,0
12944,blasio,7,1.285516998207622e-05,7,1.5946674321070342e-05,0,0
13009,divided,7,1.285516998207622e-05,7,1.5946674321070342e-05,0,0
13021,unmasking,7,1.285516998207622e-05,7,1.5946674321070342e-05,0,0
13037,rocky,7,1.285516998207622e-05,7,1.5946674321070342e-05,0,0
13060,judd,7,1.285516998207622e-05,7,1.5946674321070342e-05,0,0
13138,ross,7,1.285516998207622e-05,7,1.5946674321070342e-05,0,0
13237,minor,7,1.285516998207622e-05,7,1.5946674321070342e-05,0,0
13248,panel,7,1.285516998207622e-05,7,1.5946674321070342e-05,0,0
13395,solved,7,1.285516998207622e-05,7,1.5946674321070342e-05,0,0
13418,parlor,7,1.285516998207622e-05,7,1.5946674321070342e-05,0,0
13443,hiden,7,1.285516998207622e-05,7,1.5946674321070342e-05,0,0
13456,के,7,1.285516998207622e-05,7,1.5946674321070342e-05,0,0
13812,harvey,7,1.285516998207622e-05,7,1.5946674321070342e-05,0,0
13820,anchors,7,1.285516998207622e-05,7,1.5946674321070342e-05,0,0
13840,unverified,7,1.285516998207622e-05,7,1.5946674321070342e-05,0,0
13921,suspect,7,1.285516998207622e-05,7,1.5946674321070342e-05,0,0
13926,cooperate,7,1.285516998207622e-05,7,1.5946674321070342e-05,0,0
13946,theme,7,1.285516998207622e-05,7,1.5946674321070342e-05,0,0
14020,@troybalderson,7,1.285516998207622e-05,7,1.5946674321070342e-05,0,0
14037,brilliantly,7,1.285516998207622e-05,7,1.5946674321070342e-05,0,0
14100,permission,7,1.285516998207622e-05,7,1.5946674321070342e-05,0,0
14121,expert,7,1.285516998207622e-05,7,1.5946674321070342e-05,0,0
14139,eating,7,1.285516998207622e-05,7,1.5946674321070342e-05,0,0
14198,convicted,7,1.285516998207622e-05,7,1.5946674321070342e-05,0,0
14226,approving,7,1.285516998207622e-05,7,1.5946674321070342e-05,0,0
14459,sanford,7,1.285516998207622e-05,7,1.5946674321070342e-05,0,0
14468,do-over,7,1.285516998207622e-05,7,1.5946674321070342e-05,0,0
14891,#apec2017,7,1.285516998207622e-05,7,1.5946674321070342e-05,0,0
14986,@cabinet,7,1.285516998207622e-05,7,1.5946674321070342e-05,0,0
15193,one-sided,7,1.285516998207622e-05,7,1.5946674321070342e-05,0,0
15341,renovation,7,1.285516998207622e-05,7,1.5946674321070342e-05,0,0
15346,devastation,7,1.285516998207622e-05,7,1.5946674321070342e-05,0,0
15456,charlottesville,7,1.285516998207622e-05,7,1.5946674321070342e-05,0,0
15545,foxconn,7,1.285516998207622e-05,7,1.5946674321070342e-05,0,0
15608,syrian,7,1.285516998207622e-05,7,1.5946674321070342e-05,0,0
15699,#g20summit,7,1.285516998207622e-05,7,1.5946674321070342e-05,0,0
15701,merkel,7,1.285516998207622e-05,7,1.5946674321070342e-05,0,0
15774,scheme,7,1.285516998207622e-05,7,1.5946674321070342e-05,0,0
15798,th,7,1.285516998207622e-05,7,1.5946674321070342e-05,0,0
15869,#g7summit,7,1.285516998207622e-05,7,1.5946674321070342e-05,0,0
16006,england,7,1.285516998207622e-05,7,1.5946674321070342e-05,0,0
16135,demanded,7,1.285516998207622e-05,7,1.5946674321070342e-05,0,0
16275,barbara,7,1.285516998207622e-05,7,1.5946674321070342e-05,0,0
16375,bite,7,1.285516998207622e-05,7,1.5946674321070342e-05,0,0
16412,@rterdogan,7,1.285516998207622e-05,7,1.5946674321070342e-05,0,0
16523,transaction,7,1.285516998207622e-05,7,1.5946674321070342e-05,0,0
16556,substantial,7,1.285516998207622e-05,7,1.5946674321070342e-05,0,0
16682,invasion,7,1.285516998207622e-05,7,1.5946674321070342e-05,0,0
16722,warner,7,1.285516998207622e-05,7,1.5946674321070342e-05,0,0
16988,examiner,7,1.285516998207622e-05,7,1.5946674321070342e-05,0,0
17113,obstructing,7,1.285516998207622e-05,7,1.5946674321070342e-05,0,0
17174,professor,7,1.285516998207622e-05,7,1.5946674321070342e-05,0,0
17182,spies,7,1.285516998207622e-05,7,1.5946674321070342e-05,0,0
17472,legitimate,7,1.285516998207622e-05,7,1.5946674321070342e-05,0,0
17488,balderson,7,1.285516998207622e-05,7,1.5946674321070342e-05,0,0
17646,cave,7,1.285516998207622e-05,7,1.5946674321070342e-05,0,0
17907,devin,7,1.285516998207622e-05,7,1.5946674321070342e-05,0,0
18304,bump,7,1.285516998207622e-05,7,1.5946674321070342e-05,0,0
18393,volume,7,1.285516998207622e-05,7,1.5946674321070342e-05,0,0
18644,mac,7,1.285516998207622e-05,7,1.5946674321070342e-05,0,0
18756,nearby,7,1.285516998207622e-05,7,1.5946674321070342e-05,0,0
18780,sondland,7,1.285516998207622e-05,7,1.5946674321070342e-05,0,0
19097,#trump2020,7,1.285516998207622e-05,7,1.5946674321070342e-05,0,0
19662,tlaib,7,1.285516998207622e-05,7,1.5946674321070342e-05,0,0
20268,#dday75thanniversary,7,1.285516998207622e-05,7,1.5946674321070342e-05,0,0
33,contribution,6,1.1018717127493903e-05,3,6.8342889947444315e-06,3,2.8418509922796382e-05
99,mountain,6,1.1018717127493903e-05,4,9.11238532632591e-06,2,1.8945673281864254e-05
144,optimistic,6,1.1018717127493903e-05,3,6.8342889947444315e-06,3,2.8418509922796382e-05
151,repeat,6,1.1018717127493903e-05,5,1.1390481657907387e-05,1,9.472836640932127e-06
272,heroism,6,1.1018717127493903e-05,2,4.556192663162955e-06,4,3.789134656372851e-05
278,rosa,6,1.1018717127493903e-05,0,0,6,5.6837019845592764e-05
285,tackle,6,1.1018717127493903e-05,0,0,6,5.6837019845592764e-05
298,sleep,6,1.1018717127493903e-05,4,9.11238532632591e-06,2,1.8945673281864254e-05
335,temperatures,6,1.1018717127493903e-05,3,6.8342889947444315e-06,3,2.8418509922796382e-05
338,crucial,6,1.1018717127493903e-05,2,4.556192663162955e-06,4,3.789134656372851e-05
350,globe,6,1.1018717127493903e-05,4,9.11238532632591e-06,2,1.8945673281864254e-05
445,drivers,6,1.1018717127493903e-05,3,6.8342889947444315e-06,3,2.8418509922796382e-05
470,68,6,1.1018717127493903e-05,3,6.8342889947444315e-06,3,2.8418509922796382e-05
501,coffee,6,1.1018717127493903e-05,0,0,6,5.6837019845592764e-05
599,sweet,6,1.1018717127493903e-05,1,2.2780963315814773e-06,5,4.736418320466063e-05
615,tragedies,6,1.1018717127493903e-05,3,6.8342889947444315e-06,3,2.8418509922796382e-05
631,67,6,1.1018717127493903e-05,3,6.8342889947444315e-06,3,2.8418509922796382e-05
726,two-thirds,6,1.1018717127493903e-05,1,2.2780963315814773e-06,5,4.736418320466063e-05
748,2001,6,1.1018717127493903e-05,3,6.8342889947444315e-06,3,2.8418509922796382e-05
781,celebrates,6,1.1018717127493903e-05,3,6.8342889947444315e-06,3,2.8418509922796382e-05
823,mount,6,1.1018717127493903e-05,5,1.1390481657907387e-05,1,9.472836640932127e-06
880,pathway,6,1.1018717127493903e-05,2,4.556192663162955e-06,4,3.789134656372851e-05
882,critics,6,1.1018717127493903e-05,5,1.1390481657907387e-05,1,9.472836640932127e-06
909,drops,6,1.1018717127493903e-05,4,9.11238532632591e-06,2,1.8945673281864254e-05
932,stewart,6,1.1018717127493903e-05,4,9.11238532632591e-06,2,1.8945673281864254e-05
964,arguments,6,1.1018717127493903e-05,4,9.11238532632591e-06,2,1.8945673281864254e-05
1062,ignore,6,1.1018717127493903e-05,4,9.11238532632591e-06,2,1.8945673281864254e-05
1075,presence,6,1.1018717127493903e-05,4,9.11238532632591e-06,2,1.8945673281864254e-05
1121,body,6,1.1018717127493903e-05,4,9.11238532632591e-06,2,1.8945673281864254e-05
1184,remind,6,1.1018717127493903e-05,2,4.556192663162955e-06,4,3.789134656372851e-05
1299,guarantees,6,1.1018717127493903e-05,4,9.11238532632591e-06,2,1.8945673281864254e-05
1318,repealed,6,1.1018717127493903e-05,1,2.2780963315814773e-06,5,4.736418320466063e-05
1396,f,6,1.1018717127493903e-05,2,4.556192663162955e-06,4,3.789134656372851e-05
1428,heaven,6,1.1018717127493903e-05,3,6.8342889947444315e-06,3,2.8418509922796382e-05
1496,organizer,6,1.1018717127493903e-05,0,0,6,5.6837019845592764e-05
1497,#betterwithobamacare,6,1.1018717127493903e-05,0,0,6,5.6837019845592764e-05
1554,outdoors,6,1.1018717127493903e-05,4,9.11238532632591e-06,2,1.8945673281864254e-05
1590,launching,6,1.1018717127493903e-05,3,6.8342889947444315e-06,3,2.8418509922796382e-05
1602,girl,6,1.1018717127493903e-05,2,4.556192663162955e-06,4,3.789134656372851e-05
1609,estimated,6,1.1018717127493903e-05,3,6.8342889947444315e-06,3,2.8418509922796382e-05
1671,earliest,6,1.1018717127493903e-05,3,6.8342889947444315e-06,3,2.8418509922796382e-05
1702,degree,6,1.1018717127493903e-05,2,4.556192663162955e-06,4,3.789134656372851e-05
1713,soar,6,1.1018717127493903e-05,5,1.1390481657907387e-05,1,9.472836640932127e-06
1895,guarantee,6,1.1018717127493903e-05,3,6.8342889947444315e-06,3,2.8418509922796382e-05
1904,911,6,1.1018717127493903e-05,3,6.8342889947444315e-06,3,2.8418509922796382e-05
1912,1999,6,1.1018717127493903e-05,0,0,6,5.6837019845592764e-05
1932,58,6,1.1018717127493903e-05,4,9.11238532632591e-06,2,1.8945673281864254e-05
1960,rooting,6,1.1018717127493903e-05,2,4.556192663162955e-06,4,3.789134656372851e-05
1976,stuart,6,1.1018717127493903e-05,5,1.1390481657907387e-05,1,9.472836640932127e-06
2043,57,6,1.1018717127493903e-05,1,2.2780963315814773e-06,5,4.736418320466063e-05
2047,enrollment,6,1.1018717127493903e-05,1,2.2780963315814773e-06,5,4.736418320466063e-05
2063,achieving,6,1.1018717127493903e-05,5,1.1390481657907387e-05,1,9.472836640932127e-06
2105,jeopardy,6,1.1018717127493903e-05,4,9.11238532632591e-06,2,1.8945673281864254e-05
2134,hugs,6,1.1018717127493903e-05,0,0,6,5.6837019845592764e-05
2165,dangers,6,1.1018717127493903e-05,3,6.8342889947444315e-06,3,2.8418509922796382e-05
2222,high-quality,6,1.1018717127493903e-05,1,2.2780963315814773e-06,5,4.736418320466063e-05
2249,designated,6,1.1018717127493903e-05,5,1.1390481657907387e-05,1,9.472836640932127e-06
2277,reject,6,1.1018717127493903e-05,3,6.8342889947444315e-06,3,2.8418509922796382e-05
2276,quiet,6,1.1018717127493903e-05,4,9.11238532632591e-06,2,1.8945673281864254e-05
2322,reaffirm,6,1.1018717127493903e-05,3,6.8342889947444315e-06,3,2.8418509922796382e-05
2390,prefer,6,1.1018717127493903e-05,5,1.1390481657907387e-05,1,9.472836640932127e-06
2391,brady,6,1.1018717127493903e-05,5,1.1390481657907387e-05,1,9.472836640932127e-06
2513,defended,6,1.1018717127493903e-05,5,1.1390481657907387e-05,1,9.472836640932127e-06
2528,struck,6,1.1018717127493903e-05,5,1.1390481657907387e-05,1,9.472836640932127e-06
2536,balance,6,1.1018717127493903e-05,5,1.1390481657907387e-05,1,9.472836640932127e-06
2625,#memorialday,6,1.1018717127493903e-05,1,2.2780963315814773e-06,5,4.736418320466063e-05
2627,answered,6,1.1018717127493903e-05,3,6.8342889947444315e-06,3,2.8418509922796382e-05
2732,passover,6,1.1018717127493903e-05,3,6.8342889947444315e-06,3,2.8418509922796382e-05
2754,households,6,1.1018717127493903e-05,0,0,6,5.6837019845592764e-05
2804,margaret,6,1.1018717127493903e-05,1,2.2780963315814773e-06,5,4.736418320466063e-05
2810,scare,6,1.1018717127493903e-05,3,6.8342889947444315e-06,3,2.8418509922796382e-05
2823,arm,6,1.1018717127493903e-05,5,1.1390481657907387e-05,1,9.472836640932127e-06
2829,awesome,6,1.1018717127493903e-05,4,9.11238532632591e-06,2,1.8945673281864254e-05
2834,hurry,6,1.1018717127493903e-05,5,1.1390481657907387e-05,1,9.472836640932127e-06
2833,deadlines,6,1.1018717127493903e-05,0,0,6,5.6837019845592764e-05
2942,childs,6,1.1018717127493903e-05,0,0,6,5.6837019845592764e-05
2962,#actionsummit,6,1.1018717127493903e-05,0,0,6,5.6837019845592764e-05
3091,male,6,1.1018717127493903e-05,1,2.2780963315814773e-06,5,4.736418320466063e-05
3095,rent,6,1.1018717127493903e-05,5,1.1390481657907387e-05,1,9.472836640932127e-06
3100,sergeant,6,1.1018717127493903e-05,5,1.1390481657907387e-05,1,9.472836640932127e-06
3121,reads,6,1.1018717127493903e-05,4,9.11238532632591e-06,2,1.8945673281864254e-05
3180,surging,6,1.1018717127493903e-05,5,1.1390481657907387e-05,1,9.472836640932127e-06
3262,#gettalking,6,1.1018717127493903e-05,0,0,6,5.6837019845592764e-05
3271,foot,6,1.1018717127493903e-05,4,9.11238532632591e-06,2,1.8945673281864254e-05
3290,mandela,6,1.1018717127493903e-05,0,0,6,5.6837019845592764e-05
3337,hiv,6,1.1018717127493903e-05,3,6.8342889947444315e-06,3,2.8418509922796382e-05
3398,gather,6,1.1018717127493903e-05,5,1.1390481657907387e-05,1,9.472836640932127e-06
3419,stanley,6,1.1018717127493903e-05,4,9.11238532632591e-06,2,1.8945673281864254e-05
3435,bans,6,1.1018717127493903e-05,2,4.556192663162955e-06,4,3.789134656372851e-05
3480,reopen,6,1.1018717127493903e-05,4,9.11238532632591e-06,2,1.8945673281864254e-05
3482,@speakerboehner,6,1.1018717127493903e-05,0,0,6,5.6837019845592764e-05
3493,ceiling,6,1.1018717127493903e-05,3,6.8342889947444315e-06,3,2.8418509922796382e-05
3514,exchange,6,1.1018717127493903e-05,3,6.8342889947444315e-06,3,2.8418509922796382e-05
3537,forcing,6,1.1018717127493903e-05,4,9.11238532632591e-06,2,1.8945673281864254e-05
3551,argument,6,1.1018717127493903e-05,5,1.1390481657907387e-05,1,9.472836640932127e-06
3573,defunding,6,1.1018717127493903e-05,4,9.11238532632591e-06,2,1.8945673281864254e-05
3587,urgent,6,1.1018717127493903e-05,3,6.8342889947444315e-06,3,2.8418509922796382e-05
3633,rank,6,1.1018717127493903e-05,5,1.1390481657907387e-05,1,9.472836640932127e-06
3631,fame,6,1.1018717127493903e-05,5,1.1390481657907387e-05,1,9.472836640932127e-06
3632,liberate,6,1.1018717127493903e-05,5,1.1390481657907387e-05,1,9.472836640932127e-06
3638,unmatched,6,1.1018717127493903e-05,5,1.1390481657907387e-05,1,9.472836640932127e-06
3646,practice,6,1.1018717127493903e-05,5,1.1390481657907387e-05,1,9.472836640932127e-06
3662,bargain,6,1.1018717127493903e-05,3,6.8342889947444315e-06,3,2.8418509922796382e-05
3702,exists,6,1.1018717127493903e-05,4,9.11238532632591e-06,2,1.8945673281864254e-05
3730,feet,6,1.1018717127493903e-05,3,6.8342889947444315e-06,3,2.8418509922796382e-05
3753,default,6,1.1018717127493903e-05,4,9.11238532632591e-06,2,1.8945673281864254e-05
3764,sea,6,1.1018717127493903e-05,4,9.11238532632591e-06,2,1.8945673281864254e-05
3783,n,6,1.1018717127493903e-05,5,1.1390481657907387e-05,1,9.472836640932127e-06
3789,retire,6,1.1018717127493903e-05,5,1.1390481657907387e-05,1,9.472836640932127e-06
3885,enacted,6,1.1018717127493903e-05,4,9.11238532632591e-06,2,1.8945673281864254e-05
3895,#americanstory,6,1.1018717127493903e-05,0,0,6,5.6837019845592764e-05
3928,flat,6,1.1018717127493903e-05,3,6.8342889947444315e-06,3,2.8418509922796382e-05
4017,hears,6,1.1018717127493903e-05,2,4.556192663162955e-06,4,3.789134656372851e-05
4032,#imarch,6,1.1018717127493903e-05,0,0,6,5.6837019845592764e-05
4039,revenue,6,1.1018717127493903e-05,3,6.8342889947444315e-06,3,2.8418509922796382e-05
4069,38,6,1.1018717127493903e-05,2,4.556192663162955e-06,4,3.789134656372851e-05
4103,ct,6,1.1018717127493903e-05,0,0,6,5.6837019845592764e-05
4196,hook,6,1.1018717127493903e-05,5,1.1390481657907387e-05,1,9.472836640932127e-06
4213,snow,6,1.1018717127493903e-05,3,6.8342889947444315e-06,3,2.8418509922796382e-05
4240,struggling,6,1.1018717127493903e-05,0,0,6,5.6837019845592764e-05
4245,30000,6,1.1018717127493903e-05,2,4.556192663162955e-06,4,3.789134656372851e-05
4297,propose,6,1.1018717127493903e-05,4,9.11238532632591e-06,2,1.8945673281864254e-05
4301,sets,6,1.1018717127493903e-05,3,6.8342889947444315e-06,3,2.8418509922796382e-05
4385,bear,6,1.1018717127493903e-05,3,6.8342889947444315e-06,3,2.8418509922796382e-05
4473,olympics,6,1.1018717127493903e-05,4,9.11238532632591e-06,2,1.8945673281864254e-05
4484,#my2k,6,1.1018717127493903e-05,0,0,6,5.6837019845592764e-05
4492,extends,6,1.1018717127493903e-05,0,0,6,5.6837019845592764e-05
4513,bobby,6,1.1018717127493903e-05,5,1.1390481657907387e-05,1,9.472836640932127e-06
4570,raid,6,1.1018717127493903e-05,5,1.1390481657907387e-05,1,9.472836640932127e-06
4698,talents,6,1.1018717127493903e-05,4,9.11238532632591e-06,2,1.8945673281864254e-05
4732,stunning,6,1.1018717127493903e-05,5,1.1390481657907387e-05,1,9.472836640932127e-06
4773,cleveland,6,1.1018717127493903e-05,3,6.8342889947444315e-06,3,2.8418509922796382e-05
4780,delighted,6,1.1018717127493903e-05,2,4.556192663162955e-06,4,3.789134656372851e-05
4821,pulling,6,1.1018717127493903e-05,3,6.8342889947444315e-06,3,2.8418509922796382e-05
4834,prominent,6,1.1018717127493903e-05,5,1.1390481657907387e-05,1,9.472836640932127e-06
4894,sounded,6,1.1018717127493903e-05,5,1.1390481657907387e-05,1,9.472836640932127e-06
4965,coalition,6,1.1018717127493903e-05,5,1.1390481657907387e-05,1,9.472836640932127e-06
5011,explode,6,1.1018717127493903e-05,3,6.8342889947444315e-06,3,2.8418509922796382e-05
5055,donated,6,1.1018717127493903e-05,2,4.556192663162955e-06,4,3.789134656372851e-05
5144,rough,6,1.1018717127493903e-05,5,1.1390481657907387e-05,1,9.472836640932127e-06
5159,layoffs,6,1.1018717127493903e-05,1,2.2780963315814773e-06,5,4.736418320466063e-05
5170,laid,6,1.1018717127493903e-05,3,6.8342889947444315e-06,3,2.8418509922796382e-05
5264,gateway,6,1.1018717127493903e-05,3,6.8342889947444315e-06,3,2.8418509922796382e-05
5352,sometime,6,1.1018717127493903e-05,5,1.1390481657907387e-05,1,9.472836640932127e-06
5374,spot,6,1.1018717127493903e-05,5,1.1390481657907387e-05,1,9.472836640932127e-06
5393,hopeful,6,1.1018717127493903e-05,1,2.2780963315814773e-06,5,4.736418320466063e-05
5417,appreciated,6,1.1018717127493903e-05,5,1.1390481657907387e-05,1,9.472836640932127e-06
5539,sizes,6,1.1018717127493903e-05,3,6.8342889947444315e-06,3,2.8418509922796382e-05
5547,slash,6,1.1018717127493903e-05,5,1.1390481657907387e-05,1,9.472836640932127e-06
5623,tank,6,1.1018717127493903e-05,5,1.1390481657907387e-05,1,9.472836640932127e-06
5627,olympic,6,1.1018717127493903e-05,3,6.8342889947444315e-06,3,2.8418509922796382e-05
5644,expedited,6,1.1018717127493903e-05,5,1.1390481657907387e-05,1,9.472836640932127e-06
5709,prosper,6,1.1018717127493903e-05,5,1.1390481657907387e-05,1,9.472836640932127e-06
5735,co-founder,6,1.1018717127493903e-05,5,1.1390481657907387e-05,1,9.472836640932127e-06
5789,baby,6,1.1018717127493903e-05,4,9.11238532632591e-06,2,1.8945673281864254e-05
5826,disappoint,6,1.1018717127493903e-05,5,1.1390481657907387e-05,1,9.472836640932127e-06
5836,printed,6,1.1018717127493903e-05,4,9.11238532632591e-06,2,1.8945673281864254e-05
5870,emily,6,1.1018717127493903e-05,5,1.1390481657907387e-05,1,9.472836640932127e-06
5880,music,6,1.1018717127493903e-05,4,9.11238532632591e-06,2,1.8945673281864254e-05
5900,outsourcing,6,1.1018717127493903e-05,4,9.11238532632591e-06,2,1.8945673281864254e-05
5906,consolidate,6,1.1018717127493903e-05,0,0,6,5.6837019845592764e-05
6003,normandy,6,1.1018717127493903e-05,5,1.1390481657907387e-05,1,9.472836640932127e-06
6127,mill,6,1.1018717127493903e-05,2,4.556192663162955e-06,4,3.789134656372851e-05
6192,asian,6,1.1018717127493903e-05,5,1.1390481657907387e-05,1,9.472836640932127e-06
6208,inviting,6,1.1018717127493903e-05,4,9.11238532632591e-06,2,1.8945673281864254e-05
6226,cards,6,1.1018717127493903e-05,4,9.11238532632591e-06,2,1.8945673281864254e-05
6229,heat,6,1.1018717127493903e-05,4,9.11238532632591e-06,2,1.8945673281864254e-05
6251,#earthday2012,6,1.1018717127493903e-05,0,0,6,5.6837019845592764e-05
6304,joy,6,1.1018717127493903e-05,5,1.1390481657907387e-05,1,9.472836640932127e-06
6318,@mittromney,6,1.1018717127493903e-05,5,1.1390481657907387e-05,1,9.472836640932127e-06
6336,pump,6,1.1018717127493903e-05,3,6.8342889947444315e-06,3,2.8418509922796382e-05
6344,insider,6,1.1018717127493903e-05,2,4.556192663162955e-06,4,3.789134656372851e-05
6381,depending,6,1.1018717127493903e-05,5,1.1390481657907387e-05,1,9.472836640932127e-06
6463,academy,6,1.1018717127493903e-05,5,1.1390481657907387e-05,1,9.472836640932127e-06
6478,wrongfully,6,1.1018717127493903e-05,5,1.1390481657907387e-05,1,9.472836640932127e-06
6482,appreciates,6,1.1018717127493903e-05,5,1.1390481657907387e-05,1,9.472836640932127e-06
6555,groundbreaking,6,1.1018717127493903e-05,4,9.11238532632591e-06,2,1.8945673281864254e-05
6558,buddy,6,1.1018717127493903e-05,5,1.1390481657907387e-05,1,9.472836640932127e-06
6614,landmark,6,1.1018717127493903e-05,5,1.1390481657907387e-05,1,9.472836640932127e-06
6622,infographic,6,1.1018717127493903e-05,0,0,6,5.6837019845592764e-05
6695,xl,6,1.1018717127493903e-05,3,6.8342889947444315e-06,3,2.8418509922796382e-05
6734,spouses,6,1.1018717127493903e-05,5,1.1390481657907387e-05,1,9.472836640932127e-06
6770,contest,6,1.1018717127493903e-05,4,9.11238532632591e-06,2,1.8945673281864254e-05
6818,incomes,6,1.1018717127493903e-05,5,1.1390481657907387e-05,1,9.472836640932127e-06
6836,purchases,6,1.1018717127493903e-05,5,1.1390481657907387e-05,1,9.472836640932127e-06
6848,pieces,6,1.1018717127493903e-05,5,1.1390481657907387e-05,1,9.472836640932127e-06
6849,unemployed,6,1.1018717127493903e-05,1,2.2780963315814773e-06,5,4.736418320466063e-05
6965,chat,6,1.1018717127493903e-05,1,2.2780963315814773e-06,5,4.736418320466063e-05
7031,falls,6,1.1018717127493903e-05,5,1.1390481657907387e-05,1,9.472836640932127e-06
7060,ga,6,1.1018717127493903e-05,4,9.11238532632591e-06,2,1.8945673281864254e-05
7272,celebrated,6,1.1018717127493903e-05,5,1.1390481657907387e-05,1,9.472836640932127e-06
7332,sacrificing,6,1.1018717127493903e-05,4,9.11238532632591e-06,2,1.8945673281864254e-05
7365,rail,6,1.1018717127493903e-05,5,1.1390481657907387e-05,1,9.472836640932127e-06
7458,630,6,1.1018717127493903e-05,5,1.1390481657907387e-05,1,9.472836640932127e-06
7490,takeover,6,1.1018717127493903e-05,3,6.8342889947444315e-06,3,2.8418509922796382e-05
7492,gods,6,1.1018717127493903e-05,5,1.1390481657907387e-05,1,9.472836640932127e-06
7495,grieve,6,1.1018717127493903e-05,5,1.1390481657907387e-05,1,9.472836640932127e-06
7629,empower,6,1.1018717127493903e-05,5,1.1390481657907387e-05,1,9.472836640932127e-06
7640,coordinated,6,1.1018717127493903e-05,5,1.1390481657907387e-05,1,9.472836640932127e-06
7700,bridge,6,1.1018717127493903e-05,5,1.1390481657907387e-05,1,9.472836640932127e-06
7738,nominations,6,1.1018717127493903e-05,5,1.1390481657907387e-05,1,9.472836640932127e-06
7812,colleagues,6,1.1018717127493903e-05,5,1.1390481657907387e-05,1,9.472836640932127e-06
7896,sudan,6,1.1018717127493903e-05,6,1.3668577989488863e-05,0,0
7894,emirates,6,1.1018717127493903e-05,6,1.3668577989488863e-05,0,0
7903,shocking,6,1.1018717127493903e-05,6,1.3668577989488863e-05,0,0
7915,@sentedcruz,6,1.1018717127493903e-05,6,1.3668577989488863e-05,0,0
7945,suppress,6,1.1018717127493903e-05,6,1.3668577989488863e-05,0,0
7983,lock,6,1.1018717127493903e-05,6,1.3668577989488863e-05,0,0
8038,dump,6,1.1018717127493903e-05,6,1.3668577989488863e-05,0,0
8044,justin,6,1.1018717127493903e-05,6,1.3668577989488863e-05,0,0
8046,alternatives,6,1.1018717127493903e-05,6,1.3668577989488863e-05,0,0
8063,fcc,6,1.1018717127493903e-05,6,1.3668577989488863e-05,0,0
8076,legislatures,6,1.1018717127493903e-05,6,1.3668577989488863e-05,0,0
8097,communist,6,1.1018717127493903e-05,6,1.3668577989488863e-05,0,0
8136,betrayal,6,1.1018717127493903e-05,6,1.3668577989488863e-05,0,0
8139,compromised,6,1.1018717127493903e-05,6,1.3668577989488863e-05,0,0
8141,villages,6,1.1018717127493903e-05,6,1.3668577989488863e-05,0,0
8144,beirut,6,1.1018717127493903e-05,6,1.3668577989488863e-05,0,0
8149,lethal,6,1.1018717127493903e-05,6,1.3668577989488863e-05,0,0
8153,weakest,6,1.1018717127493903e-05,6,1.3668577989488863e-05,0,0
8172,75000000,6,1.1018717127493903e-05,6,1.3668577989488863e-05,0,0
8177,reversed,6,1.1018717127493903e-05,6,1.3668577989488863e-05,0,0
8203,agency,6,1.1018717127493903e-05,6,1.3668577989488863e-05,0,0
8260,decimated,6,1.1018717127493903e-05,6,1.3668577989488863e-05,0,0
8326,bailing,6,1.1018717127493903e-05,6,1.3668577989488863e-05,0,0
8338,ps,6,1.1018717127493903e-05,6,1.3668577989488863e-05,0,0
8339,threw,6,1.1018717127493903e-05,6,1.3668577989488863e-05,0,0
8353,@markmeadows,6,1.1018717127493903e-05,6,1.3668577989488863e-05,0,0
8369,disgusted,6,1.1018717127493903e-05,6,1.3668577989488863e-05,0,0
8376,spends,6,1.1018717127493903e-05,6,1.3668577989488863e-05,0,0
8413,lesley,6,1.1018717127493903e-05,6,1.3668577989488863e-05,0,0
8446,pat,6,1.1018717127493903e-05,6,1.3668577989488863e-05,0,0
8455,heal,6,1.1018717127493903e-05,6,1.3668577989488863e-05,0,0
8456,topic,6,1.1018717127493903e-05,6,1.3668577989488863e-05,0,0
8480,miracle,6,1.1018717127493903e-05,6,1.3668577989488863e-05,0,0
8483,discovered,6,1.1018717127493903e-05,6,1.3668577989488863e-05,0,0
8526,recommending,6,1.1018717127493903e-05,6,1.3668577989488863e-05,0,0
8527,regard,6,1.1018717127493903e-05,6,1.3668577989488863e-05,0,0
8530,loyalty,6,1.1018717127493903e-05,6,1.3668577989488863e-05,0,0
8558,confirming,6,1.1018717127493903e-05,6,1.3668577989488863e-05,0,0
8560,column,6,1.1018717127493903e-05,6,1.3668577989488863e-05,0,0
8563,fitton,6,1.1018717127493903e-05,6,1.3668577989488863e-05,0,0
8591,carrying,6,1.1018717127493903e-05,6,1.3668577989488863e-05,0,0
8629,nicole,6,1.1018717127493903e-05,6,1.3668577989488863e-05,0,0
8682,fabrication,6,1.1018717127493903e-05,6,1.3668577989488863e-05,0,0
8738,stealing,6,1.1018717127493903e-05,6,1.3668577989488863e-05,0,0
8743,owned,6,1.1018717127493903e-05,6,1.3668577989488863e-05,0,0
8775,hills,6,1.1018717127493903e-05,6,1.3668577989488863e-05,0,0
8794,mollie,6,1.1018717127493903e-05,6,1.3668577989488863e-05,0,0
8842,clause,6,1.1018717127493903e-05,6,1.3668577989488863e-05,0,0
8850,grave,6,1.1018717127493903e-05,6,1.3668577989488863e-05,0,0
8859,documented,6,1.1018717127493903e-05,6,1.3668577989488863e-05,0,0
8864,provision,6,1.1018717127493903e-05,6,1.3668577989488863e-05,0,0
8888,@google,6,1.1018717127493903e-05,6,1.3668577989488863e-05,0,0
8921,abuses,6,1.1018717127493903e-05,6,1.3668577989488863e-05,0,0
8947,hack,6,1.1018717127493903e-05,6,1.3668577989488863e-05,0,0
8951,separate,6,1.1018717127493903e-05,6,1.3668577989488863e-05,0,0
9025,snyder,6,1.1018717127493903e-05,6,1.3668577989488863e-05,0,0
9088,730,6,1.1018717127493903e-05,6,1.3668577989488863e-05,0,0
9150,prisoner,6,1.1018717127493903e-05,6,1.3668577989488863e-05,0,0
9175,elite,6,1.1018717127493903e-05,6,1.3668577989488863e-05,0,0
9235,assured,6,1.1018717127493903e-05,6,1.3668577989488863e-05,0,0
9240,illegitimate,6,1.1018717127493903e-05,6,1.3668577989488863e-05,0,0
9266,sovereignty,6,1.1018717127493903e-05,6,1.3668577989488863e-05,0,0
9267,western,6,1.1018717127493903e-05,6,1.3668577989488863e-05,0,0
9282,idlib,6,1.1018717127493903e-05,6,1.3668577989488863e-05,0,0
9283,province,6,1.1018717127493903e-05,6,1.3668577989488863e-05,0,0
9310,packing,6,1.1018717127493903e-05,6,1.3668577989488863e-05,0,0
9348,scotland,6,1.1018717127493903e-05,6,1.3668577989488863e-05,0,0
9351,turmoil,6,1.1018717127493903e-05,6,1.3668577989488863e-05,0,0
9378,jordan,6,1.1018717127493903e-05,6,1.3668577989488863e-05,0,0
9389,powerhouse,6,1.1018717127493903e-05,6,1.3668577989488863e-05,0,0
9411,rip,6,1.1018717127493903e-05,6,1.3668577989488863e-05,0,0
9522,prosecution,6,1.1018717127493903e-05,6,1.3668577989488863e-05,0,0
9536,los,6,1.1018717127493903e-05,6,1.3668577989488863e-05,0,0
9556,eradicate,6,1.1018717127493903e-05,6,1.3668577989488863e-05,0,0
9567,distribution,6,1.1018717127493903e-05,6,1.3668577989488863e-05,0,0
9569,spain,6,1.1018717127493903e-05,6,1.3668577989488863e-05,0,0
9624,timing,6,1.1018717127493903e-05,6,1.3668577989488863e-05,0,0
9628,#scotus,6,1.1018717127493903e-05,6,1.3668577989488863e-05,0,0
9641,finale,6,1.1018717127493903e-05,6,1.3668577989488863e-05,0,0
9653,rockets,6,1.1018717127493903e-05,6,1.3668577989488863e-05,0,0
9664,beautifully,6,1.1018717127493903e-05,6,1.3668577989488863e-05,0,0
9717,lawless,6,1.1018717127493903e-05,6,1.3668577989488863e-05,0,0
9727,k,6,1.1018717127493903e-05,6,1.3668577989488863e-05,0,0
9734,smooth,6,1.1018717127493903e-05,6,1.3668577989488863e-05,0,0
9891,dispute,6,1.1018717127493903e-05,6,1.3668577989488863e-05,0,0
9905,thom,6,1.1018717127493903e-05,6,1.3668577989488863e-05,0,0
9906,joni,6,1.1018717127493903e-05,6,1.3668577989488863e-05,0,0
9912,non-existent,6,1.1018717127493903e-05,6,1.3668577989488863e-05,0,0
10004,rig,6,1.1018717127493903e-05,6,1.3668577989488863e-05,0,0
10025,improvement,6,1.1018717127493903e-05,6,1.3668577989488863e-05,0,0
10035,suspend,6,1.1018717127493903e-05,6,1.3668577989488863e-05,0,0
10041,valor,6,1.1018717127493903e-05,6,1.3668577989488863e-05,0,0
10091,@sencorygardner,6,1.1018717127493903e-05,6,1.3668577989488863e-05,0,0
10100,grounds,6,1.1018717127493903e-05,6,1.3668577989488863e-05,0,0
10107,wiped,6,1.1018717127493903e-05,6,1.3668577989488863e-05,0,0
10119,wifes,6,1.1018717127493903e-05,6,1.3668577989488863e-05,0,0
10188,quoting,6,1.1018717127493903e-05,6,1.3668577989488863e-05,0,0
10210,stein,6,1.1018717127493903e-05,6,1.3668577989488863e-05,0,0
10217,@senatortimscott,6,1.1018717127493903e-05,6,1.3668577989488863e-05,0,0
10264,towns,6,1.1018717127493903e-05,6,1.3668577989488863e-05,0,0
10294,grossly,6,1.1018717127493903e-05,6,1.3668577989488863e-05,0,0
10305,diego,6,1.1018717127493903e-05,6,1.3668577989488863e-05,0,0
10347,cdc,6,1.1018717127493903e-05,6,1.3668577989488863e-05,0,0
10352,edge,6,1.1018717127493903e-05,6,1.3668577989488863e-05,0,0
10356,idaho,6,1.1018717127493903e-05,6,1.3668577989488863e-05,0,0
10365,lately,6,1.1018717127493903e-05,6,1.3668577989488863e-05,0,0
10368,tigers,6,1.1018717127493903e-05,6,1.3668577989488863e-05,0,0
10372,surge,6,1.1018717127493903e-05,6,1.3668577989488863e-05,0,0
10407,lemon,6,1.1018717127493903e-05,6,1.3668577989488863e-05,0,0
10438,notified,6,1.1018717127493903e-05,6,1.3668577989488863e-05,0,0
10473,warrant,6,1.1018717127493903e-05,6,1.3668577989488863e-05,0,0
10477,2021,6,1.1018717127493903e-05,6,1.3668577989488863e-05,0,0
10511,demeaning,6,1.1018717127493903e-05,6,1.3668577989488863e-05,0,0
10513,figured,6,1.1018717127493903e-05,6,1.3668577989488863e-05,0,0
10524,offense,6,1.1018717127493903e-05,6,1.3668577989488863e-05,0,0
10550,#ga06,6,1.1018717127493903e-05,6,1.3668577989488863e-05,0,0
10564,consultants,6,1.1018717127493903e-05,6,1.3668577989488863e-05,0,0
10587,330,6,1.1018717127493903e-05,6,1.3668577989488863e-05,0,0
10611,11000,6,1.1018717127493903e-05,6,1.3668577989488863e-05,0,0
10631,recommend,6,1.1018717127493903e-05,6,1.3668577989488863e-05,0,0
10737,endorsing,6,1.1018717127493903e-05,6,1.3668577989488863e-05,0,0
10754,contempt,6,1.1018717127493903e-05,6,1.3668577989488863e-05,0,0
10782,similar,6,1.1018717127493903e-05,6,1.3668577989488863e-05,0,0
10802,pol,6,1.1018717127493903e-05,6,1.3668577989488863e-05,0,0
10806,laugh,6,1.1018717127493903e-05,6,1.3668577989488863e-05,0,0
10820,garcia,6,1.1018717127493903e-05,6,1.3668577989488863e-05,0,0
10855,deterrent,6,1.1018717127493903e-05,6,1.3668577989488863e-05,0,0
10902,lloyd,6,1.1018717127493903e-05,6,1.3668577989488863e-05,0,0
10951,deface,6,1.1018717127493903e-05,6,1.3668577989488863e-05,0,0
10968,automobile,6,1.1018717127493903e-05,6,1.3668577989488863e-05,0,0
10985,tammy,6,1.1018717127493903e-05,6,1.3668577989488863e-05,0,0
11030,origins,6,1.1018717127493903e-05,6,1.3668577989488863e-05,0,0
11065,courthouse,6,1.1018717127493903e-05,6,1.3668577989488863e-05,0,0
11076,supplies,6,1.1018717127493903e-05,6,1.3668577989488863e-05,0,0
11106,relative,6,1.1018717127493903e-05,6,1.3668577989488863e-05,0,0
11200,cancelled,6,1.1018717127493903e-05,6,1.3668577989488863e-05,0,0
11236,crown,6,1.1018717127493903e-05,6,1.3668577989488863e-05,0,0
11270,obiden,6,1.1018717127493903e-05,6,1.3668577989488863e-05,0,0
11296,wray,6,1.1018717127493903e-05,6,1.3668577989488863e-05,0,0
11302,scorned,6,1.1018717127493903e-05,6,1.3668577989488863e-05,0,0
11313,manchester,6,1.1018717127493903e-05,6,1.3668577989488863e-05,0,0
11324,nut,6,1.1018717127493903e-05,6,1.3668577989488863e-05,0,0
11341,legend,6,1.1018717127493903e-05,6,1.3668577989488863e-05,0,0
11360,liars,6,1.1018717127493903e-05,6,1.3668577989488863e-05,0,0
11361,@katiepavlich,6,1.1018717127493903e-05,6,1.3668577989488863e-05,0,0
11366,@jairbolsonaro,6,1.1018717127493903e-05,6,1.3668577989488863e-05,0,0
11375,stating,6,1.1018717127493903e-05,6,1.3668577989488863e-05,0,0
11437,@joesquawk,6,1.1018717127493903e-05,6,1.3668577989488863e-05,0,0
11479,conclusively,6,1.1018717127493903e-05,6,1.3668577989488863e-05,0,0
11503,concept,6,1.1018717127493903e-05,6,1.3668577989488863e-05,0,0
11513,envoy,6,1.1018717127493903e-05,6,1.3668577989488863e-05,0,0
11514,ireland,6,1.1018717127493903e-05,6,1.3668577989488863e-05,0,0
11522,djt,6,1.1018717127493903e-05,6,1.3668577989488863e-05,0,0
11574,fulfilling,6,1.1018717127493903e-05,6,1.3668577989488863e-05,0,0
11667,elements,6,1.1018717127493903e-05,6,1.3668577989488863e-05,0,0
11679,journalist,6,1.1018717127493903e-05,6,1.3668577989488863e-05,0,0
11689,@jimhagedornmn,6,1.1018717127493903e-05,6,1.3668577989488863e-05,0,0
11713,spewing,6,1.1018717127493903e-05,6,1.3668577989488863e-05,0,0
11760,g7,6,1.1018717127493903e-05,6,1.3668577989488863e-05,0,0
11764,clients,6,1.1018717127493903e-05,6,1.3668577989488863e-05,0,0
11784,ships,6,1.1018717127493903e-05,6,1.3668577989488863e-05,0,0
11816,prosecutorial,6,1.1018717127493903e-05,6,1.3668577989488863e-05,0,0
11855,produces,6,1.1018717127493903e-05,6,1.3668577989488863e-05,0,0
11858,signal,6,1.1018717127493903e-05,6,1.3668577989488863e-05,0,0
11889,ballistic,6,1.1018717127493903e-05,6,1.3668577989488863e-05,0,0
11909,seemingly,6,1.1018717127493903e-05,6,1.3668577989488863e-05,0,0
11963,delays,6,1.1018717127493903e-05,6,1.3668577989488863e-05,0,0
11979,blows,6,1.1018717127493903e-05,6,1.3668577989488863e-05,0,0
12002,interfering,6,1.1018717127493903e-05,6,1.3668577989488863e-05,0,0
12054,restoration,6,1.1018717127493903e-05,6,1.3668577989488863e-05,0,0
12071,civilization,6,1.1018717127493903e-05,6,1.3668577989488863e-05,0,0
12100,accepting,6,1.1018717127493903e-05,6,1.3668577989488863e-05,0,0
12192,arnold,6,1.1018717127493903e-05,6,1.3668577989488863e-05,0,0
12195,@nascar,6,1.1018717127493903e-05,6,1.3668577989488863e-05,0,0
12194,@marcorubio,6,1.1018717127493903e-05,6,1.3668577989488863e-05,0,0
12206,clowns,6,1.1018717127493903e-05,6,1.3668577989488863e-05,0,0
12211,band,6,1.1018717127493903e-05,6,1.3668577989488863e-05,0,0
12246,mocked,6,1.1018717127493903e-05,6,1.3668577989488863e-05,0,0
12315,misled,6,1.1018717127493903e-05,6,1.3668577989488863e-05,0,0
12314,mccabes,6,1.1018717127493903e-05,6,1.3668577989488863e-05,0,0
12375,nypd,6,1.1018717127493903e-05,6,1.3668577989488863e-05,0,0
12395,feds,6,1.1018717127493903e-05,6,1.3668577989488863e-05,0,0
12428,poured,6,1.1018717127493903e-05,6,1.3668577989488863e-05,0,0
12460,responded,6,1.1018717127493903e-05,6,1.3668577989488863e-05,0,0
12495,unbelievably,6,1.1018717127493903e-05,6,1.3668577989488863e-05,0,0
12539,foreperson,6,1.1018717127493903e-05,6,1.3668577989488863e-05,0,0
12549,suing,6,1.1018717127493903e-05,6,1.3668577989488863e-05,0,0
12560,connect,6,1.1018717127493903e-05,6,1.3668577989488863e-05,0,0
12780,grid,6,1.1018717127493903e-05,6,1.3668577989488863e-05,0,0
12791,professionally,6,1.1018717127493903e-05,6,1.3668577989488863e-05,0,0
12821,comfort,6,1.1018717127493903e-05,6,1.3668577989488863e-05,0,0
12845,competing,6,1.1018717127493903e-05,6,1.3668577989488863e-05,0,0
12898,cooper,6,1.1018717127493903e-05,6,1.3668577989488863e-05,0,0
12906,file,6,1.1018717127493903e-05,6,1.3668577989488863e-05,0,0
12926,ap,6,1.1018717127493903e-05,6,1.3668577989488863e-05,0,0
12943,infected,6,1.1018717127493903e-05,6,1.3668577989488863e-05,0,0
13109,upward,6,1.1018717127493903e-05,6,1.3668577989488863e-05,0,0
13150,flunky,6,1.1018717127493903e-05,6,1.3668577989488863e-05,0,0
13177,infested,6,1.1018717127493903e-05,6,1.3668577989488863e-05,0,0
13198,federalist,6,1.1018717127493903e-05,6,1.3668577989488863e-05,0,0
13277,decisive,6,1.1018717127493903e-05,6,1.3668577989488863e-05,0,0
13299,universities,6,1.1018717127493903e-05,6,1.3668577989488863e-05,0,0
13347,heights,6,1.1018717127493903e-05,6,1.3668577989488863e-05,0,0
13374,kate,6,1.1018717127493903e-05,6,1.3668577989488863e-05,0,0
13392,bid,6,1.1018717127493903e-05,6,1.3668577989488863e-05,0,0
13419,topics,6,1.1018717127493903e-05,6,1.3668577989488863e-05,0,0
13438,eternal,6,1.1018717127493903e-05,6,1.3668577989488863e-05,0,0
13459,भारत,6,1.1018717127493903e-05,6,1.3668577989488863e-05,0,0
13782,unsuccessfully,6,1.1018717127493903e-05,6,1.3668577989488863e-05,0,0
13872,lordstown,6,1.1018717127493903e-05,6,1.3668577989488863e-05,0,0
13927,draining,6,1.1018717127493903e-05,6,1.3668577989488863e-05,0,0
13971,slammed,6,1.1018717127493903e-05,6,1.3668577989488863e-05,0,0
13990,@repratcliffe,6,1.1018717127493903e-05,6,1.3668577989488863e-05,0,0
13994,duluth,6,1.1018717127493903e-05,6,1.3668577989488863e-05,0,0
13998,bombed,6,1.1018717127493903e-05,6,1.3668577989488863e-05,0,0
14074,dumping,6,1.1018717127493903e-05,6,1.3668577989488863e-05,0,0
14087,championship,6,1.1018717127493903e-05,6,1.3668577989488863e-05,0,0
14097,pumping,6,1.1018717127493903e-05,6,1.3668577989488863e-05,0,0
14187,agreeing,6,1.1018717127493903e-05,6,1.3668577989488863e-05,0,0
14284,@senschumer,6,1.1018717127493903e-05,6,1.3668577989488863e-05,0,0
14324,herman,6,1.1018717127493903e-05,6,1.3668577989488863e-05,0,0
14403,dale,6,1.1018717127493903e-05,6,1.3668577989488863e-05,0,0
14444,sam,6,1.1018717127493903e-05,6,1.3668577989488863e-05,0,0
14569,grief,6,1.1018717127493903e-05,6,1.3668577989488863e-05,0,0
14666,withdrawn,6,1.1018717127493903e-05,6,1.3668577989488863e-05,0,0
14669,commander-in-chiefs,6,1.1018717127493903e-05,6,1.3668577989488863e-05,0,0
14786,@speakerryan,6,1.1018717127493903e-05,6,1.3668577989488863e-05,0,0
14850,assad,6,1.1018717127493903e-05,6,1.3668577989488863e-05,0,0
14964,e-mails,6,1.1018717127493903e-05,6,1.3668577989488863e-05,0,0
14988,vetting,6,1.1018717127493903e-05,6,1.3668577989488863e-05,0,0
15045,7pme,6,1.1018717127493903e-05,6,1.3668577989488863e-05,0,0
15141,imploding,6,1.1018717127493903e-05,6,1.3668577989488863e-05,0,0
15255,cruz,6,1.1018717127493903e-05,6,1.3668577989488863e-05,0,0
15347,irma,6,1.1018717127493903e-05,6,1.3668577989488863e-05,0,0
15426,disruption,6,1.1018717127493903e-05,6,1.3668577989488863e-05,0,0
15433,category,6,1.1018717127493903e-05,6,1.3668577989488863e-05,0,0
15444,@icegov,6,1.1018717127493903e-05,6,1.3668577989488863e-05,0,0
15575,involving,6,1.1018717127493903e-05,6,1.3668577989488863e-05,0,0
15599,collude,6,1.1018717127493903e-05,6,1.3668577989488863e-05,0,0
15614,andrews,6,1.1018717127493903e-05,6,1.3668577989488863e-05,0,0
15654,chancellor,6,1.1018717127493903e-05,6,1.3668577989488863e-05,0,0
15736,killings,6,1.1018717127493903e-05,6,1.3668577989488863e-05,0,0
15863,brussels,6,1.1018717127493903e-05,6,1.3668577989488863e-05,0,0
15897,manuel,6,1.1018717127493903e-05,6,1.3668577989488863e-05,0,0
15912,christian,6,1.1018717127493903e-05,6,1.3668577989488863e-05,0,0
15981,ninth,6,1.1018717127493903e-05,6,1.3668577989488863e-05,0,0
16058,libel,6,1.1018717127493903e-05,6,1.3668577989488863e-05,0,0
16193,length,6,1.1018717127493903e-05,6,1.3668577989488863e-05,0,0
16303,sleazebag,6,1.1018717127493903e-05,6,1.3668577989488863e-05,0,0
16313,belittle,6,1.1018717127493903e-05,6,1.3668577989488863e-05,0,0
16385,strassel,6,1.1018717127493903e-05,6,1.3668577989488863e-05,0,0
16460,schneiderman,6,1.1018717127493903e-05,6,1.3668577989488863e-05,0,0
16485,cages,6,1.1018717127493903e-05,6,1.3668577989488863e-05,0,0
16495,lovely,6,1.1018717127493903e-05,6,1.3668577989488863e-05,0,0
16530,@armywpfootball,6,1.1018717127493903e-05,6,1.3668577989488863e-05,0,0
16554,rosenstein,6,1.1018717127493903e-05,6,1.3668577989488863e-05,0,0
16613,resolved,6,1.1018717127493903e-05,6,1.3668577989488863e-05,0,0
16657,legislate,6,1.1018717127493903e-05,6,1.3668577989488863e-05,0,0
16802,accuser,6,1.1018717127493903e-05,6,1.3668577989488863e-05,0,0
16814,walker,6,1.1018717127493903e-05,6,1.3668577989488863e-05,0,0
16902,concluded,6,1.1018717127493903e-05,6,1.3668577989488863e-05,0,0
16925,mexicos,6,1.1018717127493903e-05,6,1.3668577989488863e-05,0,0
16944,beto,6,1.1018717127493903e-05,6,1.3668577989488863e-05,0,0
16970,dobbs,6,1.1018717127493903e-05,6,1.3668577989488863e-05,0,0
17102,feinstein,6,1.1018717127493903e-05,6,1.3668577989488863e-05,0,0
17104,proves,6,1.1018717127493903e-05,6,1.3668577989488863e-05,0,0
17158,requirements,6,1.1018717127493903e-05,6,1.3668577989488863e-05,0,0
17165,burr,6,1.1018717127493903e-05,6,1.3668577989488863e-05,0,0
17192,operative,6,1.1018717127493903e-05,6,1.3668577989488863e-05,0,0
17249,cook,6,1.1018717127493903e-05,6,1.3668577989488863e-05,0,0
17288,@tomfitton,6,1.1018717127493903e-05,6,1.3668577989488863e-05,0,0
17379,cox,6,1.1018717127493903e-05,6,1.3668577989488863e-05,0,0
17394,oversight,6,1.1018717127493903e-05,6,1.3668577989488863e-05,0,0
17409,nelly,6,1.1018717127493903e-05,6,1.3668577989488863e-05,0,0
17626,helsinki,6,1.1018717127493903e-05,6,1.3668577989488863e-05,0,0
17643,151,6,1.1018717127493903e-05,6,1.3668577989488863e-05,0,0
17658,surplus,6,1.1018717127493903e-05,6,1.3668577989488863e-05,0,0
17681,harley-davidson,6,1.1018717127493903e-05,6,1.3668577989488863e-05,0,0
17684,launches,6,1.1018717127493903e-05,6,1.3668577989488863e-05,0,0
18044,haspel,6,1.1018717127493903e-05,6,1.3668577989488863e-05,0,0
18079,#takebackday,6,1.1018717127493903e-05,6,1.3668577989488863e-05,0,0
18116,setup,6,1.1018717127493903e-05,6,1.3668577989488863e-05,0,0
18195,traditional,6,1.1018717127493903e-05,6,1.3668577989488863e-05,0,0
18295,underlying,6,1.1018717127493903e-05,6,1.3668577989488863e-05,0,0
18534,#wef18,6,1.1018717127493903e-05,6,1.3668577989488863e-05,0,0
18704,pressured,6,1.1018717127493903e-05,6,1.3668577989488863e-05,0,0
18720,@kimstrassel,6,1.1018717127493903e-05,6,1.3668577989488863e-05,0,0
18778,gallagher,6,1.1018717127493903e-05,6,1.3668577989488863e-05,0,0
18786,cameron,6,1.1018717127493903e-05,6,1.3668577989488863e-05,0,0
18948,@billhemmer,6,1.1018717127493903e-05,6,1.3668577989488863e-05,0,0
19148,congenial,6,1.1018717127493903e-05,6,1.3668577989488863e-05,0,0
19172,membership,6,1.1018717127493903e-05,6,1.3668577989488863e-05,0,0
19404,drone,6,1.1018717127493903e-05,6,1.3668577989488863e-05,0,0
19729,non-tariffed,6,1.1018717127493903e-05,6,1.3668577989488863e-05,0,0
19974,detention,6,1.1018717127493903e-05,6,1.3668577989488863e-05,0,0
20408,apprehending,6,1.1018717127493903e-05,6,1.3668577989488863e-05,0,0
20748,zealand,6,1.1018717127493903e-05,6,1.3668577989488863e-05,0,0
108,closes,5,9.182264272911586e-06,4,9.11238532632591e-06,1,9.472836640932127e-06
148,cruise,5,9.182264272911586e-06,3,6.8342889947444315e-06,2,1.8945673281864254e-05
177,#unitedonclimate,5,9.182264272911586e-06,0,0,5,4.736418320466063e-05
218,180,5,9.182264272911586e-06,4,9.11238532632591e-06,1,9.472836640932127e-06
334,record-breaking,5,9.182264272911586e-06,0,0,5,4.736418320466063e-05
349,gathering,5,9.182264272911586e-06,4,9.11238532632591e-06,1,9.472836640932127e-06
359,tripled,5,9.182264272911586e-06,1,2.2780963315814773e-06,4,3.789134656372851e-05
367,dance,5,9.182264272911586e-06,0,0,5,4.736418320466063e-05
388,#ofafallsummit,5,9.182264272911586e-06,0,0,5,4.736418320466063e-05
442,shipping,5,9.182264272911586e-06,3,6.8342889947444315e-06,2,1.8945673281864254e-05
502,halloween,5,9.182264272911586e-06,1,2.2780963315814773e-06,4,3.789134656372851e-05
595,denial,5,9.182264272911586e-06,0,0,5,4.736418320466063e-05
603,#switchtoclean,5,9.182264272911586e-06,0,0,5,4.736418320466063e-05
632,grown,5,9.182264272911586e-06,2,4.556192663162955e-06,3,2.8418509922796382e-05
719,boosting,5,9.182264272911586e-06,2,4.556192663162955e-06,3,2.8418509922796382e-05
745,reliable,5,9.182264272911586e-06,3,6.8342889947444315e-06,2,1.8945673281864254e-05
782,grit,5,9.182264272911586e-06,4,9.11238532632591e-06,1,9.472836640932127e-06
797,66,5,9.182264272911586e-06,3,6.8342889947444315e-06,2,1.8945673281864254e-05
839,@natlparkservice,5,9.182264272911586e-06,4,9.11238532632591e-06,1,9.472836640932127e-06
890,lowered,5,9.182264272911586e-06,4,9.11238532632591e-06,1,9.472836640932127e-06
897,lifeline,5,9.182264272911586e-06,1,2.2780963315814773e-06,4,3.789134656372851e-05
907,provides,5,9.182264272911586e-06,3,6.8342889947444315e-06,2,1.8945673281864254e-05
937,pursuit,5,9.182264272911586e-06,4,9.11238532632591e-06,1,9.472836640932127e-06
976,justify,5,9.182264272911586e-06,4,9.11238532632591e-06,1,9.472836640932127e-06
975,diplomatic,5,9.182264272911586e-06,4,9.11238532632591e-06,1,9.472836640932127e-06
989,invade,5,9.182264272911586e-06,4,9.11238532632591e-06,1,9.472836640932127e-06
991,#44turns54,5,9.182264272911586e-06,0,0,5,4.736418320466063e-05
1059,laying,5,9.182264272911586e-06,1,2.2780963315814773e-06,4,3.789134656372851e-05
1113,bars,5,9.182264272911586e-06,4,9.11238532632591e-06,1,9.472836640932127e-06
1249,mammograms,5,9.182264272911586e-06,0,0,5,4.736418320466063e-05
1366,63,5,9.182264272911586e-06,2,4.556192663162955e-06,3,2.8418509922796382e-05
1489,warning,5,9.182264272911586e-06,4,9.11238532632591e-06,1,9.472836640932127e-06
1511,hosts,5,9.182264272911586e-06,3,6.8342889947444315e-06,2,1.8945673281864254e-05
1515,surrender,5,9.182264272911586e-06,4,9.11238532632591e-06,1,9.472836640932127e-06
1543,risks,5,9.182264272911586e-06,1,2.2780963315814773e-06,4,3.789134656372851e-05
1551,enrich,5,9.182264272911586e-06,4,9.11238532632591e-06,1,9.472836640932127e-06
1564,holds,5,9.182264272911586e-06,3,6.8342889947444315e-06,2,1.8945673281864254e-05
1562,#equalpaynow,5,9.182264272911586e-06,0,0,5,4.736418320466063e-05
1611,patient,5,9.182264272911586e-06,3,6.8342889947444315e-06,2,1.8945673281864254e-05
1627,ports,5,9.182264272911586e-06,4,9.11238532632591e-06,1,9.472836640932127e-06
1639,#whsciencefair,5,9.182264272911586e-06,0,0,5,4.736418320466063e-05
1662,builds,5,9.182264272911586e-06,2,4.556192663162955e-06,3,2.8418509922796382e-05
1667,bracket,5,9.182264272911586e-06,0,0,5,4.736418320466063e-05
1673,rendered,5,9.182264272911586e-06,2,4.556192663162955e-06,3,2.8418509922796382e-05
1689,organized,5,9.182264272911586e-06,4,9.11238532632591e-06,1,9.472836640932127e-06
1697,scholarships,5,9.182264272911586e-06,0,0,5,4.736418320466063e-05
1727,requires,5,9.182264272911586e-06,0,0,5,4.736418320466063e-05
1769,@fcc,5,9.182264272911586e-06,2,4.556192663162955e-06,3,2.8418509922796382e-05
1822,picking,5,9.182264272911586e-06,2,4.556192663162955e-06,3,2.8418509922796382e-05
1827,59,5,9.182264272911586e-06,2,4.556192663162955e-06,3,2.8418509922796382e-05
1833,1997,5,9.182264272911586e-06,4,9.11238532632591e-06,1,9.472836640932127e-06
1860,sun,5,9.182264272911586e-06,1,2.2780963315814773e-06,4,3.789134656372851e-05
1859,shining,5,9.182264272911586e-06,3,6.8342889947444315e-06,2,1.8945673281864254e-05
1940,privacy,5,9.182264272911586e-06,2,4.556192663162955e-06,3,2.8418509922796382e-05
2005,@business,5,9.182264272911586e-06,4,9.11238532632591e-06,1,9.472836640932127e-06
2081,latino,5,9.182264272911586e-06,1,2.2780963315814773e-06,4,3.789134656372851e-05
2110,lanes,5,9.182264272911586e-06,4,9.11238532632591e-06,1,9.472836640932127e-06
2123,jackie,5,9.182264272911586e-06,3,6.8342889947444315e-06,2,1.8945673281864254e-05
2140,ideals,5,9.182264272911586e-06,1,2.2780963315814773e-06,4,3.789134656372851e-05
2167,heartbreaking,5,9.182264272911586e-06,3,6.8342889947444315e-06,2,1.8945673281864254e-05
2223,preschool,5,9.182264272911586e-06,0,0,5,4.736418320466063e-05
2231,thrives,5,9.182264272911586e-06,1,2.2780963315814773e-06,4,3.789134656372851e-05
2303,addressed,5,9.182264272911586e-06,3,6.8342889947444315e-06,2,1.8945673281864254e-05
2307,conspired,5,9.182264272911586e-06,4,9.11238532632591e-06,1,9.472836640932127e-06
2327,accomplish,5,9.182264272911586e-06,3,6.8342889947444315e-06,2,1.8945673281864254e-05
2337,gender,5,9.182264272911586e-06,0,0,5,4.736418320466063e-05
2359,chicagos,5,9.182264272911586e-06,4,9.11238532632591e-06,1,9.472836640932127e-06
2364,2002,5,9.182264272911586e-06,2,4.556192663162955e-06,3,2.8418509922796382e-05
2407,overcome,5,9.182264272911586e-06,4,9.11238532632591e-06,1,9.472836640932127e-06
2559,commend,5,9.182264272911586e-06,4,9.11238532632591e-06,1,9.472836640932127e-06
2567,cheering,5,9.182264272911586e-06,2,4.556192663162955e-06,3,2.8418509922796382e-05
2646,decides,5,9.182264272911586e-06,3,6.8342889947444315e-06,2,1.8945673281864254e-05
2692,enduring,5,9.182264272911586e-06,3,6.8342889947444315e-06,2,1.8945673281864254e-05
2718,marking,5,9.182264272911586e-06,2,4.556192663162955e-06,3,2.8418509922796382e-05
2726,trailer,5,9.182264272911586e-06,0,0,5,4.736418320466063e-05
2725,dangerously,5,9.182264272911586e-06,1,2.2780963315814773e-06,4,3.789134656372851e-05
2749,earns,5,9.182264272911586e-06,1,2.2780963315814773e-06,4,3.789134656372851e-05
2757,elses,5,9.182264272911586e-06,3,6.8342889947444315e-06,2,1.8945673281864254e-05
2776,attempts,5,9.182264272911586e-06,3,6.8342889947444315e-06,2,1.8945673281864254e-05
2778,dismantle,5,9.182264272911586e-06,4,9.11238532632591e-06,1,9.472836640932127e-06
2824,ofa,5,9.182264272911586e-06,0,0,5,4.736418320466063e-05
2850,331,5,9.182264272911586e-06,4,9.11238532632591e-06,1,9.472836640932127e-06
2892,marched,5,9.182264272911586e-06,0,0,5,4.736418320466063e-05
2895,educated,5,9.182264272911586e-06,4,9.11238532632591e-06,1,9.472836640932127e-06
2908,noticed,5,9.182264272911586e-06,4,9.11238532632591e-06,1,9.472836640932127e-06
2918,suddenly,5,9.182264272911586e-06,1,2.2780963315814773e-06,4,3.789134656372851e-05
2929,creativity,5,9.182264272911586e-06,0,0,5,4.736418320466063e-05
2931,innovative,5,9.182264272911586e-06,3,6.8342889947444315e-06,2,1.8945673281864254e-05
2983,claire,5,9.182264272911586e-06,4,9.11238532632591e-06,1,9.472836640932127e-06
3000,distance,5,9.182264272911586e-06,4,9.11238532632591e-06,1,9.472836640932127e-06
3001,trucks,5,9.182264272911586e-06,4,9.11238532632591e-06,1,9.472836640932127e-06
3033,backstage,5,9.182264272911586e-06,0,0,5,4.736418320466063e-05
3050,#outinthecold,5,9.182264272911586e-06,0,0,5,4.736418320466063e-05
3109,expire,5,9.182264272911586e-06,1,2.2780963315814773e-06,4,3.789134656372851e-05
3184,visits,5,9.182264272911586e-06,2,4.556192663162955e-06,3,2.8418509922796382e-05
3189,contraception,5,9.182264272911586e-06,0,0,5,4.736418320466063e-05
3211,kicks,5,9.182264272911586e-06,0,0,5,4.736418320466063e-05
3221,#throwbackthursday,5,9.182264272911586e-06,0,0,5,4.736418320466063e-05
3235,corner,5,9.182264272911586e-06,3,6.8342889947444315e-06,2,1.8945673281864254e-05
3245,eve,5,9.182264272911586e-06,4,9.11238532632591e-06,1,9.472836640932127e-06
3268,dec,5,9.182264272911586e-06,3,6.8342889947444315e-06,2,1.8945673281864254e-05
3267,23rd,5,9.182264272911586e-06,3,6.8342889947444315e-06,2,1.8945673281864254e-05
3282,screenings,5,9.182264272911586e-06,1,2.2780963315814773e-06,4,3.789134656372851e-05
3289,africa,5,9.182264272911586e-06,3,6.8342889947444315e-06,2,1.8945673281864254e-05
3304,pause,5,9.182264272911586e-06,3,6.8342889947444315e-06,2,1.8945673281864254e-05
3338,aids,5,9.182264272911586e-06,3,6.8342889947444315e-06,2,1.8945673281864254e-05
3350,ears,5,9.182264272911586e-06,3,6.8342889947444315e-06,2,1.8945673281864254e-05
3360,struggle,5,9.182264272911586e-06,2,4.556192663162955e-06,3,2.8418509922796382e-05
3364,chart,5,9.182264272911586e-06,2,4.556192663162955e-06,3,2.8418509922796382e-05
3373,canceled,5,9.182264272911586e-06,4,9.11238532632591e-06,1,9.472836640932127e-06
3378,ladders,5,9.182264272911586e-06,0,0,5,4.736418320466063e-05
3424,diwali,5,9.182264272911586e-06,4,9.11238532632591e-06,1,9.472836640932127e-06
3444,sandy,5,9.182264272911586e-06,1,2.2780963315814773e-06,4,3.789134656372851e-05
3459,carol,5,9.182264272911586e-06,4,9.11238532632591e-06,1,9.472836640932127e-06
3485,faces,5,9.182264272911586e-06,2,4.556192663162955e-06,3,2.8418509922796382e-05
3507,frustrated,5,9.182264272911586e-06,3,6.8342889947444315e-06,2,1.8945673281864254e-05
3540,sabotage,5,9.182264272911586e-06,4,9.11238532632591e-06,1,9.472836640932127e-06
3543,shutdowns,5,9.182264272911586e-06,4,9.11238532632591e-06,1,9.472836640932127e-06
3545,madam,5,9.182264272911586e-06,3,6.8342889947444315e-06,2,1.8945673281864254e-05
3563,opposes,5,9.182264272911586e-06,1,2.2780963315814773e-06,4,3.789134656372851e-05
3595,yard,5,9.182264272911586e-06,4,9.11238532632591e-06,1,9.472836640932127e-06
3593,touched,5,9.182264272911586e-06,3,6.8342889947444315e-06,2,1.8945673281864254e-05
3602,@nasa,5,9.182264272911586e-06,4,9.11238532632591e-06,1,9.472836640932127e-06
3643,#obamacareisworking,5,9.182264272911586e-06,0,0,5,4.736418320466063e-05
3687,ensures,5,9.182264272911586e-06,2,4.556192663162955e-06,3,2.8418509922796382e-05
3693,premium,5,9.182264272911586e-06,2,4.556192663162955e-06,3,2.8418509922796382e-05
3731,bailouts,5,9.182264272911586e-06,2,4.556192663162955e-06,3,2.8418509922796382e-05
3770,chattanooga,5,9.182264272911586e-06,4,9.11238532632591e-06,1,9.472836640932127e-06
3791,monopoly,5,9.182264272911586e-06,4,9.11238532632591e-06,1,9.472836640932127e-06
3828,louisville,5,9.182264272911586e-06,4,9.11238532632591e-06,1,9.472836640932127e-06
3830,ncaa,5,9.182264272911586e-06,3,6.8342889947444315e-06,2,1.8945673281864254e-05
3847,challenging,5,9.182264272911586e-06,3,6.8342889947444315e-06,2,1.8945673281864254e-05
3852,flood,5,9.182264272911586e-06,4,9.11238532632591e-06,1,9.472836640932127e-06
3901,rebates,5,9.182264272911586e-06,3,6.8342889947444315e-06,2,1.8945673281864254e-05
3904,hug,5,9.182264272911586e-06,0,0,5,4.736418320466063e-05
3913,betray,5,9.182264272911586e-06,3,6.8342889947444315e-06,2,1.8945673281864254e-05
3934,setback,5,9.182264272911586e-06,4,9.11238532632591e-06,1,9.472836640932127e-06
3938,contributor,5,9.182264272911586e-06,4,9.11238532632591e-06,1,9.472836640932127e-06
4022,patience,5,9.182264272911586e-06,3,6.8342889947444315e-06,2,1.8945673281864254e-05
4036,founded,5,9.182264272911586e-06,3,6.8342889947444315e-06,2,1.8945673281864254e-05
4063,ignoring,5,9.182264272911586e-06,2,4.556192663162955e-06,3,2.8418509922796382e-05
4077,witnessed,5,9.182264272911586e-06,4,9.11238532632591e-06,1,9.472836640932127e-06
4078,knocked,5,9.182264272911586e-06,1,2.2780963315814773e-06,4,3.789134656372851e-05
4083,shameful,5,9.182264272911586e-06,4,9.11238532632591e-06,1,9.472836640932127e-06
4111,movies,5,9.182264272911586e-06,4,9.11238532632591e-06,1,9.472836640932127e-06
4137,holy,5,9.182264272911586e-06,3,6.8342889947444315e-06,2,1.8945673281864254e-05
4160,#timetoact,5,9.182264272911586e-06,0,0,5,4.736418320466063e-05
4193,teach,5,9.182264272911586e-06,3,6.8342889947444315e-06,2,1.8945673281864254e-05
4202,drives,5,9.182264272911586e-06,3,6.8342889947444315e-06,2,1.8945673281864254e-05
4293,giffords,5,9.182264272911586e-06,0,0,5,4.736418320466063e-05
4304,responsibilities,5,9.182264272911586e-06,0,0,5,4.736418320466063e-05
4316,roots,5,9.182264272911586e-06,4,9.11238532632591e-06,1,9.472836640932127e-06
4342,principles,5,9.182264272911586e-06,3,6.8342889947444315e-06,2,1.8945673281864254e-05
4343,define,5,9.182264272911586e-06,4,9.11238532632591e-06,1,9.472836640932127e-06
4360,cared,5,9.182264272911586e-06,2,4.556192663162955e-06,3,2.8418509922796382e-05
4389,magazines,5,9.182264272911586e-06,4,9.11238532632591e-06,1,9.472836640932127e-06
4390,complicated,5,9.182264272911586e-06,4,9.11238532632591e-06,1,9.472836640932127e-06
4412,cliff,5,9.182264272911586e-06,2,4.556192663162955e-06,3,2.8418509922796382e-05
4414,hi,5,9.182264272911586e-06,1,2.2780963315814773e-06,4,3.789134656372851e-05
4417,trend,5,9.182264272911586e-06,4,9.11238532632591e-06,1,9.472836640932127e-06
4453,preventing,5,9.182264272911586e-06,1,2.2780963315814773e-06,4,3.789134656372851e-05
4482,schultz,5,9.182264272911586e-06,4,9.11238532632591e-06,1,9.472836640932127e-06
4489,2200,5,9.182264272911586e-06,0,0,5,4.736418320466063e-05
4502,nate,5,9.182264272911586e-06,4,9.11238532632591e-06,1,9.472836640932127e-06
4523,#stayinline,5,9.182264272911586e-06,0,0,5,4.736418320466063e-05
4534,8pm,5,9.182264272911586e-06,0,0,5,4.736418320466063e-05
4566,eliminating,5,9.182264272911586e-06,2,4.556192663162955e-06,3,2.8418509922796382e-05
4574,aint,5,9.182264272911586e-06,1,2.2780963315814773e-06,4,3.789134656372851e-05
4649,betting,5,9.182264272911586e-06,1,2.2780963315814773e-06,4,3.789134656372851e-05
4678,colin,5,9.182264272911586e-06,3,6.8342889947444315e-06,2,1.8945673281864254e-05
4699,dopresident,5,9.182264272911586e-06,0,0,5,4.736418320466063e-05
4753,ca,5,9.182264272911586e-06,1,2.2780963315814773e-06,4,3.789134656372851e-05
4758,nv,5,9.182264272911586e-06,2,4.556192663162955e-06,3,2.8418509922796382e-05
4859,pizza,5,9.182264272911586e-06,2,4.556192663162955e-06,3,2.8418509922796382e-05
4874,pretend,5,9.182264272911586e-06,4,9.11238532632591e-06,1,9.472836640932127e-06
4895,#proudofobama,5,9.182264272911586e-06,0,0,5,4.736418320466063e-05
4948,gays,5,9.182264272911586e-06,1,2.2780963315814773e-06,4,3.789134656372851e-05
4971,appointments,5,9.182264272911586e-06,4,9.11238532632591e-06,1,9.472836640932127e-06
4977,adviser,5,9.182264272911586e-06,4,9.11238532632591e-06,1,9.472836640932127e-06
5007,engines,5,9.182264272911586e-06,4,9.11238532632591e-06,1,9.472836640932127e-06
5022,click,5,9.182264272911586e-06,4,9.11238532632591e-06,1,9.472836640932127e-06
5026,#therealromney,5,9.182264272911586e-06,0,0,5,4.736418320466063e-05
5032,insulted,5,9.182264272911586e-06,1,2.2780963315814773e-06,4,3.789134656372851e-05
5030,dependent,5,9.182264272911586e-06,1,2.2780963315814773e-06,4,3.789134656372851e-05
5034,pretending,5,9.182264272911586e-06,4,9.11238532632591e-06,1,9.472836640932127e-06
5039,jay-z,5,9.182264272911586e-06,1,2.2780963315814773e-06,4,3.789134656372851e-05
5047,fooled,5,9.182264272911586e-06,4,9.11238532632591e-06,1,9.472836640932127e-06
5064,freeman,5,9.182264272911586e-06,4,9.11238532632591e-06,1,9.472836640932127e-06
5088,ryans,5,9.182264272911586e-06,0,0,5,4.736418320466063e-05
5178,registering,5,9.182264272911586e-06,3,6.8342889947444315e-06,2,1.8945673281864254e-05
5210,lesson,5,9.182264272911586e-06,2,4.556192663162955e-06,3,2.8418509922796382e-05
5240,turnout,5,9.182264272911586e-06,3,6.8342889947444315e-06,2,1.8945673281864254e-05
5257,multimillionaires,5,9.182264272911586e-06,0,0,5,4.736418320466063e-05
5288,mars,5,9.182264272911586e-06,2,4.556192663162955e-06,3,2.8418509922796382e-05
5314,handouts,5,9.182264272911586e-06,1,2.2780963315814773e-06,4,3.789134656372851e-05
5320,lobbyists,5,9.182264272911586e-06,4,9.11238532632591e-06,1,9.472836640932127e-06
5347,creator,5,9.182264272911586e-06,4,9.11238532632591e-06,1,9.472836640932127e-06
5379,petersburg,5,9.182264272911586e-06,4,9.11238532632591e-06,1,9.472836640932127e-06
5381,explaining,5,9.182264272911586e-06,4,9.11238532632591e-06,1,9.472836640932127e-06
5403,delegates,5,9.182264272911586e-06,4,9.11238532632591e-06,1,9.472836640932127e-06
5433,welfare,5,9.182264272911586e-06,3,6.8342889947444315e-06,2,1.8945673281864254e-05
5448,guide,5,9.182264272911586e-06,3,6.8342889947444315e-06,2,1.8945673281864254e-05
5492,bain,5,9.182264272911586e-06,0,0,5,4.736418320466063e-05
5521,neil,5,9.182264272911586e-06,3,6.8342889947444315e-06,2,1.8945673281864254e-05
5535,crowded,5,9.182264272911586e-06,4,9.11238532632591e-06,1,9.472836640932127e-06
5548,freed,5,9.182264272911586e-06,2,4.556192663162955e-06,3,2.8418509922796382e-05
5559,expressed,5,9.182264272911586e-06,4,9.11238532632591e-06,1,9.472836640932127e-06
5562,precedent,5,9.182264272911586e-06,4,9.11238532632591e-06,1,9.472836640932127e-06
5611,pills,5,9.182264272911586e-06,3,6.8342889947444315e-06,2,1.8945673281864254e-05
5616,costing,5,9.182264272911586e-06,4,9.11238532632591e-06,1,9.472836640932127e-06
5619,shoot,5,9.182264272911586e-06,4,9.11238532632591e-06,1,9.472836640932127e-06
5645,projects,5,9.182264272911586e-06,4,9.11238532632591e-06,1,9.472836640932127e-06
5653,await,5,9.182264272911586e-06,4,9.11238532632591e-06,1,9.472836640932127e-06
5682,image,5,9.182264272911586e-06,1,2.2780963315814773e-06,4,3.789134656372851e-05
5714,expenses,5,9.182264272911586e-06,4,9.11238532632591e-06,1,9.472836640932127e-06
5739,firms,5,9.182264272911586e-06,3,6.8342889947444315e-06,2,1.8945673281864254e-05
5762,implement,5,9.182264272911586e-06,2,4.556192663162955e-06,3,2.8418509922796382e-05
5764,recommendations,5,9.182264272911586e-06,4,9.11238532632591e-06,1,9.472836640932127e-06
5815,islands,5,9.182264272911586e-06,3,6.8342889947444315e-06,2,1.8945673281864254e-05
5921,shadow,5,9.182264272911586e-06,3,6.8342889947444315e-06,2,1.8945673281864254e-05
5919,deportation,5,9.182264272911586e-06,2,4.556192663162955e-06,3,2.8418509922796382e-05
5961,dear,5,9.182264272911586e-06,3,6.8342889947444315e-06,2,1.8945673281864254e-05
6002,beaches,5,9.182264272911586e-06,4,9.11238532632591e-06,1,9.472836640932127e-06
6024,recovered,5,9.182264272911586e-06,4,9.11238532632591e-06,1,9.472836640932127e-06
6115,avoided,5,9.182264272911586e-06,4,9.11238532632591e-06,1,9.472836640932127e-06
6141,lobby,5,9.182264272911586e-06,3,6.8342889947444315e-06,2,1.8945673281864254e-05
6160,derby,5,9.182264272911586e-06,4,9.11238532632591e-06,1,9.472836640932127e-06
6170,wisely,5,9.182264272911586e-06,4,9.11238532632591e-06,1,9.472836640932127e-06
6204,presenting,5,9.182264272911586e-06,3,6.8342889947444315e-06,2,1.8945673281864254e-05
6219,posts,5,9.182264272911586e-06,4,9.11238532632591e-06,1,9.472836640932127e-06
6320,unusual,5,9.182264272911586e-06,4,9.11238532632591e-06,1,9.472836640932127e-06
6338,selected,5,9.182264272911586e-06,3,6.8342889947444315e-06,2,1.8945673281864254e-05
6400,subsidizing,5,9.182264272911586e-06,3,6.8342889947444315e-06,2,1.8945673281864254e-05
6413,stepped,5,9.182264272911586e-06,4,9.11238532632591e-06,1,9.472836640932127e-06
6426,premiere,5,9.182264272911586e-06,0,0,5,4.736418320466063e-05
6449,japanese,5,9.182264272911586e-06,4,9.11238532632591e-06,1,9.472836640932127e-06
6479,shirt,5,9.182264272911586e-06,0,0,5,4.736418320466063e-05
6488,introducing,5,9.182264272911586e-06,2,4.556192663162955e-06,3,2.8418509922796382e-05
6493,shred,5,9.182264272911586e-06,4,9.11238532632591e-06,1,9.472836640932127e-06
6505,trips,5,9.182264272911586e-06,4,9.11238532632591e-06,1,9.472836640932127e-06
6519,uaw,5,9.182264272911586e-06,4,9.11238532632591e-06,1,9.472836640932127e-06
6527,settle,5,9.182264272911586e-06,3,6.8342889947444315e-06,2,1.8945673281864254e-05
6536,store,5,9.182264272911586e-06,3,6.8342889947444315e-06,2,1.8945673281864254e-05
6540,200000,5,9.182264272911586e-06,3,6.8342889947444315e-06,2,1.8945673281864254e-05
6549,#40dollars,5,9.182264272911586e-06,0,0,5,4.736418320466063e-05
6599,sir,5,9.182264272911586e-06,4,9.11238532632591e-06,1,9.472836640932127e-06
6642,mornings,5,9.182264272911586e-06,4,9.11238532632591e-06,1,9.472836640932127e-06
6643,resource,5,9.182264272911586e-06,3,6.8342889947444315e-06,2,1.8945673281864254e-05
6673,unit,5,9.182264272911586e-06,4,9.11238532632591e-06,1,9.472836640932127e-06
6692,barrels,5,9.182264272911586e-06,4,9.11238532632591e-06,1,9.472836640932127e-06
6694,permit,5,9.182264272911586e-06,4,9.11238532632591e-06,1,9.472836640932127e-06
6699,reviewing,5,9.182264272911586e-06,4,9.11238532632591e-06,1,9.472836640932127e-06
6784,lit,5,9.182264272911586e-06,1,2.2780963315814773e-06,4,3.789134656372851e-05
6826,325,5,9.182264272911586e-06,4,9.11238532632591e-06,1,9.472836640932127e-06
6852,#debatewatch,5,9.182264272911586e-06,0,0,5,4.736418320466063e-05
6875,debating,5,9.182264272911586e-06,4,9.11238532632591e-06,1,9.472836640932127e-06
6887,payment,5,9.182264272911586e-06,4,9.11238532632591e-06,1,9.472836640932127e-06
6925,headquarters,5,9.182264272911586e-06,3,6.8342889947444315e-06,2,1.8945673281864254e-05
6939,checked,5,9.182264272911586e-06,4,9.11238532632591e-06,1,9.472836640932127e-06
6958,hhs,5,9.182264272911586e-06,4,9.11238532632591e-06,1,9.472836640932127e-06
6989,chamber,5,9.182264272911586e-06,4,9.11238532632591e-06,1,9.472836640932127e-06
7047,bench,5,9.182264272911586e-06,4,9.11238532632591e-06,1,9.472836640932127e-06
7048,judgeships,5,9.182264272911586e-06,4,9.11238532632591e-06,1,9.472836640932127e-06
7050,nominees,5,9.182264272911586e-06,4,9.11238532632591e-06,1,9.472836640932127e-06
7238,norway,5,9.182264272911586e-06,4,9.11238532632591e-06,1,9.472836640932127e-06
7287,greeted,5,9.182264272911586e-06,4,9.11238532632591e-06,1,9.472836640932127e-06
7325,uphold,5,9.182264272911586e-06,4,9.11238532632591e-06,1,9.472836640932127e-06
7386,tucson,5,9.182264272911586e-06,3,6.8342889947444315e-06,2,1.8945673281864254e-05
7394,personnel,5,9.182264272911586e-06,4,9.11238532632591e-06,1,9.472836640932127e-06
7412,persecution,5,9.182264272911586e-06,4,9.11238532632591e-06,1,9.472836640932127e-06
7415,treaty,5,9.182264272911586e-06,4,9.11238532632591e-06,1,9.472836640932127e-06
7422,midst,5,9.182264272911586e-06,4,9.11238532632591e-06,1,9.472836640932127e-06
7437,tuesdays,5,9.182264272911586e-06,3,6.8342889947444315e-06,2,1.8945673281864254e-05
7462,submit,5,9.182264272911586e-06,2,4.556192663162955e-06,3,2.8418509922796382e-05
7465,co-workers,5,9.182264272911586e-06,4,9.11238532632591e-06,1,9.472836640932127e-06
7546,130,5,9.182264272911586e-06,4,9.11238532632591e-06,1,9.472836640932127e-06
7550,export,5,9.182264272911586e-06,4,9.11238532632591e-06,1,9.472836640932127e-06
7551,unleash,5,9.182264272911586e-06,4,9.11238532632591e-06,1,9.472836640932127e-06
7566,participating,5,9.182264272911586e-06,4,9.11238532632591e-06,1,9.472836640932127e-06
7573,damages,5,9.182264272911586e-06,4,9.11238532632591e-06,1,9.472836640932127e-06
7579,unyielding,5,9.182264272911586e-06,4,9.11238532632591e-06,1,9.472836640932127e-06
7616,120,5,9.182264272911586e-06,4,9.11238532632591e-06,1,9.472836640932127e-06
7655,height,5,9.182264272911586e-06,4,9.11238532632591e-06,1,9.472836640932127e-06
7652,devoted,5,9.182264272911586e-06,4,9.11238532632591e-06,1,9.472836640932127e-06
7678,#iamherefor,5,9.182264272911586e-06,0,0,5,4.736418320466063e-05
7692,performances,5,9.182264272911586e-06,4,9.11238532632591e-06,1,9.472836640932127e-06
7701,#recoveryact,5,9.182264272911586e-06,0,0,5,4.736418320466063e-05
7703,#ofa,5,9.182264272911586e-06,0,0,5,4.736418320466063e-05
7767,conducted,5,9.182264272911586e-06,4,9.11238532632591e-06,1,9.472836640932127e-06
7771,survey,5,9.182264272911586e-06,4,9.11238532632591e-06,1,9.472836640932127e-06
7834,goals,5,9.182264272911586e-06,2,4.556192663162955e-06,3,2.8418509922796382e-05
7836,stability,5,9.182264272911586e-06,4,9.11238532632591e-06,1,9.472836640932127e-06
7849,re,5,9.182264272911586e-06,4,9.11238532632591e-06,1,9.472836640932127e-06
7858,smoking,5,9.182264272911586e-06,4,9.11238532632591e-06,1,9.472836640932127e-06
7930,@secretarysonny,5,9.182264272911586e-06,5,1.1390481657907387e-05,0,0
7957,moderna,5,9.182264272911586e-06,5,1.1390481657907387e-05,0,0
7975,bret,5,9.182264272911586e-06,5,1.1390481657907387e-05,0,0
8023,@thejusticedept,5,9.182264272911586e-06,5,1.1390481657907387e-05,0,0
8033,arrive,5,9.182264272911586e-06,5,1.1390481657907387e-05,0,0
8045,ailes,5,9.182264272911586e-06,5,1.1390481657907387e-05,0,0
8069,900pme,5,9.182264272911586e-06,5,1.1390481657907387e-05,0,0
8079,realized,5,9.182264272911586e-06,5,1.1390481657907387e-05,0,0
8113,viewers,5,9.182264272911586e-06,5,1.1390481657907387e-05,0,0
8164,@seanparnellusa,5,9.182264272911586e-06,5,1.1390481657907387e-05,0,0
8233,pollsters,5,9.182264272911586e-06,5,1.1390481657907387e-05,0,0
8232,instances,5,9.182264272911586e-06,5,1.1390481657907387e-05,0,0
8237,located,5,9.182264272911586e-06,5,1.1390481657907387e-05,0,0
8273,thin,5,9.182264272911586e-06,5,1.1390481657907387e-05,0,0
8277,clip,5,9.182264272911586e-06,5,1.1390481657907387e-05,0,0
8279,activists,5,9.182264272911586e-06,5,1.1390481657907387e-05,0,0
8301,@gstephanopoulos,5,9.182264272911586e-06,5,1.1390481657907387e-05,0,0
8342,airtime,5,9.182264272911586e-06,5,1.1390481657907387e-05,0,0
8379,promoting,5,9.182264272911586e-06,5,1.1390481657907387e-05,0,0
8378,lows,5,9.182264272911586e-06,5,1.1390481657907387e-05,0,0
8383,cincinnati,5,9.182264272911586e-06,5,1.1390481657907387e-05,0,0
8414,stahl,5,9.182264272911586e-06,5,1.1390481657907387e-05,0,0
8459,@chanelrion,5,9.182264272911586e-06,5,1.1390481657907387e-05,0,0
8489,@senjohnkennedy,5,9.182264272911586e-06,5,1.1390481657907387e-05,0,0
8517,egregious,5,9.182264272911586e-06,5,1.1390481657907387e-05,0,0
8529,gsa,5,9.182264272911586e-06,5,1.1390481657907387e-05,0,0
8535,concede,5,9.182264272911586e-06,5,1.1390481657907387e-05,0,0
8540,79,5,9.182264272911586e-06,5,1.1390481657907387e-05,0,0
8552,@richardgrenell,5,9.182264272911586e-06,5,1.1390481657907387e-05,0,0
8572,indefinitely,5,9.182264272911586e-06,5,1.1390481657907387e-05,0,0
8592,truck,5,9.182264272911586e-06,5,1.1390481657907387e-05,0,0
8656,tap,5,9.182264272911586e-06,5,1.1390481657907387e-05,0,0
8658,successes,5,9.182264272911586e-06,5,1.1390481657907387e-05,0,0
8671,drawing,5,9.182264272911586e-06,5,1.1390481657907387e-05,0,0
8701,sasse,5,9.182264272911586e-06,5,1.1390481657907387e-05,0,0
8703,obnoxious,5,9.182264272911586e-06,5,1.1390481657907387e-05,0,0
8710,macon,5,9.182264272911586e-06,5,1.1390481657907387e-05,0,0
8718,rumor,5,9.182264272911586e-06,5,1.1390481657907387e-05,0,0
8731,scully,5,9.182264272911586e-06,5,1.1390481657907387e-05,0,0
8755,anti-american,5,9.182264272911586e-06,5,1.1390481657907387e-05,0,0
8840,spirits,5,9.182264272911586e-06,5,1.1390481657907387e-05,0,0
8843,appropriately,5,9.182264272911586e-06,5,1.1390481657907387e-05,0,0
8878,reaches,5,9.182264272911586e-06,5,1.1390481657907387e-05,0,0
8896,assaulted,5,9.182264272911586e-06,5,1.1390481657907387e-05,0,0
8904,bombing,5,9.182264272911586e-06,5,1.1390481657907387e-05,0,0
8964,denies,5,9.182264272911586e-06,5,1.1390481657907387e-05,0,0
8970,@sharylattkisson,5,9.182264272911586e-06,5,1.1390481657907387e-05,0,0
9008,christina,5,9.182264272911586e-06,5,1.1390481657907387e-05,0,0
9018,fayetteville,5,9.182264272911586e-06,5,1.1390481657907387e-05,0,0
9021,flint,5,9.182264272911586e-06,5,1.1390481657907387e-05,0,0
9075,watchable,5,9.182264272911586e-06,5,1.1390481657907387e-05,0,0
9095,equals,5,9.182264272911586e-06,5,1.1390481657907387e-05,0,0
9112,violating,5,9.182264272911586e-06,5,1.1390481657907387e-05,0,0
9179,#nc09,5,9.182264272911586e-06,5,1.1390481657907387e-05,0,0
9202,bleeding,5,9.182264272911586e-06,5,1.1390481657907387e-05,0,0
9212,rigging,5,9.182264272911586e-06,5,1.1390481657907387e-05,0,0
9220,robbed,5,9.182264272911586e-06,5,1.1390481657907387e-05,0,0
9229,vulnerable,5,9.182264272911586e-06,5,1.1390481657907387e-05,0,0
9264,recognizing,5,9.182264272911586e-06,5,1.1390481657907387e-05,0,0
9276,creed,5,9.182264272911586e-06,5,1.1390481657907387e-05,0,0
9286,@stevefda,5,9.182264272911586e-06,5,1.1390481657907387e-05,0,0
9316,engineer,5,9.182264272911586e-06,5,1.1390481657907387e-05,0,0
9331,jake,5,9.182264272911586e-06,5,1.1390481657907387e-05,0,0
9376,miscarriage,5,9.182264272911586e-06,5,1.1390481657907387e-05,0,0
9402,castro,5,9.182264272911586e-06,5,1.1390481657907387e-05,0,0
9409,blind,5,9.182264272911586e-06,5,1.1390481657907387e-05,0,0
9420,subsidize,5,9.182264272911586e-06,5,1.1390481657907387e-05,0,0
9423,apparatus,5,9.182264272911586e-06,5,1.1390481657907387e-05,0,0
9425,occur,5,9.182264272911586e-06,5,1.1390481657907387e-05,0,0
9464,morrisey,5,9.182264272911586e-06,5,1.1390481657907387e-05,0,0
9496,scranton,5,9.182264272911586e-06,5,1.1390481657907387e-05,0,0
9521,souls,5,9.182264272911586e-06,5,1.1390481657907387e-05,0,0
9553,midwest,5,9.182264272911586e-06,5,1.1390481657907387e-05,0,0
9581,verify,5,9.182264272911586e-06,5,1.1390481657907387e-05,0,0
9629,mobs,5,9.182264272911586e-06,5,1.1390481657907387e-05,0,0
9683,invited,5,9.182264272911586e-06,5,1.1390481657907387e-05,0,0
9705,pork,5,9.182264272911586e-06,5,1.1390481657907387e-05,0,0
9709,horowitz,5,9.182264272911586e-06,5,1.1390481657907387e-05,0,0
9732,smoothly,5,9.182264272911586e-06,5,1.1390481657907387e-05,0,0
9750,@newtgingrich,5,9.182264272911586e-06,5,1.1390481657907387e-05,0,0
9758,ugly,5,9.182264272911586e-06,5,1.1390481657907387e-05,0,0
9786,hagedorn,5,9.182264272911586e-06,5,1.1390481657907387e-05,0,0
9788,cowardice,5,9.182264272911586e-06,5,1.1390481657907387e-05,0,0
9809,unanimously,5,9.182264272911586e-06,5,1.1390481657907387e-05,0,0
9867,conclusive,5,9.182264272911586e-06,5,1.1390481657907387e-05,0,0
9871,non,5,9.182264272911586e-06,5,1.1390481657907387e-05,0,0
9884,17000,5,9.182264272911586e-06,5,1.1390481657907387e-05,0,0
9896,#weeklyaddress🇺🇸,5,9.182264272911586e-06,5,1.1390481657907387e-05,0,0
9971,lefts,5,9.182264272911586e-06,5,1.1390481657907387e-05,0,0
9976,atrocious,5,9.182264272911586e-06,5,1.1390481657907387e-05,0,0
9985,@joniernst,5,9.182264272911586e-06,5,1.1390481657907387e-05,0,0
9999,slippery,5,9.182264272911586e-06,5,1.1390481657907387e-05,0,0
10018,@teamcavuto,5,9.182264272911586e-06,5,1.1390481657907387e-05,0,0
10027,hotels,5,9.182264272911586e-06,5,1.1390481657907387e-05,0,0
10028,onslaught,5,9.182264272911586e-06,5,1.1390481657907387e-05,0,0
10036,temporarily,5,9.182264272911586e-06,5,1.1390481657907387e-05,0,0
10042,downward,5,9.182264272911586e-06,5,1.1390481657907387e-05,0,0
10080,@borisjohnson,5,9.182264272911586e-06,5,1.1390481657907387e-05,0,0
10098,@usairforce,5,9.182264272911586e-06,5,1.1390481657907387e-05,0,0
10143,مردم,5,9.182264272911586e-06,5,1.1390481657907387e-05,0,0
10141,شما,5,9.182264272911586e-06,5,1.1390481657907387e-05,0,0
10152,#kag2020🇺🇸,5,9.182264272911586e-06,5,1.1390481657907387e-05,0,0
10173,mentions,5,9.182264272911586e-06,5,1.1390481657907387e-05,0,0
10215,fraternal,5,9.182264272911586e-06,5,1.1390481657907387e-05,0,0
10232,در,5,9.182264272911586e-06,5,1.1390481657907387e-05,0,0
10251,pipelines,5,9.182264272911586e-06,5,1.1390481657907387e-05,0,0
10342,که,5,9.182264272911586e-06,5,1.1390481657907387e-05,0,0
10311,آنها,5,9.182264272911586e-06,5,1.1390481657907387e-05,0,0
10344,developments,5,9.182264272911586e-06,5,1.1390481657907387e-05,0,0
10350,recommendation,5,9.182264272911586e-06,5,1.1390481657907387e-05,0,0
10349,consultation,5,9.182264272911586e-06,5,1.1390481657907387e-05,0,0
10383,dummy,5,9.182264272911586e-06,5,1.1390481657907387e-05,0,0
10398,@mikedewine,5,9.182264272911586e-06,5,1.1390481657907387e-05,0,0
10461,invaluable,5,9.182264272911586e-06,5,1.1390481657907387e-05,0,0
10481,animals,5,9.182264272911586e-06,5,1.1390481657907387e-05,0,0
10486,superior,5,9.182264272911586e-06,5,1.1390481657907387e-05,0,0
10508,lifted,5,9.182264272911586e-06,5,1.1390481657907387e-05,0,0
10525,bachelor,5,9.182264272911586e-06,5,1.1390481657907387e-05,0,0
10556,inept,5,9.182264272911586e-06,5,1.1390481657907387e-05,0,0
10558,ossoff,5,9.182264272911586e-06,5,1.1390481657907387e-05,0,0
10561,roughly,5,9.182264272911586e-06,5,1.1390481657907387e-05,0,0
10580,limited,5,9.182264272911586e-06,5,1.1390481657907387e-05,0,0
10607,pigs,5,9.182264272911586e-06,5,1.1390481657907387e-05,0,0
10674,angeles,5,9.182264272911586e-06,5,1.1390481657907387e-05,0,0
10678,blowout,5,9.182264272911586e-06,5,1.1390481657907387e-05,0,0
10707,cures,5,9.182264272911586e-06,5,1.1390481657907387e-05,0,0
10723,classic,5,9.182264272911586e-06,5,1.1390481657907387e-05,0,0
10725,competitor,5,9.182264272911586e-06,5,1.1390481657907387e-05,0,0
10728,beds,5,9.182264272911586e-06,5,1.1390481657907387e-05,0,0
10730,carnage,5,9.182264272911586e-06,5,1.1390481657907387e-05,0,0
10738,lacy,5,9.182264272911586e-06,5,1.1390481657907387e-05,0,0
10749,obrien,5,9.182264272911586e-06,5,1.1390481657907387e-05,0,0
10758,furious,5,9.182264272911586e-06,5,1.1390481657907387e-05,0,0
10764,chinavirus,5,9.182264272911586e-06,5,1.1390481657907387e-05,0,0
10769,worldwide,5,9.182264272911586e-06,5,1.1390481657907387e-05,0,0
10772,aviation,5,9.182264272911586e-06,5,1.1390481657907387e-05,0,0
10801,@hhsgov,5,9.182264272911586e-06,5,1.1390481657907387e-05,0,0
10823,@ttuberville,5,9.182264272911586e-06,5,1.1390481657907387e-05,0,0
10832,ashley,5,9.182264272911586e-06,5,1.1390481657907387e-05,0,0
10836,essentially,5,9.182264272911586e-06,5,1.1390481657907387e-05,0,0
10839,satisfy,5,9.182264272911586e-06,5,1.1390481657907387e-05,0,0
10874,assessment,5,9.182264272911586e-06,5,1.1390481657907387e-05,0,0
10887,motion,5,9.182264272911586e-06,5,1.1390481657907387e-05,0,0
10892,informer,5,9.182264272911586e-06,5,1.1390481657907387e-05,0,0
10893,irans,5,9.182264272911586e-06,5,1.1390481657907387e-05,0,0
10911,perry,5,9.182264272911586e-06,5,1.1390481657907387e-05,0,0
10915,keller,5,9.182264272911586e-06,5,1.1390481657907387e-05,0,0
10923,speedy,5,9.182264272911586e-06,5,1.1390481657907387e-05,0,0
10973,distinction,5,9.182264272911586e-06,5,1.1390481657907387e-05,0,0
10984,phil,5,9.182264272911586e-06,5,1.1390481657907387e-05,0,0
10986,@edhenry,5,9.182264272911586e-06,5,1.1390481657907387e-05,0,0
11018,@ronnyjackson4tx,5,9.182264272911586e-06,5,1.1390481657907387e-05,0,0
11017,#tx13,5,9.182264272911586e-06,5,1.1390481657907387e-05,0,0
11023,flights,5,9.182264272911586e-06,5,1.1390481657907387e-05,0,0
11035,salt,5,9.182264272911586e-06,5,1.1390481657907387e-05,0,0
11039,fbis,5,9.182264272911586e-06,5,1.1390481657907387e-05,0,0
11042,procedures,5,9.182264272911586e-06,5,1.1390481657907387e-05,0,0
11071,airwaves,5,9.182264272911586e-06,5,1.1390481657907387e-05,0,0
11093,stephen,5,9.182264272911586e-06,5,1.1390481657907387e-05,0,0
11095,choked,5,9.182264272911586e-06,5,1.1390481657907387e-05,0,0
11097,planes,5,9.182264272911586e-06,5,1.1390481657907387e-05,0,0
11118,krugman,5,9.182264272911586e-06,5,1.1390481657907387e-05,0,0
11134,dowd,5,9.182264272911586e-06,5,1.1390481657907387e-05,0,0
11143,kimberley,5,9.182264272911586e-06,5,1.1390481657907387e-05,0,0
11147,triggered,5,9.182264272911586e-06,5,1.1390481657907387e-05,0,0
11231,motor,5,9.182264272911586e-06,5,1.1390481657907387e-05,0,0
11235,marsha,5,9.182264272911586e-06,5,1.1390481657907387e-05,0,0
11250,fredos,5,9.182264272911586e-06,5,1.1390481657907387e-05,0,0
11295,warrants,5,9.182264272911586e-06,5,1.1390481657907387e-05,0,0
11323,geniuses,5,9.182264272911586e-06,5,1.1390481657907387e-05,0,0
11358,suggests,5,9.182264272911586e-06,5,1.1390481657907387e-05,0,0
11357,forth,5,9.182264272911586e-06,5,1.1390481657907387e-05,0,0
11396,terrence,5,9.182264272911586e-06,5,1.1390481657907387e-05,0,0
11408,rage,5,9.182264272911586e-06,5,1.1390481657907387e-05,0,0
11409,independents,5,9.182264272911586e-06,5,1.1390481657907387e-05,0,0
11436,duly,5,9.182264272911586e-06,5,1.1390481657907387e-05,0,0
11451,tuning,5,9.182264272911586e-06,5,1.1390481657907387e-05,0,0
11453,involvement,5,9.182264272911586e-06,5,1.1390481657907387e-05,0,0
11452,dealings,5,9.182264272911586e-06,5,1.1390481657907387e-05,0,0
11484,teleconference,5,9.182264272911586e-06,5,1.1390481657907387e-05,0,0
11486,spare,5,9.182264272911586e-06,5,1.1390481657907387e-05,0,0
11495,kellyanne,5,9.182264272911586e-06,5,1.1390481657907387e-05,0,0
11499,types,5,9.182264272911586e-06,5,1.1390481657907387e-05,0,0
11516,mulvaney,5,9.182264272911586e-06,5,1.1390481657907387e-05,0,0
11520,venue,5,9.182264272911586e-06,5,1.1390481657907387e-05,0,0
11536,dominated,5,9.182264272911586e-06,5,1.1390481657907387e-05,0,0
11552,print,5,9.182264272911586e-06,5,1.1390481657907387e-05,0,0
11605,devaluation,5,9.182264272911586e-06,5,1.1390481657907387e-05,0,0
11608,historian,5,9.182264272911586e-06,5,1.1390481657907387e-05,0,0
11609,wead,5,9.182264272911586e-06,5,1.1390481657907387e-05,0,0
11629,greenville,5,9.182264272911586e-06,5,1.1390481657907387e-05,0,0
11631,declaring,5,9.182264272911586e-06,5,1.1390481657907387e-05,0,0
11744,confinement,5,9.182264272911586e-06,5,1.1390481657907387e-05,0,0
11752,erie,5,9.182264272911586e-06,5,1.1390481657907387e-05,0,0
11769,powerfully,5,9.182264272911586e-06,5,1.1390481657907387e-05,0,0
11778,purchasing,5,9.182264272911586e-06,5,1.1390481657907387e-05,0,0
11805,insisted,5,9.182264272911586e-06,5,1.1390481657907387e-05,0,0
11808,attendance,5,9.182264272911586e-06,5,1.1390481657907387e-05,0,0
11809,occupy,5,9.182264272911586e-06,5,1.1390481657907387e-05,0,0
11835,clueless,5,9.182264272911586e-06,5,1.1390481657907387e-05,0,0
11857,embarrass,5,9.182264272911586e-06,5,1.1390481657907387e-05,0,0
11892,rightfully,5,9.182264272911586e-06,5,1.1390481657907387e-05,0,0
11898,max,5,9.182264272911586e-06,5,1.1390481657907387e-05,0,0
11906,fortunately,5,9.182264272911586e-06,5,1.1390481657907387e-05,0,0
11908,lamb,5,9.182264272911586e-06,5,1.1390481657907387e-05,0,0
11917,persecuted,5,9.182264272911586e-06,5,1.1390481657907387e-05,0,0
11923,nunes,5,9.182264272911586e-06,5,1.1390481657907387e-05,0,0
11922,examples,5,9.182264272911586e-06,5,1.1390481657907387e-05,0,0
11932,endlessly,5,9.182264272911586e-06,5,1.1390481657907387e-05,0,0
11950,wheeler,5,9.182264272911586e-06,5,1.1390481657907387e-05,0,0
11965,vigilant,5,9.182264272911586e-06,5,1.1390481657907387e-05,0,0
11968,cleaning,5,9.182264272911586e-06,5,1.1390481657907387e-05,0,0
11975,paint,5,9.182264272911586e-06,5,1.1390481657907387e-05,0,0
12004,corridor,5,9.182264272911586e-06,5,1.1390481657907387e-05,0,0
12030,communications,5,9.182264272911586e-06,5,1.1390481657907387e-05,0,0
12063,prizes,5,9.182264272911586e-06,5,1.1390481657907387e-05,0,0
12091,@govrondesantis,5,9.182264272911586e-06,5,1.1390481657907387e-05,0,0
12170,filling,5,9.182264272911586e-06,5,1.1390481657907387e-05,0,0
12173,presentation,5,9.182264272911586e-06,5,1.1390481657907387e-05,0,0
12198,daytona,5,9.182264272911586e-06,5,1.1390481657907387e-05,0,0
12197,@senrickscott,5,9.182264272911586e-06,5,1.1390481657907387e-05,0,0
12201,sophisticated,5,9.182264272911586e-06,5,1.1390481657907387e-05,0,0
12218,raging,5,9.182264272911586e-06,5,1.1390481657907387e-05,0,0
12255,recognition,5,9.182264272911586e-06,5,1.1390481657907387e-05,0,0
12327,trap,5,9.182264272911586e-06,5,1.1390481657907387e-05,0,0
12352,perished,5,9.182264272911586e-06,5,1.1390481657907387e-05,0,0
12380,mans,5,9.182264272911586e-06,5,1.1390481657907387e-05,0,0
12385,reg,5,9.182264272911586e-06,5,1.1390481657907387e-05,0,0
12427,impressive,5,9.182264272911586e-06,5,1.1390481657907387e-05,0,0
12433,hidden,5,9.182264272911586e-06,5,1.1390481657907387e-05,0,0
12470,damaged,5,9.182264272911586e-06,5,1.1390481657907387e-05,0,0
12475,completion,5,9.182264272911586e-06,5,1.1390481657907387e-05,0,0
12479,files,5,9.182264272911586e-06,5,1.1390481657907387e-05,0,0
12491,incapable,5,9.182264272911586e-06,5,1.1390481657907387e-05,0,0
12685,vain,5,9.182264272911586e-06,5,1.1390481657907387e-05,0,0
12693,emphasis,5,9.182264272911586e-06,5,1.1390481657907387e-05,0,0
12697,dogs,5,9.182264272911586e-06,5,1.1390481657907387e-05,0,0
12713,supportive,5,9.182264272911586e-06,5,1.1390481657907387e-05,0,0
12719,successfully,5,9.182264272911586e-06,5,1.1390481657907387e-05,0,0
12721,wished,5,9.182264272911586e-06,5,1.1390481657907387e-05,0,0
12734,gentleman,5,9.182264272911586e-06,5,1.1390481657907387e-05,0,0
12738,thoroughly,5,9.182264272911586e-06,5,1.1390481657907387e-05,0,0
12772,unparalleled,5,9.182264272911586e-06,5,1.1390481657907387e-05,0,0
12792,crying,5,9.182264272911586e-06,5,1.1390481657907387e-05,0,0
12808,jeffress,5,9.182264272911586e-06,5,1.1390481657907387e-05,0,0
12813,@gop,5,9.182264272911586e-06,5,1.1390481657907387e-05,0,0
12814,selection,5,9.182264272911586e-06,5,1.1390481657907387e-05,0,0
12825,sky,5,9.182264272911586e-06,5,1.1390481657907387e-05,0,0
12838,marcus,5,9.182264272911586e-06,5,1.1390481657907387e-05,0,0
12846,dick,5,9.182264272911586e-06,5,1.1390481657907387e-05,0,0
12880,significantly,5,9.182264272911586e-06,5,1.1390481657907387e-05,0,0
12922,natalie,5,9.182264272911586e-06,5,1.1390481657907387e-05,0,0
12925,6000,5,9.182264272911586e-06,5,1.1390481657907387e-05,0,0
12927,bloombergs,5,9.182264272911586e-06,5,1.1390481657907387e-05,0,0
12958,rival,5,9.182264272911586e-06,5,1.1390481657907387e-05,0,0
12965,tenure,5,9.182264272911586e-06,5,1.1390481657907387e-05,0,0
12999,publicity,5,9.182264272911586e-06,5,1.1390481657907387e-05,0,0
13081,@deptvetaffairs,5,9.182264272911586e-06,5,1.1390481657907387e-05,0,0
13098,hourly,5,9.182264272911586e-06,5,1.1390481657907387e-05,0,0
13106,401k,5,9.182264272911586e-06,5,1.1390481657907387e-05,0,0
13134,untruthful,5,9.182264272911586e-06,5,1.1390481657907387e-05,0,0
13144,intense,5,9.182264272911586e-06,5,1.1390481657907387e-05,0,0
13162,scourge,5,9.182264272911586e-06,5,1.1390481657907387e-05,0,0
13209,frozen,5,9.182264272911586e-06,5,1.1390481657907387e-05,0,0
13233,softball,5,9.182264272911586e-06,5,1.1390481657907387e-05,0,0
13256,vote-by-mail,5,9.182264272911586e-06,5,1.1390481657907387e-05,0,0
13265,excitement,5,9.182264272911586e-06,5,1.1390481657907387e-05,0,0
13333,racism,5,9.182264272911586e-06,5,1.1390481657907387e-05,0,0
13393,kremlin,5,9.182264272911586e-06,5,1.1390481657907387e-05,0,0
13442,subscribers,5,9.182264272911586e-06,5,1.1390481657907387e-05,0,0
13447,louis,5,9.182264272911586e-06,5,1.1390481657907387e-05,0,0
13453,susan,5,9.182264272911586e-06,5,1.1390481657907387e-05,0,0
13483,को,5,9.182264272911586e-06,5,1.1390481657907387e-05,0,0
13574,rude,5,9.182264272911586e-06,5,1.1390481657907387e-05,0,0
13578,shep,5,9.182264272911586e-06,5,1.1390481657907387e-05,0,0
13585,associates,5,9.182264272911586e-06,5,1.1390481657907387e-05,0,0
13606,treatments,5,9.182264272911586e-06,5,1.1390481657907387e-05,0,0
13674,stunned,5,9.182264272911586e-06,5,1.1390481657907387e-05,0,0
13676,caldwell,5,9.182264272911586e-06,5,1.1390481657907387e-05,0,0
13753,deeper,5,9.182264272911586e-06,5,1.1390481657907387e-05,0,0
13767,kudlow,5,9.182264272911586e-06,5,1.1390481657907387e-05,0,0
13777,penn,5,9.182264272911586e-06,5,1.1390481657907387e-05,0,0
13799,griffin,5,9.182264272911586e-06,5,1.1390481657907387e-05,0,0
13806,gordon,5,9.182264272911586e-06,5,1.1390481657907387e-05,0,0
13898,@cardinaldolan,5,9.182264272911586e-06,5,1.1390481657907387e-05,0,0
13903,boarder,5,9.182264272911586e-06,5,1.1390481657907387e-05,0,0
13988,highways,5,9.182264272911586e-06,5,1.1390481657907387e-05,0,0
14088,dustin,5,9.182264272911586e-06,5,1.1390481657907387e-05,0,0
14111,@jimcramer,5,9.182264272911586e-06,5,1.1390481657907387e-05,0,0
14130,catholic,5,9.182264272911586e-06,5,1.1390481657907387e-05,0,0
14233,greats,5,9.182264272911586e-06,5,1.1390481657907387e-05,0,0
14236,aspects,5,9.182264272911586e-06,5,1.1390481657907387e-05,0,0
14248,resigned,5,9.182264272911586e-06,5,1.1390481657907387e-05,0,0
14269,declassified,5,9.182264272911586e-06,5,1.1390481657907387e-05,0,0
14292,mclaughlin,5,9.182264272911586e-06,5,1.1390481657907387e-05,0,0
14500,lesser,5,9.182264272911586e-06,5,1.1390481657907387e-05,0,0
14543,separately,5,9.182264272911586e-06,5,1.1390481657907387e-05,0,0
14561,#noko,5,9.182264272911586e-06,5,1.1390481657907387e-05,0,0
14601,distract,5,9.182264272911586e-06,5,1.1390481657907387e-05,0,0
14608,gorsuch,5,9.182264272911586e-06,5,1.1390481657907387e-05,0,0
14642,roosevelt,5,9.182264272911586e-06,5,1.1390481657907387e-05,0,0
14656,pelosischumer,5,9.182264272911586e-06,5,1.1390481657907387e-05,0,0
14678,cnns,5,9.182264272911586e-06,5,1.1390481657907387e-05,0,0
14736,schumerpelosi,5,9.182264272911586e-06,5,1.1390481657907387e-05,0,0
14800,discredit,5,9.182264272911586e-06,5,1.1390481657907387e-05,0,0
14801,extremist,5,9.182264272911586e-06,5,1.1390481657907387e-05,0,0
14805,woods,5,9.182264272911586e-06,5,1.1390481657907387e-05,0,0
14807,inherited,5,9.182264272911586e-06,5,1.1390481657907387e-05,0,0
14814,uss,5,9.182264272911586e-06,5,1.1390481657907387e-05,0,0
14818,twelve,5,9.182264272911586e-06,5,1.1390481657907387e-05,0,0
14820,lavar,5,9.182264272911586e-06,5,1.1390481657907387e-05,0,0
14903,da,5,9.182264272911586e-06,5,1.1390481657907387e-05,0,0
14904,nang,5,9.182264272911586e-06,5,1.1390481657907387e-05,0,0
14918,deplorables,5,9.182264272911586e-06,5,1.1390481657907387e-05,0,0
15021,theories,5,9.182264272911586e-06,5,1.1390481657907387e-05,0,0
15060,fabricate,5,9.182264272911586e-06,5,1.1390481657907387e-05,0,0
15107,confirms,5,9.182264272911586e-06,5,1.1390481657907387e-05,0,0
15110,🎥,5,9.182264272911586e-06,5,1.1390481657907387e-05,0,0
15146,pr,5,9.182264272911586e-06,5,1.1390481657907387e-05,0,0
15203,demented,5,9.182264272911586e-06,5,1.1390481657907387e-05,0,0
15261,warmbier,5,9.182264272911586e-06,5,1.1390481657907387e-05,0,0
15338,bc,5,9.182264272911586e-06,5,1.1390481657907387e-05,0,0
15339,cell,5,9.182264272911586e-06,5,1.1390481657907387e-05,0,0
15355,#fake,5,9.182264272911586e-06,5,1.1390481657907387e-05,0,0
15411,heroic,5,9.182264272911586e-06,5,1.1390481657907387e-05,0,0
15414,witnessing,5,9.182264272911586e-06,5,1.1390481657907387e-05,0,0
15457,#draintheswamp,5,9.182264272911586e-06,5,1.1390481657907387e-05,0,0
15500,retailers,5,9.182264272911586e-06,5,1.1390481657907387e-05,0,0
15503,renovated,5,9.182264272911586e-06,5,1.1390481657907387e-05,0,0
15508,ripoff,5,9.182264272911586e-06,5,1.1390481657907387e-05,0,0
15550,toyota,5,9.182264272911586e-06,5,1.1390481657907387e-05,0,0
15577,catherine,5,9.182264272911586e-06,5,1.1390481657907387e-05,0,0
15578,herridge,5,9.182264272911586e-06,5,1.1390481657907387e-05,0,0
15582,boys,5,9.182264272911586e-06,5,1.1390481657907387e-05,0,0
15600,jared,5,9.182264272911586e-06,5,1.1390481657907387e-05,0,0
15604,spicer,5,9.182264272911586e-06,5,1.1390481657907387e-05,0,0
15633,scaramucci,5,9.182264272911586e-06,5,1.1390481657907387e-05,0,0
15634,whereas,5,9.182264272911586e-06,5,1.1390481657907387e-05,0,0
15642,survivors,5,9.182264272911586e-06,5,1.1390481657907387e-05,0,0
15689,transparent,5,9.182264272911586e-06,5,1.1390481657907387e-05,0,0
15708,#icymi,5,9.182264272911586e-06,5,1.1390481657907387e-05,0,0
15720,accomplishing,5,9.182264272911586e-06,5,1.1390481657907387e-05,0,0
15724,#kateslaw,5,9.182264272911586e-06,5,1.1390481657907387e-05,0,0
15751,#icymi-,5,9.182264272911586e-06,5,1.1390481657907387e-05,0,0
15786,panama,5,9.182264272911586e-06,5,1.1390481657907387e-05,0,0
15826,#americafirst,5,9.182264272911586e-06,5,1.1390481657907387e-05,0,0
15932,charade,5,9.182264272911586e-06,5,1.1390481657907387e-05,0,0
15937,clearance,5,9.182264272911586e-06,5,1.1390481657907387e-05,0,0
15940,emmanuel,5,9.182264272911586e-06,5,1.1390481657907387e-05,0,0
15975,renegotiate,5,9.182264272911586e-06,5,1.1390481657907387e-05,0,0
16024,buzzfeed,5,9.182264272911586e-06,5,1.1390481657907387e-05,0,0
16025,trump-russia,5,9.182264272911586e-06,5,1.1390481657907387e-05,0,0
16033,inexpensive,5,9.182264272911586e-06,5,1.1390481657907387e-05,0,0
16138,cpac,5,9.182264272911586e-06,5,1.1390481657907387e-05,0,0
16153,lopez,5,9.182264272911586e-06,5,1.1390481657907387e-05,0,0
16177,trudeau,5,9.182264272911586e-06,5,1.1390481657907387e-05,0,0
16316,fiat,5,9.182264272911586e-06,5,1.1390481657907387e-05,0,0
16329,conway,5,9.182264272911586e-06,5,1.1390481657907387e-05,0,0
16346,servers,5,9.182264272911586e-06,5,1.1390481657907387e-05,0,0
16448,hw,5,9.182264272911586e-06,5,1.1390481657907387e-05,0,0
16453,omnibus,5,9.182264272911586e-06,5,1.1390481657907387e-05,0,0
16462,inflow,5,9.182264272911586e-06,5,1.1390481657907387e-05,0,0
16496,spin,5,9.182264272911586e-06,5,1.1390481657907387e-05,0,0
16522,smocking,5,9.182264272911586e-06,5,1.1390481657907387e-05,0,0
16528,occasions,5,9.182264272911586e-06,5,1.1390481657907387e-05,0,0
16614,coffers,5,9.182264272911586e-06,5,1.1390481657907387e-05,0,0
16633,quest,5,9.182264272911586e-06,5,1.1390481657907387e-05,0,0
16673,comedian,5,9.182264272911586e-06,5,1.1390481657907387e-05,0,0
16688,gillum,5,9.182264272911586e-06,5,1.1390481657907387e-05,0,0
16694,midterm,5,9.182264272911586e-06,5,1.1390481657907387e-05,0,0
16776,@rondesantisfl,5,9.182264272911586e-06,5,1.1390481657907387e-05,0,0
16805,knight,5,9.182264272911586e-06,5,1.1390481657907387e-05,0,0
16825,staged,5,9.182264272911586e-06,5,1.1390481657907387e-05,0,0
16856,anti-semitic,5,9.182264272911586e-06,5,1.1390481657907387e-05,0,0
16858,poison,5,9.182264272911586e-06,5,1.1390481657907387e-05,0,0
16857,anti-semitism,5,9.182264272911586e-06,5,1.1390481657907387e-05,0,0
16869,mcsally,5,9.182264272911586e-06,5,1.1390481657907387e-05,0,0
16976,turkish,5,9.182264272911586e-06,5,1.1390481657907387e-05,0,0
16977,nellie,5,9.182264272911586e-06,5,1.1390481657907387e-05,0,0
17013,#hurricanemichael,5,9.182264272911586e-06,5,1.1390481657907387e-05,0,0
17017,overflow,5,9.182264272911586e-06,5,1.1390481657907387e-05,0,0
17033,hardened,5,9.182264272911586e-06,5,1.1390481657907387e-05,0,0
17063,obrador,5,9.182264272911586e-06,5,1.1390481657907387e-05,0,0
17106,unredacted,5,9.182264272911586e-06,5,1.1390481657907387e-05,0,0
17211,barrack,5,9.182264272911586e-06,5,1.1390481657907387e-05,0,0
17258,journalistic,5,9.182264272911586e-06,5,1.1390481657907387e-05,0,0
17263,iranians,5,9.182264272911586e-06,5,1.1390481657907387e-05,0,0
17285,deblasio,5,9.182264272911586e-06,5,1.1390481657907387e-05,0,0
17296,ohrs,5,9.182264272911586e-06,5,1.1390481657907387e-05,0,0
17347,cohens,5,9.182264272911586e-06,5,1.1390481657907387e-05,0,0
17395,existed,5,9.182264272911586e-06,5,1.1390481657907387e-05,0,0
17399,readily,5,9.182264272911586e-06,5,1.1390481657907387e-05,0,0
17404,bribery,5,9.182264272911586e-06,5,1.1390481657907387e-05,0,0
17474,harley,5,9.182264272911586e-06,5,1.1390481657907387e-05,0,0
17512,illicit,5,9.182264272911586e-06,5,1.1390481657907387e-05,0,0
17527,township,5,9.182264272911586e-06,5,1.1390481657907387e-05,0,0
17534,dole,5,9.182264272911586e-06,5,1.1390481657907387e-05,0,0
17589,sinclair,5,9.182264272911586e-06,5,1.1390481657907387e-05,0,0
17598,piggy,5,9.182264272911586e-06,5,1.1390481657907387e-05,0,0
17653,feeding,5,9.182264272911586e-06,5,1.1390481657907387e-05,0,0
17723,nicer,5,9.182264272911586e-06,5,1.1390481657907387e-05,0,0
17740,hating,5,9.182264272911586e-06,5,1.1390481657907387e-05,0,0
17860,@g7,5,9.182264272911586e-06,5,1.1390481657907387e-05,0,0
17875,imbalance,5,9.182264272911586e-06,5,1.1390481657907387e-05,0,0
17916,clemson,5,9.182264272911586e-06,5,1.1390481657907387e-05,0,0
18060,cowards,5,9.182264272911586e-06,5,1.1390481657907387e-05,0,0
18167,maggie,5,9.182264272911586e-06,5,1.1390481657907387e-05,0,0
18217,18th,5,9.182264272911586e-06,5,1.1390481657907387e-05,0,0
18344,saccone,5,9.182264272911586e-06,5,1.1390481657907387e-05,0,0
18414,adept,5,9.182264272911586e-06,5,1.1390481657907387e-05,0,0
18555,dancing,5,9.182264272911586e-06,5,1.1390481657907387e-05,0,0
18679,dingell,5,9.182264272911586e-06,5,1.1390481657907387e-05,0,0
18745,@nato,5,9.182264272911586e-06,5,1.1390481657907387e-05,0,0
19058,testified,5,9.182264272911586e-06,5,1.1390481657907387e-05,0,0
19438,euro,5,9.182264272911586e-06,5,1.1390481657907387e-05,0,0
19458,#nc03,5,9.182264272911586e-06,5,1.1390481657907387e-05,0,0
19567,foul,5,9.182264272911586e-06,5,1.1390481657907387e-05,0,0
19618,biarritz,5,9.182264272911586e-06,5,1.1390481657907387e-05,0,0
20266,expedition,5,9.182264272911586e-06,5,1.1390481657907387e-05,0,0
20299,coyotes,5,9.182264272911586e-06,5,1.1390481657907387e-05,0,0
20556,aspect,5,9.182264272911586e-06,5,1.1390481657907387e-05,0,0
20600,sri,5,9.182264272911586e-06,5,1.1390481657907387e-05,0,0
20598,lanka,5,9.182264272911586e-06,5,1.1390481657907387e-05,0,0
20837,manuscript,5,9.182264272911586e-06,5,1.1390481657907387e-05,0,0
20884,venezuelan,5,9.182264272911586e-06,5,1.1390481657907387e-05,0,0
149,deck,4,7.3458114183292686e-06,2,4.556192663162955e-06,2,1.8945673281864254e-05
169,#parisagreement,4,7.3458114183292686e-06,0,0,4,3.789134656372851e-05
201,motivation,4,7.3458114183292686e-06,1,2.2780963315814773e-06,3,2.8418509922796382e-05
222,tackling,4,7.3458114183292686e-06,0,0,4,3.789134656372851e-05
235,no-brainer,4,7.3458114183292686e-06,0,0,4,3.789134656372851e-05
276,recommit,4,7.3458114183292686e-06,1,2.2780963315814773e-06,3,2.8418509922796382e-05
302,✓,4,7.3458114183292686e-06,0,0,4,3.789134656372851e-05
372,man-made,4,7.3458114183292686e-06,0,0,4,3.789134656372851e-05
482,choosing,4,7.3458114183292686e-06,2,4.556192663162955e-06,2,1.8945673281864254e-05
485,kid,4,7.3458114183292686e-06,0,0,4,3.789134656372851e-05
544,105,4,7.3458114183292686e-06,2,4.556192663162955e-06,2,1.8945673281864254e-05
640,organizers,4,7.3458114183292686e-06,0,0,4,3.789134656372851e-05
644,donor,4,7.3458114183292686e-06,1,2.2780963315814773e-06,3,2.8418509922796382e-05
699,yom,4,7.3458114183292686e-06,2,4.556192663162955e-06,2,1.8945673281864254e-05
735,#roshhashanah,4,7.3458114183292686e-06,1,2.2780963315814773e-06,3,2.8418509922796382e-05
741,affordability,4,7.3458114183292686e-06,0,0,4,3.789134656372851e-05
780,#laborday,4,7.3458114183292686e-06,1,2.2780963315814773e-06,3,2.8418509922796382e-05
814,#fixovertime,4,7.3458114183292686e-06,0,0,4,3.789134656372851e-05
833,#womensequalityday,4,7.3458114183292686e-06,0,0,4,3.789134656372851e-05
836,poses,4,7.3458114183292686e-06,0,0,4,3.789134656372851e-05
837,#findyourpark,4,7.3458114183292686e-06,0,0,4,3.789134656372851e-05
885,studies,4,7.3458114183292686e-06,3,6.8342889947444315e-06,1,9.472836640932127e-06
945,prevents,4,7.3458114183292686e-06,2,4.556192663162955e-06,2,1.8945673281864254e-05
966,examine,4,7.3458114183292686e-06,3,6.8342889947444315e-06,1,9.472836640932127e-06
1027,pledging,4,7.3458114183292686e-06,1,2.2780963315814773e-06,3,2.8418509922796382e-05
1042,disabilities,4,7.3458114183292686e-06,0,0,4,3.789134656372851e-05
1120,sentenced,4,7.3458114183292686e-06,3,6.8342889947444315e-06,1,9.472836640932127e-06
1125,questioned,4,7.3458114183292686e-06,3,6.8342889947444315e-06,1,9.472836640932127e-06
1131,latinos,4,7.3458114183292686e-06,2,4.556192663162955e-06,2,1.8945673281864254e-05
1130,inmates,4,7.3458114183292686e-06,2,4.556192663162955e-06,2,1.8945673281864254e-05
1153,singing,4,7.3458114183292686e-06,0,0,4,3.789134656372851e-05
1165,acres,4,7.3458114183292686e-06,3,6.8342889947444315e-06,1,9.472836640932127e-06
1215,somewhere,4,7.3458114183292686e-06,1,2.2780963315814773e-06,3,2.8418509922796382e-05
1216,128,4,7.3458114183292686e-06,1,2.2780963315814773e-06,3,2.8418509922796382e-05
1224,marry,4,7.3458114183292686e-06,0,0,4,3.789134656372851e-05
1273,reverend,4,7.3458114183292686e-06,3,6.8342889947444315e-06,1,9.472836640932127e-06
1284,vindication,4,7.3458114183292686e-06,3,6.8342889947444315e-06,1,9.472836640932127e-06
1303,benefiting,4,7.3458114183292686e-06,2,4.556192663162955e-06,2,1.8945673281864254e-05
1316,137,4,7.3458114183292686e-06,3,6.8342889947444315e-06,1,9.472836640932127e-06
1322,consistently,4,7.3458114183292686e-06,2,4.556192663162955e-06,2,1.8945673281864254e-05
1399,drinking,4,7.3458114183292686e-06,0,0,4,3.789134656372851e-05
1416,warmer,4,7.3458114183292686e-06,2,4.556192663162955e-06,2,1.8945673281864254e-05
1422,@potus,4,7.3458114183292686e-06,3,6.8342889947444315e-06,1,9.472836640932127e-06
1447,#leadontrade,4,7.3458114183292686e-06,0,0,4,3.789134656372851e-05
1519,inequality,4,7.3458114183292686e-06,0,0,4,3.789134656372851e-05
1531,birthright,4,7.3458114183292686e-06,3,6.8342889947444315e-06,1,9.472836640932127e-06
1545,everglades,4,7.3458114183292686e-06,2,4.556192663162955e-06,2,1.8945673281864254e-05
1547,treasures,4,7.3458114183292686e-06,2,4.556192663162955e-06,2,1.8945673281864254e-05
1585,chag,4,7.3458114183292686e-06,0,0,4,3.789134656372851e-05
1586,sameach,4,7.3458114183292686e-06,0,0,4,3.789134656372851e-05
1618,hotel,4,7.3458114183292686e-06,2,4.556192663162955e-06,2,1.8945673281864254e-05
1674,trickle-down,4,7.3458114183292686e-06,0,0,4,3.789134656372851e-05
1685,strides,4,7.3458114183292686e-06,2,4.556192663162955e-06,2,1.8945673281864254e-05
1698,reserved,4,7.3458114183292686e-06,0,0,4,3.789134656372851e-05
1729,shed,4,7.3458114183292686e-06,2,4.556192663162955e-06,2,1.8945673281864254e-05
1731,taught,4,7.3458114183292686e-06,2,4.556192663162955e-06,2,1.8945673281864254e-05
1732,draw,4,7.3458114183292686e-06,2,4.556192663162955e-06,2,1.8945673281864254e-05
1774,crises,4,7.3458114183292686e-06,1,2.2780963315814773e-06,3,2.8418509922796382e-05
1815,aired,4,7.3458114183292686e-06,3,6.8342889947444315e-06,1,9.472836640932127e-06
1857,fresh,4,7.3458114183292686e-06,3,6.8342889947444315e-06,1,9.472836640932127e-06
1908,graduating,4,7.3458114183292686e-06,2,4.556192663162955e-06,2,1.8945673281864254e-05
1918,#mlkday,4,7.3458114183292686e-06,2,4.556192663162955e-06,2,1.8945673281864254e-05
1934,twenty,4,7.3458114183292686e-06,1,2.2780963315814773e-06,3,2.8418509922796382e-05
1938,wheel,4,7.3458114183292686e-06,3,6.8342889947444315e-06,1,9.472836640932127e-06
1935,#cybersecurity,4,7.3458114183292686e-06,0,0,4,3.789134656372851e-05
2014,#joiningforces,4,7.3458114183292686e-06,0,0,4,3.789134656372851e-05
2086,describing,4,7.3458114183292686e-06,3,6.8342889947444315e-06,1,9.472836640932127e-06
2135,treats,4,7.3458114183292686e-06,2,4.556192663162955e-06,2,1.8945673281864254e-05
2138,scared,4,7.3458114183292686e-06,3,6.8342889947444315e-06,1,9.472836640932127e-06
2194,nobel,4,7.3458114183292686e-06,3,6.8342889947444315e-06,1,9.472836640932127e-06
2283,campus,4,7.3458114183292686e-06,3,6.8342889947444315e-06,1,9.472836640932127e-06
2288,charter,4,7.3458114183292686e-06,3,6.8342889947444315e-06,1,9.472836640932127e-06
2289,defined,4,7.3458114183292686e-06,2,4.556192663162955e-06,2,1.8945673281864254e-05
2368,openings,4,7.3458114183292686e-06,3,6.8342889947444315e-06,1,9.472836640932127e-06
2436,#livethewage,4,7.3458114183292686e-06,0,0,4,3.789134656372851e-05
2447,stubborn,4,7.3458114183292686e-06,2,4.556192663162955e-06,2,1.8945673281864254e-05
2460,tools,4,7.3458114183292686e-06,1,2.2780963315814773e-06,3,2.8418509922796382e-05
2463,#lgbt,4,7.3458114183292686e-06,0,0,4,3.789134656372851e-05
2476,motto,4,7.3458114183292686e-06,2,4.556192663162955e-06,2,1.8945673281864254e-05
2478,congestion,4,7.3458114183292686e-06,3,6.8342889947444315e-06,1,9.472836640932127e-06
2542,sister,4,7.3458114183292686e-06,3,6.8342889947444315e-06,1,9.472836640932127e-06
2569,identity,4,7.3458114183292686e-06,2,4.556192663162955e-06,2,1.8945673281864254e-05
2580,ages,4,7.3458114183292686e-06,1,2.2780963315814773e-06,3,2.8418509922796382e-05
2603,smiles,4,7.3458114183292686e-06,1,2.2780963315814773e-06,3,2.8418509922796382e-05
2612,survival,4,7.3458114183292686e-06,2,4.556192663162955e-06,2,1.8945673281864254e-05
2615,aggressive,4,7.3458114183292686e-06,3,6.8342889947444315e-06,1,9.472836640932127e-06
2673,stalling,4,7.3458114183292686e-06,1,2.2780963315814773e-06,3,2.8418509922796382e-05
2711,marathon,4,7.3458114183292686e-06,2,4.556192663162955e-06,2,1.8945673281864254e-05
2733,episode,4,7.3458114183292686e-06,0,0,4,3.789134656372851e-05
2742,minnesotas,4,7.3458114183292686e-06,2,4.556192663162955e-06,2,1.8945673281864254e-05
2747,cents,4,7.3458114183292686e-06,1,2.2780963315814773e-06,3,2.8418509922796382e-05
2793,spectrum,4,7.3458114183292686e-06,3,6.8342889947444315e-06,1,9.472836640932127e-06
2854,hoops,4,7.3458114183292686e-06,0,0,4,3.789134656372851e-05
2874,invincible,4,7.3458114183292686e-06,2,4.556192663162955e-06,2,1.8945673281864254e-05
2897,focuses,4,7.3458114183292686e-06,2,4.556192663162955e-06,2,1.8945673281864254e-05
2915,punish,4,7.3458114183292686e-06,3,6.8342889947444315e-06,1,9.472836640932127e-06
2934,adult,4,7.3458114183292686e-06,2,4.556192663162955e-06,2,1.8945673281864254e-05
2936,grade,4,7.3458114183292686e-06,2,4.556192663162955e-06,2,1.8945673281864254e-05
2964,prouder,4,7.3458114183292686e-06,0,0,4,3.789134656372851e-05
2969,discovery,4,7.3458114183292686e-06,1,2.2780963315814773e-06,3,2.8418509922796382e-05
2973,fortunate,4,7.3458114183292686e-06,1,2.2780963315814773e-06,3,2.8418509922796382e-05
3002,essence,4,7.3458114183292686e-06,2,4.556192663162955e-06,2,1.8945673281864254e-05
3011,drought,4,7.3458114183292686e-06,2,4.556192663162955e-06,2,1.8945673281864254e-05
3017,valentines,4,7.3458114183292686e-06,0,0,4,3.789134656372851e-05
3059,withholding,4,7.3458114183292686e-06,3,6.8342889947444315e-06,1,9.472836640932127e-06
3071,sunny,4,7.3458114183292686e-06,0,0,4,3.789134656372851e-05
3162,firmly,4,7.3458114183292686e-06,3,6.8342889947444315e-06,1,9.472836640932127e-06
3198,zip,4,7.3458114183292686e-06,1,2.2780963315814773e-06,3,2.8418509922796382e-05
3215,extending,4,7.3458114183292686e-06,0,0,4,3.789134656372851e-05
3303,lived,4,7.3458114183292686e-06,3,6.8342889947444315e-06,1,9.472836640932127e-06
3318,scope,4,7.3458114183292686e-06,3,6.8342889947444315e-06,1,9.472836640932127e-06
3322,declining,4,7.3458114183292686e-06,3,6.8342889947444315e-06,1,9.472836640932127e-06
3329,150th,4,7.3458114183292686e-06,2,4.556192663162955e-06,2,1.8945673281864254e-05
3418,congratulates,4,7.3458114183292686e-06,1,2.2780963315814773e-06,3,2.8418509922796382e-05
3462,recipient,4,7.3458114183292686e-06,3,6.8342889947444315e-06,1,9.472836640932127e-06
3461,formal,4,7.3458114183292686e-06,3,6.8342889947444315e-06,1,9.472836640932127e-06
3509,#justvote,4,7.3458114183292686e-06,0,0,4,3.789134656372851e-05
3594,whove,4,7.3458114183292686e-06,1,2.2780963315814773e-06,3,2.8418509922796382e-05
3630,battlefield,4,7.3458114183292686e-06,3,6.8342889947444315e-06,1,9.472836640932127e-06
3656,oct,4,7.3458114183292686e-06,0,0,4,3.789134656372851e-05
3697,deferred,4,7.3458114183292686e-06,1,2.2780963315814773e-06,3,2.8418509922796382e-05
3758,40th,4,7.3458114183292686e-06,1,2.2780963315814773e-06,3,2.8418509922796382e-05
3774,predict,4,7.3458114183292686e-06,3,6.8342889947444315e-06,1,9.472836640932127e-06
3786,pillar,4,7.3458114183292686e-06,3,6.8342889947444315e-06,1,9.472836640932127e-06
3800,solves,4,7.3458114183292686e-06,3,6.8342889947444315e-06,1,9.472836640932127e-06
3806,johns,4,7.3458114183292686e-06,2,4.556192663162955e-06,2,1.8945673281864254e-05
3817,undermines,4,7.3458114183292686e-06,2,4.556192663162955e-06,2,1.8945673281864254e-05
3829,mens,4,7.3458114183292686e-06,0,0,4,3.789134656372851e-05
3831,cameras,4,7.3458114183292686e-06,3,6.8342889947444315e-06,1,9.472836640932127e-06
3869,#takeittothehouse,4,7.3458114183292686e-06,0,0,4,3.789134656372851e-05
3918,congratulating,4,7.3458114183292686e-06,2,4.556192663162955e-06,2,1.8945673281864254e-05
3927,grandchildren,4,7.3458114183292686e-06,2,4.556192663162955e-06,2,1.8945673281864254e-05
3958,shores,4,7.3458114183292686e-06,3,6.8342889947444315e-06,1,9.472836640932127e-06
3960,unite,4,7.3458114183292686e-06,3,6.8342889947444315e-06,1,9.472836640932127e-06
3970,torn,4,7.3458114183292686e-06,3,6.8342889947444315e-06,1,9.472836640932127e-06
3974,antonio,4,7.3458114183292686e-06,2,4.556192663162955e-06,2,1.8945673281864254e-05
4048,columbia,4,7.3458114183292686e-06,3,6.8342889947444315e-06,1,9.472836640932127e-06
4053,pakistani,4,7.3458114183292686e-06,3,6.8342889947444315e-06,1,9.472836640932127e-06
4061,embarrassing,4,7.3458114183292686e-06,3,6.8342889947444315e-06,1,9.472836640932127e-06
4089,selflessly,4,7.3458114183292686e-06,3,6.8342889947444315e-06,1,9.472836640932127e-06
4098,senseless,4,7.3458114183292686e-06,2,4.556192663162955e-06,2,1.8945673281864254e-05
4115,content,4,7.3458114183292686e-06,2,4.556192663162955e-06,2,1.8945673281864254e-05
4127,portrait,4,7.3458114183292686e-06,3,6.8342889947444315e-06,1,9.472836640932127e-06
4130,murdered,4,7.3458114183292686e-06,2,4.556192663162955e-06,2,1.8945673281864254e-05
4141,#ofaclimate,4,7.3458114183292686e-06,0,0,4,3.789134656372851e-05
4149,cried,4,7.3458114183292686e-06,3,6.8342889947444315e-06,1,9.472836640932127e-06
4154,1968,4,7.3458114183292686e-06,0,0,4,3.789134656372851e-05
4156,saves,4,7.3458114183292686e-06,1,2.2780963315814773e-06,3,2.8418509922796382e-05
4159,someplace,4,7.3458114183292686e-06,3,6.8342889947444315e-06,1,9.472836640932127e-06
4178,malia,4,7.3458114183292686e-06,0,0,4,3.789134656372851e-05
4180,sasha,4,7.3458114183292686e-06,0,0,4,3.789134656372851e-05
4190,francis,4,7.3458114183292686e-06,3,6.8342889947444315e-06,1,9.472836640932127e-06
4210,#vawa,4,7.3458114183292686e-06,0,0,4,3.789134656372851e-05
4212,happiness,4,7.3458114183292686e-06,0,0,4,3.789134656372851e-05
4246,automatic,4,7.3458114183292686e-06,3,6.8342889947444315e-06,1,9.472836640932127e-06
4254,civilians,4,7.3458114183292686e-06,3,6.8342889947444315e-06,1,9.472836640932127e-06
4266,harms,4,7.3458114183292686e-06,1,2.2780963315814773e-06,3,2.8418509922796382e-05
4273,tie,4,7.3458114183292686e-06,3,6.8342889947444315e-06,1,9.472836640932127e-06
4287,61,4,7.3458114183292686e-06,2,4.556192663162955e-06,2,1.8945673281864254e-05
4291,beside,4,7.3458114183292686e-06,3,6.8342889947444315e-06,1,9.472836640932127e-06
4320,buyers,4,7.3458114183292686e-06,3,6.8342889947444315e-06,1,9.472836640932127e-06
4328,alike,4,7.3458114183292686e-06,3,6.8342889947444315e-06,1,9.472836640932127e-06
4349,inaugural,4,7.3458114183292686e-06,2,4.556192663162955e-06,2,1.8945673281864254e-05
4393,diminish,4,7.3458114183292686e-06,3,6.8342889947444315e-06,1,9.472836640932127e-06
4394,prospect,4,7.3458114183292686e-06,3,6.8342889947444315e-06,1,9.472836640932127e-06
4433,timeline,4,7.3458114183292686e-06,1,2.2780963315814773e-06,3,2.8418509922796382e-05
4451,aimed,4,7.3458114183292686e-06,2,4.556192663162955e-06,2,1.8945673281864254e-05
4457,web,4,7.3458114183292686e-06,3,6.8342889947444315e-06,1,9.472836640932127e-06
4483,wasserman,4,7.3458114183292686e-06,3,6.8342889947444315e-06,1,9.472836640932127e-06
4491,reward,4,7.3458114183292686e-06,0,0,4,3.789134656372851e-05
4496,mate,4,7.3458114183292686e-06,1,2.2780963315814773e-06,3,2.8418509922796382e-05
4520,definition,4,7.3458114183292686e-06,3,6.8342889947444315e-06,1,9.472836640932127e-06
4540,#voteobama,4,7.3458114183292686e-06,0,0,4,3.789134656372851e-05
4562,tells,4,7.3458114183292686e-06,2,4.556192663162955e-06,2,1.8945673281864254e-05
4580,18000,4,7.3458114183292686e-06,2,4.556192663162955e-06,2,1.8945673281864254e-05
4583,knocking,4,7.3458114183292686e-06,2,4.556192663162955e-06,2,1.8945673281864254e-05
4633,visions,4,7.3458114183292686e-06,1,2.2780963315814773e-06,3,2.8418509922796382e-05
4671,compassion,4,7.3458114183292686e-06,3,6.8342889947444315e-06,1,9.472836640932127e-06
4730,accomplishment,4,7.3458114183292686e-06,2,4.556192663162955e-06,2,1.8945673281864254e-05
4756,ia,4,7.3458114183292686e-06,3,6.8342889947444315e-06,1,9.472836640932127e-06
4772,#gottavote,4,7.3458114183292686e-06,0,0,4,3.789134656372851e-05
4778,abortions,4,7.3458114183292686e-06,0,0,4,3.789134656372851e-05
4804,richmond,4,7.3458114183292686e-06,1,2.2780963315814773e-06,3,2.8418509922796382e-05
4854,spotted,4,7.3458114183292686e-06,2,4.556192663162955e-06,2,1.8945673281864254e-05
4857,bye,4,7.3458114183292686e-06,3,6.8342889947444315e-06,1,9.472836640932127e-06
4868,gonna,4,7.3458114183292686e-06,0,0,4,3.789134656372851e-05
4899,messina,4,7.3458114183292686e-06,0,0,4,3.789134656372851e-05
4947,forgetting,4,7.3458114183292686e-06,2,4.556192663162955e-06,2,1.8945673281864254e-05
4979,kicked,4,7.3458114183292686e-06,1,2.2780963315814773e-06,3,2.8418509922796382e-05
4990,libya,4,7.3458114183292686e-06,1,2.2780963315814773e-06,3,2.8418509922796382e-05
5020,overturning,4,7.3458114183292686e-06,1,2.2780963315814773e-06,3,2.8418509922796382e-05
5023,insult,4,7.3458114183292686e-06,3,6.8342889947444315e-06,1,9.472836640932127e-06
5049,nonpartisan,4,7.3458114183292686e-06,1,2.2780963315814773e-06,3,2.8418509922796382e-05
5050,@michelleobamas,4,7.3458114183292686e-06,0,0,4,3.789134656372851e-05
5097,habits,4,7.3458114183292686e-06,2,4.556192663162955e-06,2,1.8945673281864254e-05
5112,usas,4,7.3458114183292686e-06,3,6.8342889947444315e-06,1,9.472836640932127e-06
5137,qaeda,4,7.3458114183292686e-06,1,2.2780963315814773e-06,3,2.8418509922796382e-05
5183,married,4,7.3458114183292686e-06,2,4.556192663162955e-06,2,1.8945673281864254e-05
5246,battleground,4,7.3458114183292686e-06,3,6.8342889947444315e-06,1,9.472836640932127e-06
5248,introduced,4,7.3458114183292686e-06,3,6.8342889947444315e-06,1,9.472836640932127e-06
5265,generate,4,7.3458114183292686e-06,1,2.2780963315814773e-06,3,2.8418509922796382e-05
5278,insulting,4,7.3458114183292686e-06,3,6.8342889947444315e-06,1,9.472836640932127e-06
5289,meanwhile,4,7.3458114183292686e-06,3,6.8342889947444315e-06,1,9.472836640932127e-06
5339,spots,4,7.3458114183292686e-06,3,6.8342889947444315e-06,1,9.472836640932127e-06
5345,crumbling,4,7.3458114183292686e-06,3,6.8342889947444315e-06,1,9.472836640932127e-06
5344,classroom,4,7.3458114183292686e-06,0,0,4,3.789134656372851e-05
5361,famous,4,7.3458114183292686e-06,2,4.556192663162955e-06,2,1.8945673281864254e-05
5420,stickers,4,7.3458114183292686e-06,0,0,4,3.789134656372851e-05
5423,philosophy,4,7.3458114183292686e-06,3,6.8342889947444315e-06,1,9.472836640932127e-06
5479,calculator,4,7.3458114183292686e-06,0,0,4,3.789134656372851e-05
5524,certificate,4,7.3458114183292686e-06,0,0,4,3.789134656372851e-05
5526,song,4,7.3458114183292686e-06,2,4.556192663162955e-06,2,1.8945673281864254e-05
5533,325000,4,7.3458114183292686e-06,1,2.2780963315814773e-06,3,2.8418509922796382e-05
5557,incest,4,7.3458114183292686e-06,1,2.2780963315814773e-06,3,2.8418509922796382e-05
5572,716,4,7.3458114183292686e-06,3,6.8342889947444315e-06,1,9.472836640932127e-06
5637,springs,4,7.3458114183292686e-06,3,6.8342889947444315e-06,1,9.472836640932127e-06
5648,kagan,4,7.3458114183292686e-06,0,0,4,3.789134656372851e-05
5671,champ,4,7.3458114183292686e-06,3,6.8342889947444315e-06,1,9.472836640932127e-06
5699,posting,4,7.3458114183292686e-06,3,6.8342889947444315e-06,1,9.472836640932127e-06
5732,refinance,4,7.3458114183292686e-06,1,2.2780963315814773e-06,3,2.8418509922796382e-05
5743,sheet,4,7.3458114183292686e-06,2,4.556192663162955e-06,2,1.8945673281864254e-05
5783,reclaim,4,7.3458114183292686e-06,3,6.8342889947444315e-06,1,9.472836640932127e-06
5791,qualify,4,7.3458114183292686e-06,3,6.8342889947444315e-06,1,9.472836640932127e-06
5800,brink,4,7.3458114183292686e-06,1,2.2780963315814773e-06,3,2.8418509922796382e-05
5807,apologies,4,7.3458114183292686e-06,3,6.8342889947444315e-06,1,9.472836640932127e-06
5811,filings,4,7.3458114183292686e-06,3,6.8342889947444315e-06,1,9.472836640932127e-06
5830,prevented,4,7.3458114183292686e-06,1,2.2780963315814773e-06,3,2.8418509922796382e-05
5850,swiss,4,7.3458114183292686e-06,2,4.556192663162955e-06,2,1.8945673281864254e-05
5849,offshore,4,7.3458114183292686e-06,0,0,4,3.789134656372851e-05
5848,finances,4,7.3458114183292686e-06,3,6.8342889947444315e-06,1,9.472836640932127e-06
5851,@truthteam2012,4,7.3458114183292686e-06,0,0,4,3.789134656372851e-05
5905,graduates,4,7.3458114183292686e-06,0,0,4,3.789134656372851e-05
5928,apparently,4,7.3458114183292686e-06,3,6.8342889947444315e-06,1,9.472836640932127e-06
5946,145pm,4,7.3458114183292686e-06,1,2.2780963315814773e-06,3,2.8418509922796382e-05
5963,145,4,7.3458114183292686e-06,3,6.8342889947444315e-06,1,9.472836640932127e-06
5970,8th,4,7.3458114183292686e-06,3,6.8342889947444315e-06,1,9.472836640932127e-06
5975,arguing,4,7.3458114183292686e-06,2,4.556192663162955e-06,2,1.8945673281864254e-05
6004,stormed,4,7.3458114183292686e-06,3,6.8342889947444315e-06,1,9.472836640932127e-06
6040,sonia,4,7.3458114183292686e-06,0,0,4,3.789134656372851e-05
6044,invite,4,7.3458114183292686e-06,3,6.8342889947444315e-06,1,9.472836640932127e-06
6066,erase,4,7.3458114183292686e-06,3,6.8342889947444315e-06,1,9.472836640932127e-06
6077,100m,4,7.3458114183292686e-06,3,6.8342889947444315e-06,1,9.472836640932127e-06
6080,hood,4,7.3458114183292686e-06,3,6.8342889947444315e-06,1,9.472836640932127e-06
6096,license,4,7.3458114183292686e-06,3,6.8342889947444315e-06,1,9.472836640932127e-06
6097,jessica,4,7.3458114183292686e-06,2,4.556192663162955e-06,2,1.8945673281864254e-05
6102,drove,4,7.3458114183292686e-06,2,4.556192663162955e-06,2,1.8945673281864254e-05
6168,podium,4,7.3458114183292686e-06,2,4.556192663162955e-06,2,1.8945673281864254e-05
6200,convinced,4,7.3458114183292686e-06,3,6.8342889947444315e-06,1,9.472836640932127e-06
6252,environmentalists,4,7.3458114183292686e-06,1,2.2780963315814773e-06,3,2.8418509922796382e-05
6258,relied,4,7.3458114183292686e-06,3,6.8342889947444315e-06,1,9.472836640932127e-06
6274,8000,4,7.3458114183292686e-06,3,6.8342889947444315e-06,1,9.472836640932127e-06
6283,driver,4,7.3458114183292686e-06,2,4.556192663162955e-06,2,1.8945673281864254e-05
6295,shocked,4,7.3458114183292686e-06,3,6.8342889947444315e-06,1,9.472836640932127e-06
6316,financing,4,7.3458114183292686e-06,2,4.556192663162955e-06,2,1.8945673281864254e-05
6335,giveaways,4,7.3458114183292686e-06,1,2.2780963315814773e-06,3,2.8418509922796382e-05
6339,videos,4,7.3458114183292686e-06,2,4.556192663162955e-06,2,1.8945673281864254e-05
6421,limited-edition,4,7.3458114183292686e-06,0,0,4,3.789134656372851e-05
6437,controls,4,7.3458114183292686e-06,3,6.8342889947444315e-06,1,9.472836640932127e-06
6462,overnight,4,7.3458114183292686e-06,3,6.8342889947444315e-06,1,9.472836640932127e-06
6480,@maddow,4,7.3458114183292686e-06,3,6.8342889947444315e-06,1,9.472836640932127e-06
6492,israels,4,7.3458114183292686e-06,3,6.8342889947444315e-06,1,9.472836640932127e-06
6500,offices,4,7.3458114183292686e-06,3,6.8342889947444315e-06,1,9.472836640932127e-06
6516,koch,4,7.3458114183292686e-06,3,6.8342889947444315e-06,1,9.472836640932127e-06
6533,rounds,4,7.3458114183292686e-06,3,6.8342889947444315e-06,1,9.472836640932127e-06
6630,lauer,4,7.3458114183292686e-06,3,6.8342889947444315e-06,1,9.472836640932127e-06
6701,#mlk2012,4,7.3458114183292686e-06,0,0,4,3.789134656372851e-05
6709,mlk,4,7.3458114183292686e-06,1,2.2780963315814773e-06,3,2.8418509922796382e-05
6711,stamped,4,7.3458114183292686e-06,2,4.556192663162955e-06,2,1.8945673281864254e-05
6751,ideology,4,7.3458114183292686e-06,3,6.8342889947444315e-06,1,9.472836640932127e-06
6755,circus,4,7.3458114183292686e-06,3,6.8342889947444315e-06,1,9.472836640932127e-06
6766,meal,4,7.3458114183292686e-06,0,0,4,3.789134656372851e-05
6779,tracking,4,7.3458114183292686e-06,3,6.8342889947444315e-06,1,9.472836640932127e-06
6782,once-in-a-generation,4,7.3458114183292686e-06,2,4.556192663162955e-06,2,1.8945673281864254e-05
6809,warfare,4,7.3458114183292686e-06,2,4.556192663162955e-06,2,1.8945673281864254e-05
6837,pardons,4,7.3458114183292686e-06,3,6.8342889947444315e-06,1,9.472836640932127e-06
6850,credits,4,7.3458114183292686e-06,1,2.2780963315814773e-06,3,2.8418509922796382e-05
6856,hires,4,7.3458114183292686e-06,3,6.8342889947444315e-06,1,9.472836640932127e-06
6860,pledges,4,7.3458114183292686e-06,3,6.8342889947444315e-06,1,9.472836640932127e-06
6881,casey,4,7.3458114183292686e-06,3,6.8342889947444315e-06,1,9.472836640932127e-06
6930,captain,4,7.3458114183292686e-06,3,6.8342889947444315e-06,1,9.472836640932127e-06
6945,stem,4,7.3458114183292686e-06,3,6.8342889947444315e-06,1,9.472836640932127e-06
6959,hivaids,4,7.3458114183292686e-06,2,4.556192663162955e-06,2,1.8945673281864254e-05
6968,beer,4,7.3458114183292686e-06,3,6.8342889947444315e-06,1,9.472836640932127e-06
6972,backtrack,4,7.3458114183292686e-06,0,0,4,3.789134656372851e-05
6983,bargaining,4,7.3458114183292686e-06,3,6.8342889947444315e-06,1,9.472836640932127e-06
7008,legion,4,7.3458114183292686e-06,3,6.8342889947444315e-06,1,9.472836640932127e-06
7028,19th,4,7.3458114183292686e-06,3,6.8342889947444315e-06,1,9.472836640932127e-06
7057,conviction,4,7.3458114183292686e-06,3,6.8342889947444315e-06,1,9.472836640932127e-06
7064,cos,4,7.3458114183292686e-06,3,6.8342889947444315e-06,1,9.472836640932127e-06
7231,giants,4,7.3458114183292686e-06,3,6.8342889947444315e-06,1,9.472836640932127e-06
7258,lauren,4,7.3458114183292686e-06,3,6.8342889947444315e-06,1,9.472836640932127e-06
7265,erin,4,7.3458114183292686e-06,3,6.8342889947444315e-06,1,9.472836640932127e-06
7268,jeanne,4,7.3458114183292686e-06,3,6.8342889947444315e-06,1,9.472836640932127e-06
7294,manage,4,7.3458114183292686e-06,3,6.8342889947444315e-06,1,9.472836640932127e-06
7346,advise,4,7.3458114183292686e-06,3,6.8342889947444315e-06,1,9.472836640932127e-06
7355,unleashing,4,7.3458114183292686e-06,3,6.8342889947444315e-06,1,9.472836640932127e-06
7387,observe,4,7.3458114183292686e-06,3,6.8342889947444315e-06,1,9.472836640932127e-06
7420,@presssec,4,7.3458114183292686e-06,2,4.556192663162955e-06,2,1.8945673281864254e-05
7438,dig,4,7.3458114183292686e-06,3,6.8342889947444315e-06,1,9.472836640932127e-06
7441,appearing,4,7.3458114183292686e-06,3,6.8342889947444315e-06,1,9.472836640932127e-06
7470,haul,4,7.3458114183292686e-06,2,4.556192663162955e-06,2,1.8945673281864254e-05
7485,small-business,4,7.3458114183292686e-06,3,6.8342889947444315e-06,1,9.472836640932127e-06
7537,disclose,4,7.3458114183292686e-06,3,6.8342889947444315e-06,1,9.472836640932127e-06
7544,steady,4,7.3458114183292686e-06,3,6.8342889947444315e-06,1,9.472836640932127e-06
7580,addiction,4,7.3458114183292686e-06,3,6.8342889947444315e-06,1,9.472836640932127e-06
7586,unfolding,4,7.3458114183292686e-06,3,6.8342889947444315e-06,1,9.472836640932127e-06
7595,backing,4,7.3458114183292686e-06,3,6.8342889947444315e-06,1,9.472836640932127e-06
7600,sights,4,7.3458114183292686e-06,3,6.8342889947444315e-06,1,9.472836640932127e-06
7619,@statedept,4,7.3458114183292686e-06,3,6.8342889947444315e-06,1,9.472836640932127e-06
7624,historys,4,7.3458114183292686e-06,1,2.2780963315814773e-06,3,2.8418509922796382e-05
7644,disposal,4,7.3458114183292686e-06,3,6.8342889947444315e-06,1,9.472836640932127e-06
7646,advancing,4,7.3458114183292686e-06,3,6.8342889947444315e-06,1,9.472836640932127e-06
7656,commitments,4,7.3458114183292686e-06,3,6.8342889947444315e-06,1,9.472836640932127e-06
7660,mourning,4,7.3458114183292686e-06,2,4.556192663162955e-06,2,1.8945673281864254e-05
7667,nationals,4,7.3458114183292686e-06,3,6.8342889947444315e-06,1,9.472836640932127e-06
7671,moscow,4,7.3458114183292686e-06,3,6.8342889947444315e-06,1,9.472836640932127e-06
7670,metro,4,7.3458114183292686e-06,3,6.8342889947444315e-06,1,9.472836640932127e-06
7704,wondering,4,7.3458114183292686e-06,3,6.8342889947444315e-06,1,9.472836640932127e-06
7705,donating,4,7.3458114183292686e-06,3,6.8342889947444315e-06,1,9.472836640932127e-06
7726,institutions,4,7.3458114183292686e-06,3,6.8342889947444315e-06,1,9.472836640932127e-06
7744,#masen,4,7.3458114183292686e-06,0,0,4,3.789134656372851e-05
7754,haiti,4,7.3458114183292686e-06,2,4.556192663162955e-06,2,1.8945673281864254e-05
7888,identification,4,7.3458114183292686e-06,4,9.11238532632591e-06,0,0
7917,@senronjohnson,4,7.3458114183292686e-06,4,9.11238532632591e-06,0,0
7969,glitches,4,7.3458114183292686e-06,4,9.11238532632591e-06,0,0
7973,backlash,4,7.3458114183292686e-06,4,9.11238532632591e-06,0,0
7989,@perduesenate,4,7.3458114183292686e-06,4,9.11238532632591e-06,0,0
8020,@fbi,4,7.3458114183292686e-06,4,9.11238532632591e-06,0,0
8031,80000000,4,7.3458114183292686e-06,4,9.11238532632591e-06,0,0
8041,scholars,4,7.3458114183292686e-06,4,9.11238532632591e-06,0,0
8061,@senatorwicker,4,7.3458114183292686e-06,4,9.11238532632591e-06,0,0
8081,tabulation,4,7.3458114183292686e-06,4,9.11238532632591e-06,0,0
8117,corrected,4,7.3458114183292686e-06,4,9.11238532632591e-06,0,0
8154,matching,4,7.3458114183292686e-06,4,9.11238532632591e-06,0,0
8244,postal,4,7.3458114183292686e-06,4,9.11238532632591e-06,0,0
8256,cease,4,7.3458114183292686e-06,4,9.11238532632591e-06,0,0
8287,mcdaniel,4,7.3458114183292686e-06,4,9.11238532632591e-06,0,0
8285,72,4,7.3458114183292686e-06,4,9.11238532632591e-06,0,0
8293,appeal,4,7.3458114183292686e-06,4,9.11238532632591e-06,0,0
8341,wearing,4,7.3458114183292686e-06,4,9.11238532632591e-06,0,0
8381,tremendously,4,7.3458114183292686e-06,4,9.11238532632591e-06,0,0
8400,@cindyhydesmith,4,7.3458114183292686e-06,4,9.11238532632591e-06,0,0
8408,coaches,4,7.3458114183292686e-06,4,9.11238532632591e-06,0,0
8423,scandals,4,7.3458114183292686e-06,4,9.11238532632591e-06,0,0
8425,comment,4,7.3458114183292686e-06,4,9.11238532632591e-06,0,0
8440,coverup,4,7.3458114183292686e-06,4,9.11238532632591e-06,0,0
8453,999,4,7.3458114183292686e-06,4,9.11238532632591e-06,0,0
8460,dominion-izing,4,7.3458114183292686e-06,4,9.11238532632591e-06,0,0
8497,rushing,4,7.3458114183292686e-06,4,9.11238532632591e-06,0,0
8501,g20,4,7.3458114183292686e-06,4,9.11238532632591e-06,0,0
8515,statistically,4,7.3458114183292686e-06,4,9.11238532632591e-06,0,0
8557,rounding,4,7.3458114183292686e-06,4,9.11238532632591e-06,0,0
8559,takedown,4,7.3458114183292686e-06,4,9.11238532632591e-06,0,0
8578,scammed,4,7.3458114183292686e-06,4,9.11238532632591e-06,0,0
8585,victor,4,7.3458114183292686e-06,4,9.11238532632591e-06,0,0
8595,raffensperger,4,7.3458114183292686e-06,4,9.11238532632591e-06,0,0
8597,upholds,4,7.3458114183292686e-06,4,9.11238532632591e-06,0,0
8617,claudia,4,7.3458114183292686e-06,4,9.11238532632591e-06,0,0
8632,alfred,4,7.3458114183292686e-06,4,9.11238532632591e-06,0,0
8636,newman,4,7.3458114183292686e-06,4,9.11238532632591e-06,0,0
8674,scotus,4,7.3458114183292686e-06,4,9.11238532632591e-06,0,0
8678,owens,4,7.3458114183292686e-06,4,9.11238532632591e-06,0,0
8713,predator,4,7.3458114183292686e-06,4,9.11238532632591e-06,0,0
8721,reference,4,7.3458114183292686e-06,4,9.11238532632591e-06,0,0
8812,contractor,4,7.3458114183292686e-06,4,9.11238532632591e-06,0,0
8829,accuracy,4,7.3458114183292686e-06,4,9.11238532632591e-06,0,0
8841,@jiminhofe,4,7.3458114183292686e-06,4,9.11238532632591e-06,0,0
8853,succeeded,4,7.3458114183292686e-06,4,9.11238532632591e-06,0,0
8865,renaming,4,7.3458114183292686e-06,4,9.11238532632591e-06,0,0
8868,slightly,4,7.3458114183292686e-06,4,9.11238532632591e-06,0,0
8870,credible,4,7.3458114183292686e-06,4,9.11238532632591e-06,0,0
8881,dope,4,7.3458114183292686e-06,4,9.11238532632591e-06,0,0
8905,billing,4,7.3458114183292686e-06,4,9.11238532632591e-06,0,0
8969,quarantine,4,7.3458114183292686e-06,4,9.11238532632591e-06,0,0
8993,happier,4,7.3458114183292686e-06,4,9.11238532632591e-06,0,0
9004,revenge,4,7.3458114183292686e-06,4,9.11238532632591e-06,0,0
9030,somalia,4,7.3458114183292686e-06,4,9.11238532632591e-06,0,0
9031,surges,4,7.3458114183292686e-06,4,9.11238532632591e-06,0,0
9034,@senbillcassidy,4,7.3458114183292686e-06,4,9.11238532632591e-06,0,0
9051,overrun,4,7.3458114183292686e-06,4,9.11238532632591e-06,0,0
9058,yvette,4,7.3458114183292686e-06,4,9.11238532632591e-06,0,0
9065,lunatics,4,7.3458114183292686e-06,4,9.11238532632591e-06,0,0
9079,preparation,4,7.3458114183292686e-06,4,9.11238532632591e-06,0,0
9086,lawlessness,4,7.3458114183292686e-06,4,9.11238532632591e-06,0,0
9118,disasters,4,7.3458114183292686e-06,4,9.11238532632591e-06,0,0
9128,claiming,4,7.3458114183292686e-06,4,9.11238532632591e-06,0,0
9166,dumps,4,7.3458114183292686e-06,4,9.11238532632591e-06,0,0
9169,globalist,4,7.3458114183292686e-06,4,9.11238532632591e-06,0,0
9178,#electionday,4,7.3458114183292686e-06,4,9.11238532632591e-06,0,0
9182,@nancymace,4,7.3458114183292686e-06,4,9.11238532632591e-06,0,0
9181,#sc01,4,7.3458114183292686e-06,4,9.11238532632591e-06,0,0
9238,ari,4,7.3458114183292686e-06,4,9.11238532632591e-06,0,0
9244,al-baghdadi,4,7.3458114183292686e-06,4,9.11238532632591e-06,0,0
9246,forging,4,7.3458114183292686e-06,4,9.11238532632591e-06,0,0
9257,superpower,4,7.3458114183292686e-06,4,9.11238532632591e-06,0,0
9277,unheard,4,7.3458114183292686e-06,4,9.11238532632591e-06,0,0
9281,@facebook,4,7.3458114183292686e-06,4,9.11238532632591e-06,0,0
9290,hahn,4,7.3458114183292686e-06,4,9.11238532632591e-06,0,0
9341,hadnt,4,7.3458114183292686e-06,4,9.11238532632591e-06,0,0
9349,sincere,4,7.3458114183292686e-06,4,9.11238532632591e-06,0,0
9374,restored,4,7.3458114183292686e-06,4,9.11238532632591e-06,0,0
9381,miraculously,4,7.3458114183292686e-06,4,9.11238532632591e-06,0,0
9405,merits,4,7.3458114183292686e-06,4,9.11238532632591e-06,0,0
9416,law-abiding,4,7.3458114183292686e-06,4,9.11238532632591e-06,0,0
9418,indoctrinate,4,7.3458114183292686e-06,4,9.11238532632591e-06,0,0
9429,sheriff,4,7.3458114183292686e-06,4,9.11238532632591e-06,0,0
9434,jurisdiction,4,7.3458114183292686e-06,4,9.11238532632591e-06,0,0
9435,harvesting,4,7.3458114183292686e-06,4,9.11238532632591e-06,0,0
9446,indians,4,7.3458114183292686e-06,4,9.11238532632591e-06,0,0
9448,clown,4,7.3458114183292686e-06,4,9.11238532632591e-06,0,0
9450,betrayed,4,7.3458114183292686e-06,4,9.11238532632591e-06,0,0
9452,hispanic-americans,4,7.3458114183292686e-06,4,9.11238532632591e-06,0,0
9456,duties,4,7.3458114183292686e-06,4,9.11238532632591e-06,0,0
9489,commercials,4,7.3458114183292686e-06,4,9.11238532632591e-06,0,0
9503,excoriated,4,7.3458114183292686e-06,4,9.11238532632591e-06,0,0
9506,#trumppence2020,4,7.3458114183292686e-06,4,9.11238532632591e-06,0,0
9512,mills,4,7.3458114183292686e-06,4,9.11238532632591e-06,0,0
9517,rollout,4,7.3458114183292686e-06,4,9.11238532632591e-06,0,0
9582,@fedex,4,7.3458114183292686e-06,4,9.11238532632591e-06,0,0
9589,releases,4,7.3458114183292686e-06,4,9.11238532632591e-06,0,0
9606,@usarmy,4,7.3458114183292686e-06,4,9.11238532632591e-06,0,0
9613,shake,4,7.3458114183292686e-06,4,9.11238532632591e-06,0,0
9615,breakdown,4,7.3458114183292686e-06,4,9.11238532632591e-06,0,0
9644,viewership,4,7.3458114183292686e-06,4,9.11238532632591e-06,0,0
9642,nba,4,7.3458114183292686e-06,4,9.11238532632591e-06,0,0
9658,actuality,4,7.3458114183292686e-06,4,9.11238532632591e-06,0,0
9661,petrified,4,7.3458114183292686e-06,4,9.11238532632591e-06,0,0
9682,500000,4,7.3458114183292686e-06,4,9.11238532632591e-06,0,0
9701,fmr,4,7.3458114183292686e-06,4,9.11238532632591e-06,0,0
9713,ruining,4,7.3458114183292686e-06,4,9.11238532632591e-06,0,0
9772,britain,4,7.3458114183292686e-06,4,9.11238532632591e-06,0,0
9779,wolf,4,7.3458114183292686e-06,4,9.11238532632591e-06,0,0
9806,esper,4,7.3458114183292686e-06,4,9.11238532632591e-06,0,0
9821,estimates,4,7.3458114183292686e-06,4,9.11238532632591e-06,0,0
9824,mi,4,7.3458114183292686e-06,4,9.11238532632591e-06,0,0
9842,walmart,4,7.3458114183292686e-06,4,9.11238532632591e-06,0,0
9858,applications,4,7.3458114183292686e-06,4,9.11238532632591e-06,0,0
9865,lawsuits,4,7.3458114183292686e-06,4,9.11238532632591e-06,0,0
9872,residents,4,7.3458114183292686e-06,4,9.11238532632591e-06,0,0
9921,@russvought45,4,7.3458114183292686e-06,4,9.11238532632591e-06,0,0
9932,glenn,4,7.3458114183292686e-06,4,9.11238532632591e-06,0,0
9931,forrest,4,7.3458114183292686e-06,4,9.11238532632591e-06,0,0
9950,@chatbycc,4,7.3458114183292686e-06,4,9.11238532632591e-06,0,0
9974,bryan,4,7.3458114183292686e-06,4,9.11238532632591e-06,0,0
9981,estate,4,7.3458114183292686e-06,4,9.11238532632591e-06,0,0
9995,witch-hunt,4,7.3458114183292686e-06,4,9.11238532632591e-06,0,0
10015,heartland,4,7.3458114183292686e-06,4,9.11238532632591e-06,0,0
10046,dominant,4,7.3458114183292686e-06,4,9.11238532632591e-06,0,0
10074,@govabbott,4,7.3458114183292686e-06,4,9.11238532632591e-06,0,0
10075,@louisianagov,4,7.3458114183292686e-06,4,9.11238532632591e-06,0,0
10110,acosta,4,7.3458114183292686e-06,4,9.11238532632591e-06,0,0
10121,از,4,7.3458114183292686e-06,4,9.11238532632591e-06,0,0
10166,@senjoniernst,4,7.3458114183292686e-06,4,9.11238532632591e-06,0,0
10254,unanimous,4,7.3458114183292686e-06,4,9.11238532632591e-06,0,0
10274,450,4,7.3458114183292686e-06,4,9.11238532632591e-06,0,0
10275,@charliekirk11,4,7.3458114183292686e-06,4,9.11238532632591e-06,0,0
10278,kirk,4,7.3458114183292686e-06,4,9.11238532632591e-06,0,0
10280,fabled,4,7.3458114183292686e-06,4,9.11238532632591e-06,0,0
10292,ingraham,4,7.3458114183292686e-06,4,9.11238532632591e-06,0,0
10298,monumental,4,7.3458114183292686e-06,4,9.11238532632591e-06,0,0
10306,efficiently,4,7.3458114183292686e-06,4,9.11238532632591e-06,0,0
10364,crashing,4,7.3458114183292686e-06,4,9.11238532632591e-06,0,0
10375,shouting,4,7.3458114183292686e-06,4,9.11238532632591e-06,0,0
10423,cow,4,7.3458114183292686e-06,4,9.11238532632591e-06,0,0
10433,finland,4,7.3458114183292686e-06,4,9.11238532632591e-06,0,0
10453,raided,4,7.3458114183292686e-06,4,9.11238532632591e-06,0,0
10474,rhetoric,4,7.3458114183292686e-06,4,9.11238532632591e-06,0,0
10487,vindman,4,7.3458114183292686e-06,4,9.11238532632591e-06,0,0
10492,boaters,4,7.3458114183292686e-06,4,9.11238532632591e-06,0,0
10518,rare,4,7.3458114183292686e-06,4,9.11238532632591e-06,0,0
10522,hoaxes,4,7.3458114183292686e-06,4,9.11238532632591e-06,0,0
10523,mightily,4,7.3458114183292686e-06,4,9.11238532632591e-06,0,0
10551,@karenhandel,4,7.3458114183292686e-06,4,9.11238532632591e-06,0,0
10562,destabilize,4,7.3458114183292686e-06,4,9.11238532632591e-06,0,0
10581,outdated,4,7.3458114183292686e-06,4,9.11238532632591e-06,0,0
10663,immense,4,7.3458114183292686e-06,4,9.11238532632591e-06,0,0
10688,errors,4,7.3458114183292686e-06,4,9.11238532632591e-06,0,0
10718,rip-off,4,7.3458114183292686e-06,4,9.11238532632591e-06,0,0
10721,overdue,4,7.3458114183292686e-06,4,9.11238532632591e-06,0,0
10727,stimulate,4,7.3458114183292686e-06,4,9.11238532632591e-06,0,0
10766,awaited,4,7.3458114183292686e-06,4,9.11238532632591e-06,0,0
10775,brighter,4,7.3458114183292686e-06,4,9.11238532632591e-06,0,0
10789,pandering,4,7.3458114183292686e-06,4,9.11238532632591e-06,0,0
10813,@tomtiffanywi,4,7.3458114183292686e-06,4,9.11238532632591e-06,0,0
10814,wi07,4,7.3458114183292686e-06,4,9.11238532632591e-06,0,0
10816,#ca25,4,7.3458114183292686e-06,4,9.11238532632591e-06,0,0
10826,tuberville,4,7.3458114183292686e-06,4,9.11238532632591e-06,0,0
10866,discretion,4,7.3458114183292686e-06,4,9.11238532632591e-06,0,0
10873,warfighters,4,7.3458114183292686e-06,4,9.11238532632591e-06,0,0
10880,undo,4,7.3458114183292686e-06,4,9.11238532632591e-06,0,0
10879,rachel,4,7.3458114183292686e-06,4,9.11238532632591e-06,0,0
10884,defective,4,7.3458114183292686e-06,4,9.11238532632591e-06,0,0
10886,dismiss,4,7.3458114183292686e-06,4,9.11238532632591e-06,0,0
10888,obliterated,4,7.3458114183292686e-06,4,9.11238532632591e-06,0,0
10942,@harrisfaulkner,4,7.3458114183292686e-06,4,9.11238532632591e-06,0,0
10952,half-staff,4,7.3458114183292686e-06,4,9.11238532632591e-06,0,0
10987,@lisamarieboothe,4,7.3458114183292686e-06,4,9.11238532632591e-06,0,0
11032,criticism,4,7.3458114183292686e-06,4,9.11238532632591e-06,0,0
11040,kris,4,7.3458114183292686e-06,4,9.11238532632591e-06,0,0
11068,jump,4,7.3458114183292686e-06,4,9.11238532632591e-06,0,0
11077,@herschelwalker,4,7.3458114183292686e-06,4,9.11238532632591e-06,0,0
11100,backup,4,7.3458114183292686e-06,4,9.11238532632591e-06,0,0
11130,compliments,4,7.3458114183292686e-06,4,9.11238532632591e-06,0,0
11137,chelsea,4,7.3458114183292686e-06,4,9.11238532632591e-06,0,0
11149,dismissing,4,7.3458114183292686e-06,4,9.11238532632591e-06,0,0
11157,401-ks,4,7.3458114183292686e-06,4,9.11238532632591e-06,0,0
11203,countless,4,7.3458114183292686e-06,4,9.11238532632591e-06,0,0
11207,@abcworldnews,4,7.3458114183292686e-06,4,9.11238532632591e-06,0,0
11246,politely,4,7.3458114183292686e-06,4,9.11238532632591e-06,0,0
11252,wack,4,7.3458114183292686e-06,4,9.11238532632591e-06,0,0
11272,@mzhemingway,4,7.3458114183292686e-06,4,9.11238532632591e-06,0,0
11280,slime,4,7.3458114183292686e-06,4,9.11238532632591e-06,0,0
11290,trashing,4,7.3458114183292686e-06,4,9.11238532632591e-06,0,0
11298,attended,4,7.3458114183292686e-06,4,9.11238532632591e-06,0,0
11317,@usnationalguard,4,7.3458114183292686e-06,4,9.11238532632591e-06,0,0
11335,profound,4,7.3458114183292686e-06,4,9.11238532632591e-06,0,0
11346,retail,4,7.3458114183292686e-06,4,9.11238532632591e-06,0,0
11352,tone,4,7.3458114183292686e-06,4,9.11238532632591e-06,0,0
11356,@brithume,4,7.3458114183292686e-06,4,9.11238532632591e-06,0,0
11389,evangelical,4,7.3458114183292686e-06,4,9.11238532632591e-06,0,0
11393,watters,4,7.3458114183292686e-06,4,9.11238532632591e-06,0,0
11405,linda,4,7.3458114183292686e-06,4,9.11238532632591e-06,0,0
11416,duped,4,7.3458114183292686e-06,4,9.11238532632591e-06,0,0
11420,@replouiegohmert,4,7.3458114183292686e-06,4,9.11238532632591e-06,0,0
11457,exhausted,4,7.3458114183292686e-06,4,9.11238532632591e-06,0,0
11487,surrounding,4,7.3458114183292686e-06,4,9.11238532632591e-06,0,0
11498,failures,4,7.3458114183292686e-06,4,9.11238532632591e-06,0,0
11500,ineptitude,4,7.3458114183292686e-06,4,9.11238532632591e-06,0,0
11501,jonathan,4,7.3458114183292686e-06,4,9.11238532632591e-06,0,0
11521,closings,4,7.3458114183292686e-06,4,9.11238532632591e-06,0,0
11529,rocking,4,7.3458114183292686e-06,4,9.11238532632591e-06,0,0
11527,@sbagov,4,7.3458114183292686e-06,4,9.11238532632591e-06,0,0
11548,seller,4,7.3458114183292686e-06,4,9.11238532632591e-06,0,0
11553,protesting,4,7.3458114183292686e-06,4,9.11238532632591e-06,0,0
11559,studied,4,7.3458114183292686e-06,4,9.11238532632591e-06,0,0
11560,homan,4,7.3458114183292686e-06,4,9.11238532632591e-06,0,0
11562,allen,4,7.3458114183292686e-06,4,9.11238532632591e-06,0,0
11583,@govmikehuckabee,4,7.3458114183292686e-06,4,9.11238532632591e-06,0,0
11587,@jasoninthehouse,4,7.3458114183292686e-06,4,9.11238532632591e-06,0,0
11591,sane,4,7.3458114183292686e-06,4,9.11238532632591e-06,0,0
11607,description,4,7.3458114183292686e-06,4,9.11238532632591e-06,0,0
11632,defeating,4,7.3458114183292686e-06,4,9.11238532632591e-06,0,0
11646,hockey,4,7.3458114183292686e-06,4,9.11238532632591e-06,0,0
11678,ca25,4,7.3458114183292686e-06,4,9.11238532632591e-06,0,0
11683,thanking,4,7.3458114183292686e-06,4,9.11238532632591e-06,0,0
11691,serves,4,7.3458114183292686e-06,4,9.11238532632591e-06,0,0
11702,hang,4,7.3458114183292686e-06,4,9.11238532632591e-06,0,0
11723,valley,4,7.3458114183292686e-06,4,9.11238532632591e-06,0,0
11742,studying,4,7.3458114183292686e-06,4,9.11238532632591e-06,0,0
11747,solitary,4,7.3458114183292686e-06,4,9.11238532632591e-06,0,0
11767,weaker,4,7.3458114183292686e-06,4,9.11238532632591e-06,0,0
11770,sharp,4,7.3458114183292686e-06,4,9.11238532632591e-06,0,0
11780,signals,4,7.3458114183292686e-06,4,9.11238532632591e-06,0,0
11792,dominating,4,7.3458114183292686e-06,4,9.11238532632591e-06,0,0
11804,@roycoopernc,4,7.3458114183292686e-06,4,9.11238532632591e-06,0,0
11806,mood,4,7.3458114183292686e-06,4,9.11238532632591e-06,0,0
11819,inappropriate,4,7.3458114183292686e-06,4,9.11238532632591e-06,0,0
11828,distancing,4,7.3458114183292686e-06,4,9.11238532632591e-06,0,0
11834,improperly,4,7.3458114183292686e-06,4,9.11238532632591e-06,0,0
11839,bestseller,4,7.3458114183292686e-06,4,9.11238532632591e-06,0,0
11848,wyoming,4,7.3458114183292686e-06,4,9.11238532632591e-06,0,0
11893,@mattformontana,4,7.3458114183292686e-06,4,9.11238532632591e-06,0,0
11934,consistent,4,7.3458114183292686e-06,4,9.11238532632591e-06,0,0
11937,bernies,4,7.3458114183292686e-06,4,9.11238532632591e-06,0,0
11985,port,4,7.3458114183292686e-06,4,9.11238532632591e-06,0,0
11999,meadow,4,7.3458114183292686e-06,4,9.11238532632591e-06,0,0
12026,interchange,4,7.3458114183292686e-06,4,9.11238532632591e-06,0,0
12055,terminal,4,7.3458114183292686e-06,4,9.11238532632591e-06,0,0
12069,adams,4,7.3458114183292686e-06,4,9.11238532632591e-06,0,0
12078,reconstruct,4,7.3458114183292686e-06,4,9.11238532632591e-06,0,0
12089,manhattan,4,7.3458114183292686e-06,4,9.11238532632591e-06,0,0
12113,curve,4,7.3458114183292686e-06,4,9.11238532632591e-06,0,0
12126,enhanced,4,7.3458114183292686e-06,4,9.11238532632591e-06,0,0
12137,191,4,7.3458114183292686e-06,4,9.11238532632591e-06,0,0
12152,40m,4,7.3458114183292686e-06,4,9.11238532632591e-06,0,0
12220,@housegop,4,7.3458114183292686e-06,4,9.11238532632591e-06,0,0
12229,closure,4,7.3458114183292686e-06,4,9.11238532632591e-06,0,0
12234,modi,4,7.3458114183292686e-06,4,9.11238532632591e-06,0,0
12237,thunder,4,7.3458114183292686e-06,4,9.11238532632591e-06,0,0
12250,unstable,4,7.3458114183292686e-06,4,9.11238532632591e-06,0,0
12261,@heytammybruce,4,7.3458114183292686e-06,4,9.11238532632591e-06,0,0
12277,representation,4,7.3458114183292686e-06,4,9.11238532632591e-06,0,0
12294,emerson,4,7.3458114183292686e-06,4,9.11238532632591e-06,0,0
12295,famously,4,7.3458114183292686e-06,4,9.11238532632591e-06,0,0
12302,briefings,4,7.3458114183292686e-06,4,9.11238532632591e-06,0,0
12321,jamie,4,7.3458114183292686e-06,4,9.11238532632591e-06,0,0
12358,rioting,4,7.3458114183292686e-06,4,9.11238532632591e-06,0,0
12376,river,4,7.3458114183292686e-06,4,9.11238532632591e-06,0,0
12392,daines,4,7.3458114183292686e-06,4,9.11238532632591e-06,0,0
12402,bombs,4,7.3458114183292686e-06,4,9.11238532632591e-06,0,0
12407,rulings,4,7.3458114183292686e-06,4,9.11238532632591e-06,0,0
12434,breath,4,7.3458114183292686e-06,4,9.11238532632591e-06,0,0
12446,knee,4,7.3458114183292686e-06,4,9.11238532632591e-06,0,0
12447,locker,4,7.3458114183292686e-06,4,9.11238532632591e-06,0,0
12457,@iagovernor,4,7.3458114183292686e-06,4,9.11238532632591e-06,0,0
12464,congressmen,4,7.3458114183292686e-06,4,9.11238532632591e-06,0,0
12469,survive,4,7.3458114183292686e-06,4,9.11238532632591e-06,0,0
12488,fat,4,7.3458114183292686e-06,4,9.11238532632591e-06,0,0
12515,obsolete,4,7.3458114183292686e-06,4,9.11238532632591e-06,0,0
12517,mutual,4,7.3458114183292686e-06,4,9.11238532632591e-06,0,0
12520,instituted,4,7.3458114183292686e-06,4,9.11238532632591e-06,0,0
12521,@nbc,4,7.3458114183292686e-06,4,9.11238532632591e-06,0,0
12534,@judgenap,4,7.3458114183292686e-06,4,9.11238532632591e-06,0,0
12562,state-of-the-art,4,7.3458114183292686e-06,4,9.11238532632591e-06,0,0
12577,retreat,4,7.3458114183292686e-06,4,9.11238532632591e-06,0,0
12586,circulated,4,7.3458114183292686e-06,4,9.11238532632591e-06,0,0
12619,unlikely,4,7.3458114183292686e-06,4,9.11238532632591e-06,0,0
12633,span,4,7.3458114183292686e-06,4,9.11238532632591e-06,0,0
12635,jacob,4,7.3458114183292686e-06,4,9.11238532632591e-06,0,0
12634,frey,4,7.3458114183292686e-06,4,9.11238532632591e-06,0,0
12636,branch,4,7.3458114183292686e-06,4,9.11238532632591e-06,0,0
12649,revoked,4,7.3458114183292686e-06,4,9.11238532632591e-06,0,0
12701,@fischbachmn7,4,7.3458114183292686e-06,4,9.11238532632591e-06,0,0
12707,submarine,4,7.3458114183292686e-06,4,9.11238532632591e-06,0,0
12705,sailor,4,7.3458114183292686e-06,4,9.11238532632591e-06,0,0
12752,kay,4,7.3458114183292686e-06,4,9.11238532632591e-06,0,0
12767,credentials,4,7.3458114183292686e-06,4,9.11238532632591e-06,0,0
12779,electrical,4,7.3458114183292686e-06,4,9.11238532632591e-06,0,0
12802,182,4,7.3458114183292686e-06,4,9.11238532632591e-06,0,0
12836,depot,4,7.3458114183292686e-06,4,9.11238532632591e-06,0,0
12855,quadruple,4,7.3458114183292686e-06,4,9.11238532632591e-06,0,0
12867,salman,4,7.3458114183292686e-06,4,9.11238532632591e-06,0,0
12872,cleaners,4,7.3458114183292686e-06,4,9.11238532632591e-06,0,0
12878,warnings,4,7.3458114183292686e-06,4,9.11238532632591e-06,0,0
12889,mountains,4,7.3458114183292686e-06,4,9.11238532632591e-06,0,0
12896,rochester,4,7.3458114183292686e-06,4,9.11238532632591e-06,0,0
12908,bible,4,7.3458114183292686e-06,4,9.11238532632591e-06,0,0
12923,anarchy,4,7.3458114183292686e-06,4,9.11238532632591e-06,0,0
12947,tenfold,4,7.3458114183292686e-06,4,9.11238532632591e-06,0,0
12949,sentences,4,7.3458114183292686e-06,4,9.11238532632591e-06,0,0
12982,flare,4,7.3458114183292686e-06,4,9.11238532632591e-06,0,0
12984,generally,4,7.3458114183292686e-06,4,9.11238532632591e-06,0,0
13001,custody,4,7.3458114183292686e-06,4,9.11238532632591e-06,0,0
13042,attitude,4,7.3458114183292686e-06,4,9.11238532632591e-06,0,0
13044,dni,4,7.3458114183292686e-06,4,9.11238532632591e-06,0,0
13045,nominating,4,7.3458114183292686e-06,4,9.11238532632591e-06,0,0
13080,shinzo,4,7.3458114183292686e-06,4,9.11238532632591e-06,0,0
13115,kneel,4,7.3458114183292686e-06,4,9.11238532632591e-06,0,0
13123,mtg,4,7.3458114183292686e-06,4,9.11238532632591e-06,0,0
13131,bannon,4,7.3458114183292686e-06,4,9.11238532632591e-06,0,0
13136,350,4,7.3458114183292686e-06,4,9.11238532632591e-06,0,0
13152,unfairness,4,7.3458114183292686e-06,4,9.11238532632591e-06,0,0
13154,consequential,4,7.3458114183292686e-06,4,9.11238532632591e-06,0,0
13157,missteps,4,7.3458114183292686e-06,4,9.11238532632591e-06,0,0
13165,doubts,4,7.3458114183292686e-06,4,9.11238532632591e-06,0,0
13181,formally,4,7.3458114183292686e-06,4,9.11238532632591e-06,0,0
13187,criminality,4,7.3458114183292686e-06,4,9.11238532632591e-06,0,0
13194,hesitation,4,7.3458114183292686e-06,4,9.11238532632591e-06,0,0
13205,accusing,4,7.3458114183292686e-06,4,9.11238532632591e-06,0,0
13257,bryant,4,7.3458114183292686e-06,4,9.11238532632591e-06,0,0
13275,nytimes,4,7.3458114183292686e-06,4,9.11238532632591e-06,0,0
13305,hats,4,7.3458114183292686e-06,4,9.11238532632591e-06,0,0
13378,nazi,4,7.3458114183292686e-06,4,9.11238532632591e-06,0,0
13381,lousy,4,7.3458114183292686e-06,4,9.11238532632591e-06,0,0
13391,decorated,4,7.3458114183292686e-06,4,9.11238532632591e-06,0,0
13424,jacksonville,4,7.3458114183292686e-06,4,9.11238532632591e-06,0,0
13465,हम,4,7.3458114183292686e-06,4,9.11238532632591e-06,0,0
13530,बनाएँगे,4,7.3458114183292686e-06,4,9.11238532632591e-06,0,0
13560,industrial,4,7.3458114183292686e-06,4,9.11238532632591e-06,0,0
13629,established,4,7.3458114183292686e-06,4,9.11238532632591e-06,0,0
13659,sole,4,7.3458114183292686e-06,4,9.11238532632591e-06,0,0
13666,latrobe,4,7.3458114183292686e-06,4,9.11238532632591e-06,0,0
13690,devote,4,7.3458114183292686e-06,4,9.11238532632591e-06,0,0
13715,slanted,4,7.3458114183292686e-06,4,9.11238532632591e-06,0,0
13729,jealous,4,7.3458114183292686e-06,4,9.11238532632591e-06,0,0
13751,style,4,7.3458114183292686e-06,4,9.11238532632591e-06,0,0
13756,refuted,4,7.3458114183292686e-06,4,9.11238532632591e-06,0,0
13765,stages,4,7.3458114183292686e-06,4,9.11238532632591e-06,0,0
13769,mistakenly,4,7.3458114183292686e-06,4,9.11238532632591e-06,0,0
13781,refer,4,7.3458114183292686e-06,4,9.11238532632591e-06,0,0
13783,obliterate,4,7.3458114183292686e-06,4,9.11238532632591e-06,0,0
13790,gary,4,7.3458114183292686e-06,4,9.11238532632591e-06,0,0
13814,yale,4,7.3458114183292686e-06,4,9.11238532632591e-06,0,0
13835,@esperdod,4,7.3458114183292686e-06,4,9.11238532632591e-06,0,0
13853,cycle,4,7.3458114183292686e-06,4,9.11238532632591e-06,0,0
13972,swearing,4,7.3458114183292686e-06,4,9.11238532632591e-06,0,0
14008,bossie,4,7.3458114183292686e-06,4,9.11238532632591e-06,0,0
14101,gracious,4,7.3458114183292686e-06,4,9.11238532632591e-06,0,0
14105,payne,4,7.3458114183292686e-06,4,9.11238532632591e-06,0,0
14120,deborah,4,7.3458114183292686e-06,4,9.11238532632591e-06,0,0
14125,delinquent,4,7.3458114183292686e-06,4,9.11238532632591e-06,0,0
14129,cathedral,4,7.3458114183292686e-06,4,9.11238532632591e-06,0,0
14155,weird,4,7.3458114183292686e-06,4,9.11238532632591e-06,0,0
14166,13th,4,7.3458114183292686e-06,4,9.11238532632591e-06,0,0
14170,ethics,4,7.3458114183292686e-06,4,9.11238532632591e-06,0,0
14175,pitcher,4,7.3458114183292686e-06,4,9.11238532632591e-06,0,0
14194,republicanconservative,4,7.3458114183292686e-06,4,9.11238532632591e-06,0,0
14222,holt,4,7.3458114183292686e-06,4,9.11238532632591e-06,0,0
14227,generous,4,7.3458114183292686e-06,4,9.11238532632591e-06,0,0
14232,superstar,4,7.3458114183292686e-06,4,9.11238532632591e-06,0,0
14252,golfer,4,7.3458114183292686e-06,4,9.11238532632591e-06,0,0
14271,@tomcottonar,4,7.3458114183292686e-06,4,9.11238532632591e-06,0,0
14279,135,4,7.3458114183292686e-06,4,9.11238532632591e-06,0,0
14293,retained,4,7.3458114183292686e-06,4,9.11238532632591e-06,0,0
14311,low-life,4,7.3458114183292686e-06,4,9.11238532632591e-06,0,0
14345,praised,4,7.3458114183292686e-06,4,9.11238532632591e-06,0,0
14349,transfer,4,7.3458114183292686e-06,4,9.11238532632591e-06,0,0
14352,portray,4,7.3458114183292686e-06,4,9.11238532632591e-06,0,0
14359,dozens,4,7.3458114183292686e-06,4,9.11238532632591e-06,0,0
14365,peggy,4,7.3458114183292686e-06,4,9.11238532632591e-06,0,0
14368,knights,4,7.3458114183292686e-06,4,9.11238532632591e-06,0,0
14371,scholar,4,7.3458114183292686e-06,4,9.11238532632591e-06,0,0
14434,bothered,4,7.3458114183292686e-06,4,9.11238532632591e-06,0,0
14450,tolerate,4,7.3458114183292686e-06,4,9.11238532632591e-06,0,0
14456,25th,4,7.3458114183292686e-06,4,9.11238532632591e-06,0,0
14464,astronauts,4,7.3458114183292686e-06,4,9.11238532632591e-06,0,0
14476,overthrow,4,7.3458114183292686e-06,4,9.11238532632591e-06,0,0
14505,masters,4,7.3458114183292686e-06,4,9.11238532632591e-06,0,0
14553,regimes,4,7.3458114183292686e-06,4,9.11238532632591e-06,0,0
14556,packages,4,7.3458114183292686e-06,4,9.11238532632591e-06,0,0
14560,coldest,4,7.3458114183292686e-06,4,9.11238532632591e-06,0,0
14579,inaugurated,4,7.3458114183292686e-06,4,9.11238532632591e-06,0,0
14592,15-0,4,7.3458114183292686e-06,4,9.11238532632591e-06,0,0
14611,rises,4,7.3458114183292686e-06,4,9.11238532632591e-06,0,0
14619,occurred,4,7.3458114183292686e-06,4,9.11238532632591e-06,0,0
14631,address🇺🇸,4,7.3458114183292686e-06,4,9.11238532632591e-06,0,0
14653,stacked,4,7.3458114183292686e-06,4,9.11238532632591e-06,0,0
14665,stain,4,7.3458114183292686e-06,4,9.11238532632591e-06,0,0
14680,slogan,4,7.3458114183292686e-06,4,9.11238532632591e-06,0,0
14775,mystery,4,7.3458114183292686e-06,4,9.11238532632591e-06,0,0
14785,sentiment,4,7.3458114183292686e-06,4,9.11238532632591e-06,0,0
14791,distorted,4,7.3458114183292686e-06,4,9.11238532632591e-06,0,0
14816,aboard,4,7.3458114183292686e-06,4,9.11238532632591e-06,0,0
14822,ungrateful,4,7.3458114183292686e-06,4,9.11238532632591e-06,0,0
14845,#ms13,4,7.3458114183292686e-06,4,9.11238532632591e-06,0,0
14857,naive,4,7.3458114183292686e-06,4,9.11238532632591e-06,0,0
14879,jong-un,4,7.3458114183292686e-06,4,9.11238532632591e-06,0,0
14882,reset,4,7.3458114183292686e-06,4,9.11238532632591e-06,0,0
14886,denuclearize,4,7.3458114183292686e-06,4,9.11238532632591e-06,0,0
14909,madame,4,7.3458114183292686e-06,4,9.11238532632591e-06,0,0
14910,peng,4,7.3458114183292686e-06,4,9.11238532632591e-06,0,0
14908,liyuan,4,7.3458114183292686e-06,4,9.11238532632591e-06,0,0
14941,northam,4,7.3458114183292686e-06,4,9.11238532632591e-06,0,0
14963,degenerate,4,7.3458114183292686e-06,4,9.11238532632591e-06,0,0
14995,europes,4,7.3458114183292686e-06,4,9.11238532632591e-06,0,0
15003,alleged,4,7.3458114183292686e-06,4,9.11238532632591e-06,0,0
15017,trumprussia,4,7.3458114183292686e-06,4,9.11238532632591e-06,0,0
15027,@theleegreenwood,4,7.3458114183292686e-06,4,9.11238532632591e-06,0,0
15039,declared,4,7.3458114183292686e-06,4,9.11238532632591e-06,0,0
15065,1973,4,7.3458114183292686e-06,4,9.11238532632591e-06,0,0
15074,msm,4,7.3458114183292686e-06,4,9.11238532632591e-06,0,0
15086,@ricardorossello,4,7.3458114183292686e-06,4,9.11238532632591e-06,0,0
15101,technical,4,7.3458114183292686e-06,4,9.11238532632591e-06,0,0
15095,@nikkihaley,4,7.3458114183292686e-06,4,9.11238532632591e-06,0,0
15129,tpp,4,7.3458114183292686e-06,4,9.11238532632591e-06,0,0
15137,soars,4,7.3458114183292686e-06,4,9.11238532632591e-06,0,0
15178,praise,4,7.3458114183292686e-06,4,9.11238532632591e-06,0,0
15184,stadium,4,7.3458114183292686e-06,4,9.11238532632591e-06,0,0
15194,suggesting,4,7.3458114183292686e-06,4,9.11238532632591e-06,0,0
15195,material,4,7.3458114183292686e-06,4,9.11238532632591e-06,0,0
15201,warmth,4,7.3458114183292686e-06,4,9.11238532632591e-06,0,0
15210,19000,4,7.3458114183292686e-06,4,9.11238532632591e-06,0,0
15262,knees,4,7.3458114183292686e-06,4,9.11238532632591e-06,0,0
15273,116,4,7.3458114183292686e-06,4,9.11238532632591e-06,0,0
15299,luncheon,4,7.3458114183292686e-06,4,9.11238532632591e-06,0,0
15332,wyou,4,7.3458114183292686e-06,4,9.11238532632591e-06,0,0
15352,lara,4,7.3458114183292686e-06,4,9.11238532632591e-06,0,0
15359,evacuation,4,7.3458114183292686e-06,4,9.11238532632591e-06,0,0
15361,enormous,4,7.3458114183292686e-06,4,9.11238532632591e-06,0,0
15401,usa🇺🇸,4,7.3458114183292686e-06,4,9.11238532632591e-06,0,0
15415,extortion,4,7.3458114183292686e-06,4,9.11238532632591e-06,0,0
15417,floods,4,7.3458114183292686e-06,4,9.11238532632591e-06,0,0
15434,@femabrock,4,7.3458114183292686e-06,4,9.11238532632591e-06,0,0
15439,yuma,4,7.3458114183292686e-06,4,9.11238532632591e-06,0,0
15460,everlasting,4,7.3458114183292686e-06,4,9.11238532632591e-06,0,0
15471,@usga,4,7.3458114183292686e-06,4,9.11238532632591e-06,0,0
15509,regards,4,7.3458114183292686e-06,4,9.11238532632591e-06,0,0
15556,merit-based,4,7.3458114183292686e-06,4,9.11238532632591e-06,0,0
15562,varney,4,7.3458114183292686e-06,4,9.11238532632591e-06,0,0
15656,#uswomensopen,4,7.3458114183292686e-06,4,9.11238532632591e-06,0,0
15686,beef,4,7.3458114183292686e-06,4,9.11238532632591e-06,0,0
15698,hamburg,4,7.3458114183292686e-06,4,9.11238532632591e-06,0,0
15756,bombshell,4,7.3458114183292686e-06,4,9.11238532632591e-06,0,0
15762,obstructed,4,7.3458114183292686e-06,4,9.11238532632591e-06,0,0
15801,memorandum,4,7.3458114183292686e-06,4,9.11238532632591e-06,0,0
15814,spiral,4,7.3458114183292686e-06,4,9.11238532632591e-06,0,0
15846,khan,4,7.3458114183292686e-06,4,9.11238532632591e-06,0,0
15889,servicemen,4,7.3458114183292686e-06,4,9.11238532632591e-06,0,0
15928,frauds,4,7.3458114183292686e-06,4,9.11238532632591e-06,0,0
15950,#nationaldayofprayer,4,7.3458114183292686e-06,4,9.11238532632591e-06,0,0
15953,rice,4,7.3458114183292686e-06,4,9.11238532632591e-06,0,0
15996,bravest,4,7.3458114183292686e-06,4,9.11238532632591e-06,0,0
15998,kraft,4,7.3458114183292686e-06,4,9.11238532632591e-06,0,0
16015,removing,4,7.3458114183292686e-06,4,9.11238532632591e-06,0,0
16046,offers,4,7.3458114183292686e-06,4,9.11238532632591e-06,0,0
16085,behaving,4,7.3458114183292686e-06,4,9.11238532632591e-06,0,0
16098,preparations,4,7.3458114183292686e-06,4,9.11238532632591e-06,0,0
16107,crimea,4,7.3458114183292686e-06,4,9.11238532632591e-06,0,0
16110,@exxonmobil,4,7.3458114183292686e-06,4,9.11238532632591e-06,0,0
16145,differently,4,7.3458114183292686e-06,4,9.11238532632591e-06,0,0
16148,nsa,4,7.3458114183292686e-06,4,9.11238532632591e-06,0,0
16164,connection,4,7.3458114183292686e-06,4,9.11238532632591e-06,0,0
16174,mnuchin,4,7.3458114183292686e-06,4,9.11238532632591e-06,0,0
16183,els,4,7.3458114183292686e-06,4,9.11238532632591e-06,0,0
16200,statute,4,7.3458114183292686e-06,4,9.11238532632591e-06,0,0
16215,@oreillyfactor,4,7.3458114183292686e-06,4,9.11238532632591e-06,0,0
16221,halt,4,7.3458114183292686e-06,4,9.11238532632591e-06,0,0
16261,barra,4,7.3458114183292686e-06,4,9.11238532632591e-06,0,0
16326,confidential,4,7.3458114183292686e-06,4,9.11238532632591e-06,0,0
16372,murders,4,7.3458114183292686e-06,4,9.11238532632591e-06,0,0
16401,visiting,4,7.3458114183292686e-06,4,9.11238532632591e-06,0,0
16408,airplanes,4,7.3458114183292686e-06,4,9.11238532632591e-06,0,0
16427,30000000,4,7.3458114183292686e-06,4,9.11238532632591e-06,0,0
16445,tries,4,7.3458114183292686e-06,4,9.11238532632591e-06,0,0
16447,flew,4,7.3458114183292686e-06,4,9.11238532632591e-06,0,0
16483,corsi,4,7.3458114183292686e-06,4,9.11238532632591e-06,0,0
16490,attorneys,4,7.3458114183292686e-06,4,9.11238532632591e-06,0,0
16492,crookeds,4,7.3458114183292686e-06,4,9.11238532632591e-06,0,0
16499,interior,4,7.3458114183292686e-06,4,9.11238532632591e-06,0,0
16526,certainty,4,7.3458114183292686e-06,4,9.11238532632591e-06,0,0
16581,soybeans,4,7.3458114183292686e-06,4,9.11238532632591e-06,0,0
16594,cleanest,4,7.3458114183292686e-06,4,9.11238532632591e-06,0,0
16609,capturing,4,7.3458114183292686e-06,4,9.11238532632591e-06,0,0
16621,hyde-smith,4,7.3458114183292686e-06,4,9.11238532632591e-06,0,0
16651,detain,4,7.3458114183292686e-06,4,9.11238532632591e-06,0,0
16658,roberts,4,7.3458114183292686e-06,4,9.11238532632591e-06,0,0
16685,mentioning,4,7.3458114183292686e-06,4,9.11238532632591e-06,0,0
16715,wine,4,7.3458114183292686e-06,4,9.11238532632591e-06,0,0
16721,routinely,4,7.3458114183292686e-06,4,9.11238532632591e-06,0,0
16756,astonishing,4,7.3458114183292686e-06,4,9.11238532632591e-06,0,0
16771,somethings,4,7.3458114183292686e-06,4,9.11238532632591e-06,0,0
16783,stabenow,4,7.3458114183292686e-06,4,9.11238532632591e-06,0,0
16799,anti-israel,4,7.3458114183292686e-06,4,9.11238532632591e-06,0,0
16819,rothfus,4,7.3458114183292686e-06,4,9.11238532632591e-06,0,0
16822,detriment,4,7.3458114183292686e-06,4,9.11238532632591e-06,0,0
16860,synagogue,4,7.3458114183292686e-06,4,9.11238532632591e-06,0,0
16906,institute,4,7.3458114183292686e-06,4,9.11238532632591e-06,0,0
16926,unknown,4,7.3458114183292686e-06,4,9.11238532632591e-06,0,0
16937,mesa,4,7.3458114183292686e-06,4,9.11238532632591e-06,0,0
16946,orourke,4,7.3458114183292686e-06,4,9.11238532632591e-06,0,0
16953,liberals,4,7.3458114183292686e-06,4,9.11238532632591e-06,0,0
17035,#iacp2018,4,7.3458114183292686e-06,4,9.11238532632591e-06,0,0
17062,andres,4,7.3458114183292686e-06,4,9.11238532632591e-06,0,0
17080,placing,4,7.3458114183292686e-06,4,9.11238532632591e-06,0,0
17103,declassify,4,7.3458114183292686e-06,4,9.11238532632591e-06,0,0
17135,tariffed,4,7.3458114183292686e-06,4,9.11238532632591e-06,0,0
17145,administrator,4,7.3458114183292686e-06,4,9.11238532632591e-06,0,0
17170,wrongdoing,4,7.3458114183292686e-06,4,9.11238532632591e-06,0,0
17187,wand,4,7.3458114183292686e-06,4,9.11238532632591e-06,0,0
17196,assaults,4,7.3458114183292686e-06,4,9.11238532632591e-06,0,0
17314,instantly,4,7.3458114183292686e-06,4,9.11238532632591e-06,0,0
17346,client,4,7.3458114183292686e-06,4,9.11238532632591e-06,0,0
17408,fatter,4,7.3458114183292686e-06,4,9.11238532632591e-06,0,0
17486,@grahamledger,4,7.3458114183292686e-06,4,9.11238532632591e-06,0,0
17500,accumulated,4,7.3458114183292686e-06,4,9.11238532632591e-06,0,0
17511,dianne,4,7.3458114183292686e-06,4,9.11238532632591e-06,0,0
17523,soil,4,7.3458114183292686e-06,4,9.11238532632591e-06,0,0
17630,turnberry,4,7.3458114183292686e-06,4,9.11238532632591e-06,0,0
17673,@wvgovernor,4,7.3458114183292686e-06,4,9.11238532632591e-06,0,0
17725,@henrymcmaster,4,7.3458114183292686e-06,4,9.11238532632591e-06,0,0
17890,craft,4,7.3458114183292686e-06,4,9.11238532632591e-06,0,0
17957,hemingway,4,7.3458114183292686e-06,4,9.11238532632591e-06,0,0
17992,zte,4,7.3458114183292686e-06,4,9.11238532632591e-06,0,0
18032,terry,4,7.3458114183292686e-06,4,9.11238532632591e-06,0,0
18043,premier,4,7.3458114183292686e-06,4,9.11238532632591e-06,0,0
18166,haberman,4,7.3458114183292686e-06,4,9.11238532632591e-06,0,0
18300,bravely,4,7.3458114183292686e-06,4,9.11238532632591e-06,0,0
18348,guards,4,7.3458114183292686e-06,4,9.11238532632591e-06,0,0
18373,agony,4,7.3458114183292686e-06,4,9.11238532632591e-06,0,0
18392,blown,4,7.3458114183292686e-06,4,9.11238532632591e-06,0,0
18419,#cpac2018,4,7.3458114183292686e-06,4,9.11238532632591e-06,0,0
18440,generic,4,7.3458114183292686e-06,4,9.11238532632591e-06,0,0
18685,weaponized,4,7.3458114183292686e-06,4,9.11238532632591e-06,0,0
18770,overruns,4,7.3458114183292686e-06,4,9.11238532632591e-06,0,0
18777,35000000,4,7.3458114183292686e-06,4,9.11238532632591e-06,0,0
18800,subpoenas,4,7.3458114183292686e-06,4,9.11238532632591e-06,0,0
18843,realizes,4,7.3458114183292686e-06,4,9.11238532632591e-06,0,0
18863,bevin,4,7.3458114183292686e-06,4,9.11238532632591e-06,0,0
18866,vaping,4,7.3458114183292686e-06,4,9.11238532632591e-06,0,0
18942,reeves,4,7.3458114183292686e-06,4,9.11238532632591e-06,0,0
18957,tightened,4,7.3458114183292686e-06,4,9.11238532632591e-06,0,0
19022,bore,4,7.3458114183292686e-06,4,9.11238532632591e-06,0,0
19115,@gma,4,7.3458114183292686e-06,4,9.11238532632591e-06,0,0
19252,hole,4,7.3458114183292686e-06,4,9.11238532632591e-06,0,0
19366,@peterschweizer,4,7.3458114183292686e-06,4,9.11238532632591e-06,0,0
19477,mouthed,4,7.3458114183292686e-06,4,9.11238532632591e-06,0,0
19534,kahn,4,7.3458114183292686e-06,4,9.11238532632591e-06,0,0
19753,beg,4,7.3458114183292686e-06,4,9.11238532632591e-06,0,0
19920,bibi,4,7.3458114183292686e-06,4,9.11238532632591e-06,0,0
19948,indicted,4,7.3458114183292686e-06,4,9.11238532632591e-06,0,0
19947,deported,4,7.3458114183292686e-06,4,9.11238532632591e-06,0,0
20056,solomon,4,7.3458114183292686e-06,4,9.11238532632591e-06,0,0
20093,directors,4,7.3458114183292686e-06,4,9.11238532632591e-06,0,0
20098,notre,4,7.3458114183292686e-06,4,9.11238532632591e-06,0,0
20097,dame,4,7.3458114183292686e-06,4,9.11238532632591e-06,0,0
20267,#dday75,4,7.3458114183292686e-06,4,9.11238532632591e-06,0,0
20453,quicker,4,7.3458114183292686e-06,4,9.11238532632591e-06,0,0
20454,waivers,4,7.3458114183292686e-06,4,9.11238532632591e-06,0,0
165,aiming,3,5.509358563746952e-06,2,4.556192663162955e-06,1,9.472836640932127e-06
168,pitching,3,5.509358563746952e-06,1,2.2780963315814773e-06,2,1.8945673281864254e-05
206,changebut,3,5.509358563746952e-06,0,0,3,2.8418509922796382e-05
233,no-fly,3,5.509358563746952e-06,0,0,3,2.8418509922796382e-05
303,#happythanksgiving,3,5.509358563746952e-06,1,2.2780963315814773e-06,2,1.8945673281864254e-05
341,inevitable,3,5.509358563746952e-06,1,2.2780963315814773e-06,2,1.8945673281864254e-05
374,#veteransday,3,5.509358563746952e-06,0,0,3,2.8418509922796382e-05
404,cynics,3,5.509358563746952e-06,0,0,3,2.8418509922796382e-05
447,gallon,3,5.509358563746952e-06,0,0,3,2.8418509922796382e-05
458,steadily,3,5.509358563746952e-06,2,4.556192663162955e-06,1,9.472836640932127e-06
504,#happyhalloween,3,5.509358563746952e-06,0,0,3,2.8418509922796382e-05
507,eat,3,5.509358563746952e-06,2,4.556192663162955e-06,1,9.472836640932127e-06
554,bfd,3,5.509358563746952e-06,0,0,3,2.8418509922796382e-05
570,generating,3,5.509358563746952e-06,0,0,3,2.8418509922796382e-05
622,repair,3,5.509358563746952e-06,1,2.2780963315814773e-06,2,1.8945673281864254e-05
673,@pontifex,3,5.509358563746952e-06,1,2.2780963315814773e-06,2,1.8945673281864254e-05
696,observing,3,5.509358563746952e-06,2,4.556192663162955e-06,1,9.472836640932127e-06
710,empowered,3,5.509358563746952e-06,1,2.2780963315814773e-06,2,1.8945673281864254e-05
755,diplomacy,3,5.509358563746952e-06,2,4.556192663162955e-06,1,9.472836640932127e-06
784,300000,3,5.509358563746952e-06,2,4.556192663162955e-06,1,9.472836640932127e-06
815,fridays,3,5.509358563746952e-06,1,2.2780963315814773e-06,2,1.8945673281864254e-05
843,yearsand,3,5.509358563746952e-06,0,0,3,2.8418509922796382e-05
870,@billclinton,3,5.509358563746952e-06,0,0,3,2.8418509922796382e-05
915,#vra50,3,5.509358563746952e-06,0,0,3,2.8418509922796382e-05
929,@thedailyshow,3,5.509358563746952e-06,0,0,3,2.8418509922796382e-05
970,labeled,3,5.509358563746952e-06,2,4.556192663162955e-06,1,9.472836640932127e-06
974,conscience,3,5.509358563746952e-06,1,2.2780963315814773e-06,2,1.8945673281864254e-05
977,objectives,3,5.509358563746952e-06,2,4.556192663162955e-06,1,9.472836640932127e-06
1003,hint,3,5.509358563746952e-06,0,0,3,2.8418509922796382e-05
1000,#44,3,5.509358563746952e-06,0,0,3,2.8418509922796382e-05
1048,requiring,3,5.509358563746952e-06,0,0,3,2.8418509922796382e-05
1068,redemption,3,5.509358563746952e-06,2,4.556192663162955e-06,1,9.472836640932127e-06
1072,absence,3,5.509358563746952e-06,0,0,3,2.8418509922796382e-05
1081,nonviolent,3,5.509358563746952e-06,0,0,3,2.8418509922796382e-05
1107,incarceration,3,5.509358563746952e-06,2,4.556192663162955e-06,1,9.472836640932127e-06
1116,parent,3,5.509358563746952e-06,1,2.2780963315814773e-06,2,1.8945673281864254e-05
1171,#shebelieves,3,5.509358563746952e-06,0,0,3,2.8418509922796382e-05
1230,jobsthe,3,5.509358563746952e-06,0,0,3,2.8418509922796382e-05
1246,consequence,3,5.509358563746952e-06,1,2.2780963315814773e-06,2,1.8945673281864254e-05
1270,charleston,3,5.509358563746952e-06,2,4.556192663162955e-06,1,9.472836640932127e-06
1308,dust,3,5.509358563746952e-06,1,2.2780963315814773e-06,2,1.8945673281864254e-05
1347,beau,3,5.509358563746952e-06,0,0,3,2.8418509922796382e-05
1479,#thankateacher,3,5.509358563746952e-06,0,0,3,2.8418509922796382e-05
1493,shapes,3,5.509358563746952e-06,2,4.556192663162955e-06,1,9.472836640932127e-06
1522,#climatechangeisreal,3,5.509358563746952e-06,0,0,3,2.8418509922796382e-05
1525,god-given,3,5.509358563746952e-06,2,4.556192663162955e-06,1,9.472836640932127e-06
1612,preventable,3,5.509358563746952e-06,2,4.556192663162955e-06,1,9.472836640932127e-06
1615,sprint,3,5.509358563746952e-06,2,4.556192663162955e-06,1,9.472836640932127e-06
1622,keeper,3,5.509358563746952e-06,0,0,3,2.8418509922796382e-05
1623,sisters,3,5.509358563746952e-06,0,0,3,2.8418509922796382e-05
1629,trains,3,5.509358563746952e-06,1,2.2780963315814773e-06,2,1.8945673281864254e-05
1699,asset,3,5.509358563746952e-06,2,4.556192663162955e-06,1,9.472836640932127e-06
1708,immeasurable,3,5.509358563746952e-06,1,2.2780963315814773e-06,2,1.8945673281864254e-05
1728,selma,3,5.509358563746952e-06,0,0,3,2.8418509922796382e-05
1726,cynicism,3,5.509358563746952e-06,0,0,3,2.8418509922796382e-05
1739,conquer,3,5.509358563746952e-06,2,4.556192663162955e-06,1,9.472836640932127e-06
1790,good-paying,3,5.509358563746952e-06,1,2.2780963315814773e-06,2,1.8945673281864254e-05
1809,joshua,3,5.509358563746952e-06,1,2.2780963315814773e-06,2,1.8945673281864254e-05
1826,risen,3,5.509358563746952e-06,1,2.2780963315814773e-06,2,1.8945673281864254e-05
1847,precision,3,5.509358563746952e-06,2,4.556192663162955e-06,1,9.472836640932127e-06
1939,joins,3,5.509358563746952e-06,1,2.2780963315814773e-06,2,1.8945673281864254e-05
1947,initiatives,3,5.509358563746952e-06,0,0,3,2.8418509922796382e-05
1956,129,3,5.509358563746952e-06,2,4.556192663162955e-06,1,9.472836640932127e-06
1972,obamacares,3,5.509358563746952e-06,0,0,3,2.8418509922796382e-05
1985,kwanzaa,3,5.509358563746952e-06,0,0,3,2.8418509922796382e-05
2034,exceptional,3,5.509358563746952e-06,2,4.556192663162955e-06,1,9.472836640932127e-06
2046,applied,3,5.509358563746952e-06,2,4.556192663162955e-06,1,9.472836640932127e-06
2083,criteria,3,5.509358563746952e-06,2,4.556192663162955e-06,1,9.472836640932127e-06
2098,#readysetenroll,3,5.509358563746952e-06,0,0,3,2.8418509922796382e-05
2124,robinson,3,5.509358563746952e-06,1,2.2780963315814773e-06,2,1.8945673281864254e-05
2128,undeniable,3,5.509358563746952e-06,1,2.2780963315814773e-06,2,1.8945673281864254e-05
2151,participants,3,5.509358563746952e-06,2,4.556192663162955e-06,1,9.472836640932127e-06
2161,embodiment,3,5.509358563746952e-06,2,4.556192663162955e-06,1,9.472836640932127e-06
2173,ebola,3,5.509358563746952e-06,1,2.2780963315814773e-06,2,1.8945673281864254e-05
2196,#with1010,3,5.509358563746952e-06,0,0,3,2.8418509922796382e-05
2226,approaching,3,5.509358563746952e-06,2,4.556192663162955e-06,1,9.472836640932127e-06
2258,droughts,3,5.509358563746952e-06,0,0,3,2.8418509922796382e-05
2286,#cleanwater,3,5.509358563746952e-06,0,0,3,2.8418509922796382e-05
2292,#ontherecord,3,5.509358563746952e-06,0,0,3,2.8418509922796382e-05
2298,persons,3,5.509358563746952e-06,1,2.2780963315814773e-06,2,1.8945673281864254e-05
2316,dramatic,3,5.509358563746952e-06,2,4.556192663162955e-06,1,9.472836640932127e-06
2324,consensus,3,5.509358563746952e-06,1,2.2780963315814773e-06,2,1.8945673281864254e-05
2328,cynical,3,5.509358563746952e-06,0,0,3,2.8418509922796382e-05
2352,upholding,3,5.509358563746952e-06,2,4.556192663162955e-06,1,9.472836640932127e-06
2385,725,3,5.509358563746952e-06,0,0,3,2.8418509922796382e-05
2470,expecting,3,5.509358563746952e-06,1,2.2780963315814773e-06,2,1.8945673281864254e-05
2483,lonely,3,5.509358563746952e-06,2,4.556192663162955e-06,1,9.472836640932127e-06
2503,throwback,3,5.509358563746952e-06,1,2.2780963315814773e-06,2,1.8945673281864254e-05
2507,#usmnt,3,5.509358563746952e-06,0,0,3,2.8418509922796382e-05
2509,alongside,3,5.509358563746952e-06,1,2.2780963315814773e-06,2,1.8945673281864254e-05
2519,cc,3,5.509358563746952e-06,2,4.556192663162955e-06,1,9.472836640932127e-06
2532,#withabetterwage,3,5.509358563746952e-06,0,0,3,2.8418509922796382e-05
2543,budge,3,5.509358563746952e-06,2,4.556192663162955e-06,1,9.472836640932127e-06
2548,bar,3,5.509358563746952e-06,2,4.556192663162955e-06,1,9.472836640932127e-06
2557,accessible,3,5.509358563746952e-06,0,0,3,2.8418509922796382e-05
2570,orientation,3,5.509358563746952e-06,1,2.2780963315814773e-06,2,1.8945673281864254e-05
2573,discriminating,3,5.509358563746952e-06,1,2.2780963315814773e-06,2,1.8945673281864254e-05
2597,soaring,3,5.509358563746952e-06,2,4.556192663162955e-06,1,9.472836640932127e-06
2598,throwing,3,5.509358563746952e-06,2,4.556192663162955e-06,1,9.472836640932127e-06
2621,maya,3,5.509358563746952e-06,0,0,3,2.8418509922796382e-05
2619,angelou,3,5.509358563746952e-06,0,0,3,2.8418509922796382e-05
2657,unborn,3,5.509358563746952e-06,2,4.556192663162955e-06,1,9.472836640932127e-06
2663,moms,3,5.509358563746952e-06,0,0,3,2.8418509922796382e-05
2682,uppresident,3,5.509358563746952e-06,0,0,3,2.8418509922796382e-05
2705,caring,3,5.509358563746952e-06,1,2.2780963315814773e-06,2,1.8945673281864254e-05
2730,unspeakable,3,5.509358563746952e-06,2,4.556192663162955e-06,1,9.472836640932127e-06
2744,#mathnotmyth,3,5.509358563746952e-06,0,0,3,2.8418509922796382e-05
2753,breadwinners,3,5.509358563746952e-06,0,0,3,2.8418509922796382e-05
2764,myth,3,5.509358563746952e-06,1,2.2780963315814773e-06,2,1.8945673281864254e-05
2791,#worldautismawarenessday,3,5.509358563746952e-06,2,4.556192663162955e-06,1,9.472836640932127e-06
2830,reminding,3,5.509358563746952e-06,1,2.2780963315814773e-06,2,1.8945673281864254e-05
2828,@iamkidpresident,3,5.509358563746952e-06,0,0,3,2.8418509922796382e-05
2844,#marchmadness,3,5.509358563746952e-06,0,0,3,2.8418509922796382e-05
2852,mt,3,5.509358563746952e-06,0,0,3,2.8418509922796382e-05
2902,trapped,3,5.509358563746952e-06,0,0,3,2.8418509922796382e-05
2948,suffers,3,5.509358563746952e-06,2,4.556192663162955e-06,1,9.472836640932127e-06
2961,poised,3,5.509358563746952e-06,2,4.556192663162955e-06,1,9.472836640932127e-06
2972,job-creating,3,5.509358563746952e-06,1,2.2780963315814773e-06,2,1.8945673281864254e-05
2980,attract,3,5.509358563746952e-06,1,2.2780963315814773e-06,2,1.8945673281864254e-05
2988,trends,3,5.509358563746952e-06,2,4.556192663162955e-06,1,9.472836640932127e-06
3005,@johnkerry,3,5.509358563746952e-06,1,2.2780963315814773e-06,2,1.8945673281864254e-05
3054,renewing,3,5.509358563746952e-06,1,2.2780963315814773e-06,2,1.8945673281864254e-05
3104,diplomats,3,5.509358563746952e-06,2,4.556192663162955e-06,1,9.472836640932127e-06
3132,trials,3,5.509358563746952e-06,2,4.556192663162955e-06,1,9.472836640932127e-06
3133,campuses,3,5.509358563746952e-06,2,4.556192663162955e-06,1,9.472836640932127e-06
3153,kitchen,3,5.509358563746952e-06,2,4.556192663162955e-06,1,9.472836640932127e-06
3155,darkness,3,5.509358563746952e-06,0,0,3,2.8418509922796382e-05
3164,ladys,3,5.509358563746952e-06,0,0,3,2.8418509922796382e-05
3178,jobspresident,3,5.509358563746952e-06,0,0,3,2.8418509922796382e-05
3186,inaction,3,5.509358563746952e-06,1,2.2780963315814773e-06,2,1.8945673281864254e-05
3197,ethic,3,5.509358563746952e-06,1,2.2780963315814773e-06,2,1.8945673281864254e-05
3202,joyous,3,5.509358563746952e-06,1,2.2780963315814773e-06,2,1.8945673281864254e-05
3205,applying,3,5.509358563746952e-06,1,2.2780963315814773e-06,2,1.8945673281864254e-05
3217,lori,3,5.509358563746952e-06,2,4.556192663162955e-06,1,9.472836640932127e-06
3226,asthma,3,5.509358563746952e-06,0,0,3,2.8418509922796382e-05
3236,strikes,3,5.509358563746952e-06,1,2.2780963315814773e-06,2,1.8945673281864254e-05
3274,memories,3,5.509358563746952e-06,0,0,3,2.8418509922796382e-05
3297,lighting,3,5.509358563746952e-06,0,0,3,2.8418509922796382e-05
3299,automakers,3,5.509358563746952e-06,1,2.2780963315814773e-06,2,1.8945673281864254e-05
3308,universe,3,5.509358563746952e-06,2,4.556192663162955e-06,1,9.472836640932127e-06
3319,broad,3,5.509358563746952e-06,2,4.556192663162955e-06,1,9.472836640932127e-06
3321,non-discrimination,3,5.509358563746952e-06,0,0,3,2.8418509922796382e-05
3342,shop,3,5.509358563746952e-06,1,2.2780963315814773e-06,2,1.8945673281864254e-05
3357,farther,3,5.509358563746952e-06,0,0,3,2.8418509922796382e-05
3365,slowing,3,5.509358563746952e-06,2,4.556192663162955e-06,1,9.472836640932127e-06
3372,rescinded,3,5.509358563746952e-06,2,4.556192663162955e-06,1,9.472836640932127e-06
3401,survivor,3,5.509358563746952e-06,1,2.2780963315814773e-06,2,1.8945673281864254e-05
3420,#ofasummit,3,5.509358563746952e-06,0,0,3,2.8418509922796382e-05
3458,burnett,3,5.509358563746952e-06,2,4.556192663162955e-06,1,9.472836640932127e-06
3472,disagreement,3,5.509358563746952e-06,1,2.2780963315814773e-06,2,1.8945673281864254e-05
3477,purposefully,3,5.509358563746952e-06,2,4.556192663162955e-06,1,9.472836640932127e-06
3478,bounce,3,5.509358563746952e-06,2,4.556192663162955e-06,1,9.472836640932127e-06
3547,governing,3,5.509358563746952e-06,2,4.556192663162955e-06,1,9.472836640932127e-06
3572,greenhouse,3,5.509358563746952e-06,0,0,3,2.8418509922796382e-05
3569,15m,3,5.509358563746952e-06,1,2.2780963315814773e-06,2,1.8945673281864254e-05
3585,defunded,3,5.509358563746952e-06,1,2.2780963315814773e-06,2,1.8945673281864254e-05
3607,addresses,3,5.509358563746952e-06,2,4.556192663162955e-06,1,9.472836640932127e-06
3616,tova,3,5.509358563746952e-06,1,2.2780963315814773e-06,2,1.8945673281864254e-05
3625,urgency,3,5.509358563746952e-06,1,2.2780963315814773e-06,2,1.8945673281864254e-05
3628,oppression,3,5.509358563746952e-06,2,4.556192663162955e-06,1,9.472836640932127e-06
3639,245,3,5.509358563746952e-06,1,2.2780963315814773e-06,2,1.8945673281864254e-05
3651,commemorating,3,5.509358563746952e-06,2,4.556192663162955e-06,1,9.472836640932127e-06
3703,gravity,3,5.509358563746952e-06,2,4.556192663162955e-06,1,9.472836640932127e-06
3724,semper,3,5.509358563746952e-06,2,4.556192663162955e-06,1,9.472836640932127e-06
3728,homeownership,3,5.509358563746952e-06,0,0,3,2.8418509922796382e-05
3735,accounted,3,5.509358563746952e-06,2,4.556192663162955e-06,1,9.472836640932127e-06
3743,#vra,3,5.509358563746952e-06,0,0,3,2.8418509922796382e-05
3754,racked,3,5.509358563746952e-06,1,2.2780963315814773e-06,2,1.8945673281864254e-05
3757,uncertainty,3,5.509358563746952e-06,1,2.2780963315814773e-06,2,1.8945673281864254e-05
3788,cbo,3,5.509358563746952e-06,1,2.2780963315814773e-06,2,1.8945673281864254e-05
3794,praises,3,5.509358563746952e-06,2,4.556192663162955e-06,1,9.472836640932127e-06
3799,awful,3,5.509358563746952e-06,2,4.556192663162955e-06,1,9.472836640932127e-06
3803,trypresident,3,5.509358563746952e-06,0,0,3,2.8418509922796382e-05
3812,illness,3,5.509358563746952e-06,2,4.556192663162955e-06,1,9.472836640932127e-06
3818,morally,3,5.509358563746952e-06,2,4.556192663162955e-06,1,9.472836640932127e-06
3840,childrens,3,5.509358563746952e-06,2,4.556192663162955e-06,1,9.472836640932127e-06
3844,pioneer,3,5.509358563746952e-06,1,2.2780963315814773e-06,2,1.8945673281864254e-05
3907,drill,3,5.509358563746952e-06,2,4.556192663162955e-06,1,9.472836640932127e-06
3908,upheld,3,5.509358563746952e-06,0,0,3,2.8418509922796382e-05
3909,airfare,3,5.509358563746952e-06,0,0,3,2.8418509922796382e-05
3916,@renewoureconomy,3,5.509358563746952e-06,0,0,3,2.8418509922796382e-05
3921,doma,3,5.509358563746952e-06,0,0,3,2.8418509922796382e-05
3940,@abbywambach,3,5.509358563746952e-06,0,0,3,2.8418509922796382e-05
3943,#nbafinals,3,5.509358563746952e-06,0,0,3,2.8418509922796382e-05
3971,violenceand,3,5.509358563746952e-06,0,0,3,2.8418509922796382e-05
4010,expands,3,5.509358563746952e-06,2,4.556192663162955e-06,1,9.472836640932127e-06
4016,activated,3,5.509358563746952e-06,1,2.2780963315814773e-06,2,1.8945673281864254e-05
4020,stafford,3,5.509358563746952e-06,1,2.2780963315814773e-06,2,1.8945673281864254e-05
4021,privileged,3,5.509358563746952e-06,0,0,3,2.8418509922796382e-05
4027,shore,3,5.509358563746952e-06,2,4.556192663162955e-06,1,9.472836640932127e-06
4056,foster,3,5.509358563746952e-06,2,4.556192663162955e-06,1,9.472836640932127e-06
4071,600000,3,5.509358563746952e-06,2,4.556192663162955e-06,1,9.472836640932127e-06
4079,momentarily,3,5.509358563746952e-06,2,4.556192663162955e-06,1,9.472836640932127e-06
4107,glass,3,5.509358563746952e-06,2,4.556192663162955e-06,1,9.472836640932127e-06
4117,theaters,3,5.509358563746952e-06,1,2.2780963315814773e-06,2,1.8945673281864254e-05
4128,livesand,3,5.509358563746952e-06,0,0,3,2.8418509922796382e-05
4133,buddies,3,5.509358563746952e-06,0,0,3,2.8418509922796382e-05
4140,reflection,3,5.509358563746952e-06,0,0,3,2.8418509922796382e-05
4150,heartbreak,3,5.509358563746952e-06,1,2.2780963315814773e-06,2,1.8945673281864254e-05
4155,warscombined,3,5.509358563746952e-06,0,0,3,2.8418509922796382e-05
4166,tear,3,5.509358563746952e-06,2,4.556192663162955e-06,1,9.472836640932127e-06
4194,millionairesnot,3,5.509358563746952e-06,0,0,3,2.8418509922796382e-05
4199,transfers,3,5.509358563746952e-06,2,4.556192663162955e-06,1,9.472836640932127e-06
4200,87,3,5.509358563746952e-06,2,4.556192663162955e-06,1,9.472836640932127e-06
4201,americaand,3,5.509358563746952e-06,0,0,3,2.8418509922796382e-05
4211,reauthorize,3,5.509358563746952e-06,2,4.556192663162955e-06,1,9.472836640932127e-06
4250,gabby,3,5.509358563746952e-06,0,0,3,2.8418509922796382e-05
4277,rewards,3,5.509358563746952e-06,1,2.2780963315814773e-06,2,1.8945673281864254e-05
4282,innovate,3,5.509358563746952e-06,1,2.2780963315814773e-06,2,1.8945673281864254e-05
4300,invests,3,5.509358563746952e-06,0,0,3,2.8418509922796382e-05
4307,shall,3,5.509358563746952e-06,2,4.556192663162955e-06,1,9.472836640932127e-06
4308,#immigrationstory,3,5.509358563746952e-06,0,0,3,2.8418509922796382e-05
4359,substitute,3,5.509358563746952e-06,2,4.556192663162955e-06,1,9.472836640932127e-06
4391,divisive,3,5.509358563746952e-06,2,4.556192663162955e-06,1,9.472836640932127e-06
4401,dime,3,5.509358563746952e-06,1,2.2780963315814773e-06,2,1.8945673281864254e-05
4403,34th,3,5.509358563746952e-06,1,2.2780963315814773e-06,2,1.8945673281864254e-05
4407,reduces,3,5.509358563746952e-06,2,4.556192663162955e-06,1,9.472836640932127e-06
4435,davenport,3,5.509358563746952e-06,0,0,3,2.8418509922796382e-05
4450,proposals,3,5.509358563746952e-06,1,2.2780963315814773e-06,2,1.8945673281864254e-05
4487,weigh,3,5.509358563746952e-06,0,0,3,2.8418509922796382e-05
4495,archives,3,5.509358563746952e-06,0,0,3,2.8418509922796382e-05
4527,pt,3,5.509358563746952e-06,2,4.556192663162955e-06,1,9.472836640932127e-06
4551,purple,3,5.509358563746952e-06,2,4.556192663162955e-06,1,9.472836640932127e-06
4603,servicemembers,3,5.509358563746952e-06,0,0,3,2.8418509922796382e-05
4619,takers,3,5.509358563746952e-06,2,4.556192663162955e-06,1,9.472836640932127e-06
4666,#wedecide,3,5.509358563746952e-06,0,0,3,2.8418509922796382e-05
4701,classpresident,3,5.509358563746952e-06,0,0,3,2.8418509922796382e-05
4728,instructions,3,5.509358563746952e-06,2,4.556192663162955e-06,1,9.472836640932127e-06
4757,il,3,5.509358563746952e-06,1,2.2780963315814773e-06,2,1.8945673281864254e-05
4790,method,3,5.509358563746952e-06,2,4.556192663162955e-06,1,9.472836640932127e-06
4811,casino,3,5.509358563746952e-06,1,2.2780963315814773e-06,2,1.8945673281864254e-05
4826,chasing,3,5.509358563746952e-06,2,4.556192663162955e-06,1,9.472836640932127e-06
4867,t-shirts,3,5.509358563746952e-06,1,2.2780963315814773e-06,2,1.8945673281864254e-05
4871,recruit,3,5.509358563746952e-06,0,0,3,2.8418509922796382e-05
4888,outbreak,3,5.509358563746952e-06,2,4.556192663162955e-06,1,9.472836640932127e-06
4890,08,3,5.509358563746952e-06,0,0,3,2.8418509922796382e-05
4900,retaining,3,5.509358563746952e-06,1,2.2780963315814773e-06,2,1.8945673281864254e-05
4905,#romneywrong,3,5.509358563746952e-06,0,0,3,2.8418509922796382e-05
4920,deductions,3,5.509358563746952e-06,1,2.2780963315814773e-06,2,1.8945673281864254e-05
4923,ranked,3,5.509358563746952e-06,1,2.2780963315814773e-06,2,1.8945673281864254e-05
4961,78,3,5.509358563746952e-06,2,4.556192663162955e-06,1,9.472836640932127e-06
4967,resumes,3,5.509358563746952e-06,0,0,3,2.8418509922796382e-05
4981,threatens,3,5.509358563746952e-06,1,2.2780963315814773e-06,2,1.8945673281864254e-05
4984,leveling,3,5.509358563746952e-06,0,0,3,2.8418509922796382e-05
4989,gerald,3,5.509358563746952e-06,2,4.556192663162955e-06,1,9.472836640932127e-06
4992,advisors,3,5.509358563746952e-06,2,4.556192663162955e-06,1,9.472836640932127e-06
5005,bird,3,5.509358563746952e-06,0,0,3,2.8418509922796382e-05
5009,#realromney,3,5.509358563746952e-06,0,0,3,2.8418509922796382e-05
5012,striving,3,5.509358563746952e-06,0,0,3,2.8418509922796382e-05
5021,#mittmath,3,5.509358563746952e-06,0,0,3,2.8418509922796382e-05
5043,#teamobamabiden,3,5.509358563746952e-06,0,0,3,2.8418509922796382e-05
5073,#teamjoe,3,5.509358563746952e-06,0,0,3,2.8418509922796382e-05
5079,wire,3,5.509358563746952e-06,2,4.556192663162955e-06,1,9.472836640932127e-06
5082,#detailsmatter,3,5.509358563746952e-06,0,0,3,2.8418509922796382e-05
5087,arithmetic,3,5.509358563746952e-06,0,0,3,2.8418509922796382e-05
5094,crippling,3,5.509358563746952e-06,2,4.556192663162955e-06,1,9.472836640932127e-06
5100,pretends,3,5.509358563746952e-06,2,4.556192663162955e-06,1,9.472836640932127e-06
5103,jerk,3,5.509358563746952e-06,2,4.556192663162955e-06,1,9.472836640932127e-06
5152,owes,3,5.509358563746952e-06,2,4.556192663162955e-06,1,9.472836640932127e-06
5155,hammer,3,5.509358563746952e-06,2,4.556192663162955e-06,1,9.472836640932127e-06
5171,describe,3,5.509358563746952e-06,2,4.556192663162955e-06,1,9.472836640932127e-06
5172,intend,3,5.509358563746952e-06,2,4.556192663162955e-06,1,9.472836640932127e-06
5174,#debate2012,3,5.509358563746952e-06,0,0,3,2.8418509922796382e-05
5181,prep,3,5.509358563746952e-06,2,4.556192663162955e-06,1,9.472836640932127e-06
5192,47th,3,5.509358563746952e-06,0,0,3,2.8418509922796382e-05
5194,10000000,3,5.509358563746952e-06,1,2.2780963315814773e-06,2,1.8945673281864254e-05
5213,62262,3,5.509358563746952e-06,0,0,3,2.8418509922796382e-05
5231,#writtenoffbyromney,3,5.509358563746952e-06,0,0,3,2.8418509922796382e-05
5233,45000,3,5.509358563746952e-06,2,4.556192663162955e-06,1,9.472836640932127e-06
5244,scenes,3,5.509358563746952e-06,2,4.556192663162955e-06,1,9.472836640932127e-06
5251,mindset,3,5.509358563746952e-06,2,4.556192663162955e-06,1,9.472836640932127e-06
5293,sox,3,5.509358563746952e-06,1,2.2780963315814773e-06,2,1.8945673281864254e-05
5357,melbourne,3,5.509358563746952e-06,2,4.556192663162955e-06,1,9.472836640932127e-06
5363,pierce,3,5.509358563746952e-06,1,2.2780963315814773e-06,2,1.8945673281864254e-05
5372,ft,3,5.509358563746952e-06,2,4.556192663162955e-06,1,9.472836640932127e-06
5376,floridians,3,5.509358563746952e-06,1,2.2780963315814773e-06,2,1.8945673281864254e-05
5402,chairwoman,3,5.509358563746952e-06,2,4.556192663162955e-06,1,9.472836640932127e-06
5428,fired-up,3,5.509358563746952e-06,0,0,3,2.8418509922796382e-05
5432,weakened,3,5.509358563746952e-06,2,4.556192663162955e-06,1,9.472836640932127e-06
5453,predecessor,3,5.509358563746952e-06,2,4.556192663162955e-06,1,9.472836640932127e-06
5461,depend,3,5.509358563746952e-06,1,2.2780963315814773e-06,2,1.8945673281864254e-05
5476,boovote,3,5.509358563746952e-06,0,0,3,2.8418509922796382e-05
5582,6350,3,5.509358563746952e-06,0,0,3,2.8418509922796382e-05
5612,discriminatory,3,5.509358563746952e-06,2,4.556192663162955e-06,1,9.472836640932127e-06
5642,youpresident,3,5.509358563746952e-06,0,0,3,2.8418509922796382e-05
5662,custom,3,5.509358563746952e-06,1,2.2780963315814773e-06,2,1.8945673281864254e-05
5665,owns,3,5.509358563746952e-06,1,2.2780963315814773e-06,2,1.8945673281864254e-05
5674,tennis,3,5.509358563746952e-06,1,2.2780963315814773e-06,2,1.8945673281864254e-05
5695,@ofaoh,3,5.509358563746952e-06,0,0,3,2.8418509922796382e-05
5726,35000,3,5.509358563746952e-06,2,4.556192663162955e-06,1,9.472836640932127e-06
5740,incentives,3,5.509358563746952e-06,2,4.556192663162955e-06,1,9.472836640932127e-06
5768,explanation,3,5.509358563746952e-06,1,2.2780963315814773e-06,2,1.8945673281864254e-05
5775,contrast,3,5.509358563746952e-06,2,4.556192663162955e-06,1,9.472836640932127e-06
5792,rebate,3,5.509358563746952e-06,0,0,3,2.8418509922796382e-05
5798,barber,3,5.509358563746952e-06,1,2.2780963315814773e-06,2,1.8945673281864254e-05
5799,disloyal,3,5.509358563746952e-06,2,4.556192663162955e-06,1,9.472836640932127e-06
5852,havens,3,5.509358563746952e-06,1,2.2780963315814773e-06,2,1.8945673281864254e-05
5871,totaling,3,5.509358563746952e-06,0,0,3,2.8418509922796382e-05
5890,manufacturer,3,5.509358563746952e-06,0,0,3,2.8418509922796382e-05
5924,tip,3,5.509358563746952e-06,2,4.556192663162955e-06,1,9.472836640932127e-06
5933,replay,3,5.509358563746952e-06,2,4.556192663162955e-06,1,9.472836640932127e-06
5932,charts,3,5.509358563746952e-06,2,4.556192663162955e-06,1,9.472836640932127e-06
5937,depends,3,5.509358563746952e-06,1,2.2780963315814773e-06,2,1.8945673281864254e-05
5943,repeating,3,5.509358563746952e-06,2,4.556192663162955e-06,1,9.472836640932127e-06
5959,angel,3,5.509358563746952e-06,2,4.556192663162955e-06,1,9.472836640932127e-06
5974,classrooms,3,5.509358563746952e-06,1,2.2780963315814773e-06,2,1.8945673281864254e-05
5978,internship,3,5.509358563746952e-06,0,0,3,2.8418509922796382e-05
5985,retro,3,5.509358563746952e-06,0,0,3,2.8418509922796382e-05
6001,allied,3,5.509358563746952e-06,2,4.556192663162955e-06,1,9.472836640932127e-06
6020,interactive,3,5.509358563746952e-06,0,0,3,2.8418509922796382e-05
6023,crackdown,3,5.509358563746952e-06,2,4.556192663162955e-06,1,9.472836640932127e-06
6025,750,3,5.509358563746952e-06,1,2.2780963315814773e-06,2,1.8945673281864254e-05
6038,inspires,3,5.509358563746952e-06,1,2.2780963315814773e-06,2,1.8945673281864254e-05
6046,sixth,3,5.509358563746952e-06,2,4.556192663162955e-06,1,9.472836640932127e-06
6062,photograph,3,5.509358563746952e-06,2,4.556192663162955e-06,1,9.472836640932127e-06
6070,difficulties,3,5.509358563746952e-06,2,4.556192663162955e-06,1,9.472836640932127e-06
6089,valerie,3,5.509358563746952e-06,2,4.556192663162955e-06,1,9.472836640932127e-06
6093,playlist,3,5.509358563746952e-06,0,0,3,2.8418509922796382e-05
6105,parker,3,5.509358563746952e-06,2,4.556192663162955e-06,1,9.472836640932127e-06
6147,ann,3,5.509358563746952e-06,2,4.556192663162955e-06,1,9.472836640932127e-06
6150,homeowner,3,5.509358563746952e-06,0,0,3,2.8418509922796382e-05
6155,make-or-break,3,5.509358563746952e-06,0,0,3,2.8418509922796382e-05
6196,contested,3,5.509358563746952e-06,2,4.556192663162955e-06,1,9.472836640932127e-06
6199,05,3,5.509358563746952e-06,2,4.556192663162955e-06,1,9.472836640932127e-06
6209,travels,3,5.509358563746952e-06,2,4.556192663162955e-06,1,9.472836640932127e-06
6220,quarterly,3,5.509358563746952e-06,2,4.556192663162955e-06,1,9.472836640932127e-06
6221,clooneys,3,5.509358563746952e-06,0,0,3,2.8418509922796382e-05
6234,fallon,3,5.509358563746952e-06,1,2.2780963315814773e-06,2,1.8945673281864254e-05
6282,55000,3,5.509358563746952e-06,2,4.556192663162955e-06,1,9.472836640932127e-06
6298,fairer,3,5.509358563746952e-06,1,2.2780963315814773e-06,2,1.8945673281864254e-05
6312,helm,3,5.509358563746952e-06,2,4.556192663162955e-06,1,9.472836640932127e-06
6314,#51volunteers,3,5.509358563746952e-06,0,0,3,2.8418509922796382e-05
6319,@messina2012,3,5.509358563746952e-06,0,0,3,2.8418509922796382e-05
6327,daring,3,5.509358563746952e-06,2,4.556192663162955e-06,1,9.472836640932127e-06
6340,reply,3,5.509358563746952e-06,1,2.2780963315814773e-06,2,1.8945673281864254e-05
6360,billionaire,3,5.509358563746952e-06,2,4.556192663162955e-06,1,9.472836640932127e-06
6361,out-organize,3,5.509358563746952e-06,0,0,3,2.8418509922796382e-05
6379,edition,3,5.509358563746952e-06,1,2.2780963315814773e-06,2,1.8945673281864254e-05
6416,activist,3,5.509358563746952e-06,2,4.556192663162955e-06,1,9.472836640932127e-06
6427,#roadtraveled,3,5.509358563746952e-06,0,0,3,2.8418509922796382e-05
6433,deductible,3,5.509358563746952e-06,2,4.556192663162955e-06,1,9.472836640932127e-06
6436,all-of-the-above,3,5.509358563746952e-06,0,0,3,2.8418509922796382e-05
6440,#baracksbracket,3,5.509358563746952e-06,0,0,3,2.8418509922796382e-05
6450,unimaginable,3,5.509358563746952e-06,2,4.556192663162955e-06,1,9.472836640932127e-06
6452,dewey,3,5.509358563746952e-06,2,4.556192663162955e-06,1,9.472836640932127e-06
6483,followers,3,5.509358563746952e-06,2,4.556192663162955e-06,1,9.472836640932127e-06
6525,ton,3,5.509358563746952e-06,2,4.556192663162955e-06,1,9.472836640932127e-06
6535,iphone,3,5.509358563746952e-06,1,2.2780963315814773e-06,2,1.8945673281864254e-05
6556,meets,3,5.509358563746952e-06,1,2.2780963315814773e-06,2,1.8945673281864254e-05
6563,17th,3,5.509358563746952e-06,2,4.556192663162955e-06,1,9.472836640932127e-06
6565,feb,3,5.509358563746952e-06,0,0,3,2.8418509922796382e-05
6576,160,3,5.509358563746952e-06,1,2.2780963315814773e-06,2,1.8945673281864254e-05
6620,cannon,3,5.509358563746952e-06,0,0,3,2.8418509922796382e-05
6636,proposes,3,5.509358563746952e-06,1,2.2780963315814773e-06,2,1.8945673281864254e-05
6646,one-term,3,5.509358563746952e-06,0,0,3,2.8418509922796382e-05
6670,mortgage,3,5.509358563746952e-06,1,2.2780963315814773e-06,2,1.8945673281864254e-05
6671,ingenuity,3,5.509358563746952e-06,1,2.2780963315814773e-06,2,1.8945673281864254e-05
6683,blueprint,3,5.509358563746952e-06,2,4.556192663162955e-06,1,9.472836640932127e-06
6691,tourism,3,5.509358563746952e-06,1,2.2780963315814773e-06,2,1.8945673281864254e-05
6704,characters,3,5.509358563746952e-06,2,4.556192663162955e-06,1,9.472836640932127e-06
6729,cry,3,5.509358563746952e-06,2,4.556192663162955e-06,1,9.472836640932127e-06
6732,dividing,3,5.509358563746952e-06,2,4.556192663162955e-06,1,9.472836640932127e-06
6749,cordray,3,5.509358563746952e-06,1,2.2780963315814773e-06,2,1.8945673281864254e-05
6752,appointing,3,5.509358563746952e-06,2,4.556192663162955e-06,1,9.472836640932127e-06
6761,calendar,3,5.509358563746952e-06,1,2.2780963315814773e-06,2,1.8945673281864254e-05
6778,santa,3,5.509358563746952e-06,2,4.556192663162955e-06,1,9.472836640932127e-06
6786,welcomes,3,5.509358563746952e-06,0,0,3,2.8418509922796382e-05
6824,113,3,5.509358563746952e-06,2,4.556192663162955e-06,1,9.472836640932127e-06
6828,83,3,5.509358563746952e-06,2,4.556192663162955e-06,1,9.472836640932127e-06
6830,legislator,3,5.509358563746952e-06,0,0,3,2.8418509922796382e-05
6846,#veteranscantwait,3,5.509358563746952e-06,0,0,3,2.8418509922796382e-05
6859,pending,3,5.509358563746952e-06,2,4.556192663162955e-06,1,9.472836640932127e-06
6865,disabled,3,5.509358563746952e-06,2,4.556192663162955e-06,1,9.472836640932127e-06
6877,rails,3,5.509358563746952e-06,1,2.2780963315814773e-06,2,1.8945673281864254e-05
6885,digital,3,5.509358563746952e-06,2,4.556192663162955e-06,1,9.472836640932127e-06
6909,finger,3,5.509358563746952e-06,2,4.556192663162955e-06,1,9.472836640932127e-06
6929,artists,3,5.509358563746952e-06,2,4.556192663162955e-06,1,9.472836640932127e-06
6944,pink,3,5.509358563746952e-06,0,0,3,2.8418509922796382e-05
6962,pin,3,5.509358563746952e-06,2,4.556192663162955e-06,1,9.472836640932127e-06
6974,tally,3,5.509358563746952e-06,2,4.556192663162955e-06,1,9.472836640932127e-06
6985,strip,3,5.509358563746952e-06,2,4.556192663162955e-06,1,9.472836640932127e-06
7007,physician,3,5.509358563746952e-06,2,4.556192663162955e-06,1,9.472836640932127e-06
7013,irene,3,5.509358563746952e-06,0,0,3,2.8418509922796382e-05
7015,commemorate,3,5.509358563746952e-06,2,4.556192663162955e-06,1,9.472836640932127e-06
7022,shelter,3,5.509358563746952e-06,1,2.2780963315814773e-06,2,1.8945673281864254e-05
7051,diversity,3,5.509358563746952e-06,2,4.556192663162955e-06,1,9.472836640932127e-06
7052,1pm,3,5.509358563746952e-06,0,0,3,2.8418509922796382e-05
7056,#bo50,3,5.509358563746952e-06,0,0,3,2.8418509922796382e-05
7063,alice,3,5.509358563746952e-06,2,4.556192663162955e-06,1,9.472836640932127e-06
7072,approx,3,5.509358563746952e-06,2,4.556192663162955e-06,1,9.472836640932127e-06
7080,swear,3,5.509358563746952e-06,2,4.556192663162955e-06,1,9.472836640932127e-06
7112,@johncornyn,3,5.509358563746952e-06,2,4.556192663162955e-06,1,9.472836640932127e-06
7236,certified,3,5.509358563746952e-06,2,4.556192663162955e-06,1,9.472836640932127e-06
7239,revenues,3,5.509358563746952e-06,2,4.556192663162955e-06,1,9.472836640932127e-06
7242,shuttle,3,5.509358563746952e-06,1,2.2780963315814773e-06,2,1.8945673281864254e-05
7253,finals,3,5.509358563746952e-06,2,4.556192663162955e-06,1,9.472836640932127e-06
7257,cheney,3,5.509358563746952e-06,2,4.556192663162955e-06,1,9.472836640932127e-06
7262,headlines,3,5.509358563746952e-06,2,4.556192663162955e-06,1,9.472836640932127e-06
7269,11am,3,5.509358563746952e-06,1,2.2780963315814773e-06,2,1.8945673281864254e-05
7277,stream,3,5.509358563746952e-06,1,2.2780963315814773e-06,2,1.8945673281864254e-05
7279,enjoying,3,5.509358563746952e-06,2,4.556192663162955e-06,1,9.472836640932127e-06
7281,26th,3,5.509358563746952e-06,1,2.2780963315814773e-06,2,1.8945673281864254e-05
7282,450000,3,5.509358563746952e-06,2,4.556192663162955e-06,1,9.472836640932127e-06
7292,frequent,3,5.509358563746952e-06,2,4.556192663162955e-06,1,9.472836640932127e-06
7296,lights,3,5.509358563746952e-06,2,4.556192663162955e-06,1,9.472836640932127e-06
7308,filing,3,5.509358563746952e-06,2,4.556192663162955e-06,1,9.472836640932127e-06
7318,latin,3,5.509358563746952e-06,2,4.556192663162955e-06,1,9.472836640932127e-06
7319,partnerships,3,5.509358563746952e-06,2,4.556192663162955e-06,1,9.472836640932127e-06
7323,deserving,3,5.509358563746952e-06,2,4.556192663162955e-06,1,9.472836640932127e-06
7329,earthquake,3,5.509358563746952e-06,2,4.556192663162955e-06,1,9.472836640932127e-06
7331,sustainable,3,5.509358563746952e-06,2,4.556192663162955e-06,1,9.472836640932127e-06
7345,3pm,3,5.509358563746952e-06,1,2.2780963315814773e-06,2,1.8945673281864254e-05
7353,lunar,3,5.509358563746952e-06,2,4.556192663162955e-06,1,9.472836640932127e-06
7358,competent,3,5.509358563746952e-06,2,4.556192663162955e-06,1,9.472836640932127e-06
7425,inserted,3,5.509358563746952e-06,2,4.556192663162955e-06,1,9.472836640932127e-06
7440,11pm,3,5.509358563746952e-06,2,4.556192663162955e-06,1,9.472836640932127e-06
7451,6pm,3,5.509358563746952e-06,0,0,3,2.8418509922796382e-05
7476,special-interest,3,5.509358563746952e-06,0,0,3,2.8418509922796382e-05
7480,reliance,3,5.509358563746952e-06,2,4.556192663162955e-06,1,9.472836640932127e-06
7493,renewal,3,5.509358563746952e-06,2,4.556192663162955e-06,1,9.472836640932127e-06
7504,rosh,3,5.509358563746952e-06,2,4.556192663162955e-06,1,9.472836640932127e-06
7503,hashanah,3,5.509358563746952e-06,2,4.556192663162955e-06,1,9.472836640932127e-06
7539,slide,3,5.509358563746952e-06,2,4.556192663162955e-06,1,9.472836640932127e-06
7562,@twitter,3,5.509358563746952e-06,2,4.556192663162955e-06,1,9.472836640932127e-06
7567,provider,3,5.509358563746952e-06,1,2.2780963315814773e-06,2,1.8945673281864254e-05
7568,canceling,3,5.509358563746952e-06,2,4.556192663162955e-06,1,9.472836640932127e-06
7572,bp,3,5.509358563746952e-06,0,0,3,2.8418509922796382e-05
7576,responding,3,5.509358563746952e-06,2,4.556192663162955e-06,1,9.472836640932127e-06
7577,awaits,3,5.509358563746952e-06,2,4.556192663162955e-06,1,9.472836640932127e-06
7610,emerge,3,5.509358563746952e-06,2,4.556192663162955e-06,1,9.472836640932127e-06
7622,@usedgov,3,5.509358563746952e-06,2,4.556192663162955e-06,1,9.472836640932127e-06
7626,budgets,3,5.509358563746952e-06,2,4.556192663162955e-06,1,9.472836640932127e-06
7631,weaken,3,5.509358563746952e-06,2,4.556192663162955e-06,1,9.472836640932127e-06
7641,relentless,3,5.509358563746952e-06,2,4.556192663162955e-06,1,9.472836640932127e-06
7647,entrepreneurship,3,5.509358563746952e-06,1,2.2780963315814773e-06,2,1.8945673281864254e-05
7665,pursuing,3,5.509358563746952e-06,2,4.556192663162955e-06,1,9.472836640932127e-06
7682,preexisting,3,5.509358563746952e-06,2,4.556192663162955e-06,1,9.472836640932127e-06
7702,rescued,3,5.509358563746952e-06,2,4.556192663162955e-06,1,9.472836640932127e-06
7729,root,3,5.509358563746952e-06,2,4.556192663162955e-06,1,9.472836640932127e-06
7734,technologies,3,5.509358563746952e-06,2,4.556192663162955e-06,1,9.472836640932127e-06
7743,frustration,3,5.509358563746952e-06,2,4.556192663162955e-06,1,9.472836640932127e-06
7750,@marthacoakley,3,5.509358563746952e-06,0,0,3,2.8418509922796382e-05
7752,sundays,3,5.509358563746952e-06,2,4.556192663162955e-06,1,9.472836640932127e-06
7775,7am,3,5.509358563746952e-06,2,4.556192663162955e-06,1,9.472836640932127e-06
7781,husbands,3,5.509358563746952e-06,2,4.556192663162955e-06,1,9.472836640932127e-06
7791,5pm,3,5.509358563746952e-06,1,2.2780963315814773e-06,2,1.8945673281864254e-05
7804,secures,3,5.509358563746952e-06,2,4.556192663162955e-06,1,9.472836640932127e-06
7841,rationing,3,5.509358563746952e-06,2,4.556192663162955e-06,1,9.472836640932127e-06
7865,ordering,3,5.509358563746952e-06,2,4.556192663162955e-06,1,9.472836640932127e-06
7873,kickoff,3,5.509358563746952e-06,1,2.2780963315814773e-06,2,1.8945673281864254e-05
7874,#obamahealthcare,3,5.509358563746952e-06,0,0,3,2.8418509922796382e-05
7885,elise,3,5.509358563746952e-06,3,6.8342889947444315e-06,0,0
7889,threshold,3,5.509358563746952e-06,3,6.8342889947444315e-06,0,0
7910,@sentomcotton,3,5.509358563746952e-06,3,6.8342889947444315e-06,0,0
7919,certification,3,5.509358563746952e-06,3,6.8342889947444315e-06,0,0
7937,82,3,5.509358563746952e-06,3,6.8342889947444315e-06,0,0
7946,tampering,3,5.509358563746952e-06,3,6.8342889947444315e-06,0,0
7947,#stopthesteal,3,5.509358563746952e-06,3,6.8342889947444315e-06,0,0
7963,verified,3,5.509358563746952e-06,3,6.8342889947444315e-06,0,0
7978,nolte,3,5.509358563746952e-06,3,6.8342889947444315e-06,0,0
8002,@senjohnthune,3,5.509358563746952e-06,3,6.8342889947444315e-06,0,0
8026,artificial,3,5.509358563746952e-06,3,6.8342889947444315e-06,0,0
8064,simington,3,5.509358563746952e-06,3,6.8342889947444315e-06,0,0
8072,@mikepence,3,5.509358563746952e-06,3,6.8342889947444315e-06,0,0
8093,intervention,3,5.509358563746952e-06,3,6.8342889947444315e-06,0,0
8109,ignorant,3,5.509358563746952e-06,3,6.8342889947444315e-06,0,0
8122,sampling,3,5.509358563746952e-06,3,6.8342889947444315e-06,0,0
8124,widespread,3,5.509358563746952e-06,3,6.8342889947444315e-06,0,0
8131,loeffler,3,5.509358563746952e-06,3,6.8342889947444315e-06,0,0
8142,241,3,5.509358563746952e-06,3,6.8342889947444315e-06,0,0
8181,krebs,3,5.509358563746952e-06,3,6.8342889947444315e-06,0,0
8189,viable,3,5.509358563746952e-06,3,6.8342889947444315e-06,0,0
8191,clark,3,5.509358563746952e-06,3,6.8342889947444315e-06,0,0
8199,threatened,3,5.509358563746952e-06,3,6.8342889947444315e-06,0,0
8198,screamed,3,5.509358563746952e-06,3,6.8342889947444315e-06,0,0
8208,eviscerate,3,5.509358563746952e-06,3,6.8342889947444315e-06,0,0
8221,clobbered,3,5.509358563746952e-06,3,6.8342889947444315e-06,0,0
8248,schmidt,3,5.509358563746952e-06,3,6.8342889947444315e-06,0,0
8261,restaurant,3,5.509358563746952e-06,3,6.8342889947444315e-06,0,0
8283,unwatchable,3,5.509358563746952e-06,3,6.8342889947444315e-06,0,0
8288,ronna,3,5.509358563746952e-06,3,6.8342889947444315e-06,0,0
8300,healing,3,5.509358563746952e-06,3,6.8342889947444315e-06,0,0
8305,obliteration,3,5.509358563746952e-06,3,6.8342889947444315e-06,0,0
8315,orleans,3,5.509358563746952e-06,3,6.8342889947444315e-06,0,0
8375,regain,3,5.509358563746952e-06,3,6.8342889947444315e-06,0,0
8386,pro-trump,3,5.509358563746952e-06,3,6.8342889947444315e-06,0,0
8412,delphi,3,5.509358563746952e-06,3,6.8342889947444315e-06,0,0
8422,tribe,3,5.509358563746952e-06,3,6.8342889947444315e-06,0,0
8448,toomey,3,5.509358563746952e-06,3,6.8342889947444315e-06,0,0
8452,discrepancies,3,5.509358563746952e-06,3,6.8342889947444315e-06,0,0
8462,tossed,3,5.509358563746952e-06,3,6.8342889947444315e-06,0,0
8470,allentown,3,5.509358563746952e-06,3,6.8342889947444315e-06,0,0
8508,hogan,3,5.509358563746952e-06,3,6.8342889947444315e-06,0,0
8550,philadelpiha,3,5.509358563746952e-06,3,6.8342889947444315e-06,0,0
8564,alito,3,5.509358563746952e-06,3,6.8342889947444315e-06,0,0
8590,stacey,3,5.509358563746952e-06,3,6.8342889947444315e-06,0,0
8588,abrams,3,5.509358563746952e-06,3,6.8342889947444315e-06,0,0
8593,@gasecofstate,3,5.509358563746952e-06,3,6.8342889947444315e-06,0,0
8599,viewed,3,5.509358563746952e-06,3,6.8342889947444315e-06,0,0
8614,usps,3,5.509358563746952e-06,3,6.8342889947444315e-06,0,0
8621,checking,3,5.509358563746952e-06,3,6.8342889947444315e-06,0,0
8630,staten,3,5.509358563746952e-06,3,6.8342889947444315e-06,0,0
8640,autonomous,3,5.509358563746952e-06,3,6.8342889947444315e-06,0,0
8661,pundit,3,5.509358563746952e-06,3,6.8342889947444315e-06,0,0
8666,dominance,3,5.509358563746952e-06,3,6.8342889947444315e-06,0,0
8685,sleaze,3,5.509358563746952e-06,3,6.8342889947444315e-06,0,0
8694,unelectable,3,5.509358563746952e-06,3,6.8342889947444315e-06,0,0
8706,@staceyabrams,3,5.509358563746952e-06,3,6.8342889947444315e-06,0,0
8711,ocala,3,5.509358563746952e-06,3,6.8342889947444315e-06,0,0
8714,prepaid,3,5.509358563746952e-06,3,6.8342889947444315e-06,0,0
8719,pointed,3,5.509358563746952e-06,3,6.8342889947444315e-06,0,0
8744,privately,3,5.509358563746952e-06,3,6.8342889947444315e-06,0,0
8749,coney,3,5.509358563746952e-06,3,6.8342889947444315e-06,0,0
8753,sample,3,5.509358563746952e-06,3,6.8342889947444315e-06,0,0
8760,gatherings,3,5.509358563746952e-06,3,6.8342889947444315e-06,0,0
8763,irrefutable,3,5.509358563746952e-06,3,6.8342889947444315e-06,0,0
8771,victoria,3,5.509358563746952e-06,3,6.8342889947444315e-06,0,0
8768,sidney,3,5.509358563746952e-06,3,6.8342889947444315e-06,0,0
8772,techs,3,5.509358563746952e-06,3,6.8342889947444315e-06,0,0
8779,represenative,3,5.509358563746952e-06,3,6.8342889947444315e-06,0,0
8785,implementing,3,5.509358563746952e-06,3,6.8342889947444315e-06,0,0
8783,catch-and-release,3,5.509358563746952e-06,3,6.8342889947444315e-06,0,0
8791,potatoes,3,5.509358563746952e-06,3,6.8342889947444315e-06,0,0
8796,stuffing,3,5.509358563746952e-06,3,6.8342889947444315e-06,0,0
8809,charity,3,5.509358563746952e-06,3,6.8342889947444315e-06,0,0
8820,unsuccessful,3,5.509358563746952e-06,3,6.8342889947444315e-06,0,0
8838,insure,3,5.509358563746952e-06,3,6.8342889947444315e-06,0,0
8844,developer,3,5.509358563746952e-06,3,6.8342889947444315e-06,0,0
8849,tabulated,3,5.509358563746952e-06,3,6.8342889947444315e-06,0,0
8851,windfall,3,5.509358563746952e-06,3,6.8342889947444315e-06,0,0
8855,circles,3,5.509358563746952e-06,3,6.8342889947444315e-06,0,0
8869,suppressed,3,5.509358563746952e-06,3,6.8342889947444315e-06,0,0
8871,countryand,3,5.509358563746952e-06,3,6.8342889947444315e-06,0,0
8877,@rsbnetwork,3,5.509358563746952e-06,3,6.8342889947444315e-06,0,0
8911,graduations,3,5.509358563746952e-06,3,6.8342889947444315e-06,0,0
8913,abolishing,3,5.509358563746952e-06,3,6.8342889947444315e-06,0,0
8935,altered,3,5.509358563746952e-06,3,6.8342889947444315e-06,0,0
8949,observed,3,5.509358563746952e-06,3,6.8342889947444315e-06,0,0
8955,managers,3,5.509358563746952e-06,3,6.8342889947444315e-06,0,0
8961,jorge,3,5.509358563746952e-06,3,6.8342889947444315e-06,0,0
8966,zach,3,5.509358563746952e-06,3,6.8342889947444315e-06,0,0
8967,hicks,3,5.509358563746952e-06,3,6.8342889947444315e-06,0,0
8971,brazile,3,5.509358563746952e-06,3,6.8342889947444315e-06,0,0
8973,censor,3,5.509358563746952e-06,3,6.8342889947444315e-06,0,0
8991,rubin,3,5.509358563746952e-06,3,6.8342889947444315e-06,0,0
9010,marxists,3,5.509358563746952e-06,3,6.8342889947444315e-06,0,0
9009,flag-burners,3,5.509358563746952e-06,3,6.8342889947444315e-06,0,0
9033,yemen,3,5.509358563746952e-06,3,6.8342889947444315e-06,0,0
9027,floodgates,3,5.509358563746952e-06,3,6.8342889947444315e-06,0,0
9042,energized,3,5.509358563746952e-06,3,6.8342889947444315e-06,0,0
9053,cleanup,3,5.509358563746952e-06,3,6.8342889947444315e-06,0,0
9080,exception,3,5.509358563746952e-06,3,6.8342889947444315e-06,0,0
9094,vibrant,3,5.509358563746952e-06,3,6.8342889947444315e-06,0,0
9110,solely,3,5.509358563746952e-06,3,6.8342889947444315e-06,0,0
9119,knife,3,5.509358563746952e-06,3,6.8342889947444315e-06,0,0
9125,eliminated,3,5.509358563746952e-06,3,6.8342889947444315e-06,0,0
9135,communists,3,5.509358563746952e-06,3,6.8342889947444315e-06,0,0
9143,troop,3,5.509358563746952e-06,3,6.8342889947444315e-06,0,0
9148,brilliance,3,5.509358563746952e-06,3,6.8342889947444315e-06,0,0
9151,screwed,3,5.509358563746952e-06,3,6.8342889947444315e-06,0,0
9160,prople,3,5.509358563746952e-06,3,6.8342889947444315e-06,0,0
9172,vernon,3,5.509358563746952e-06,3,6.8342889947444315e-06,0,0
9170,@ffweekend,3,5.509358563746952e-06,3,6.8342889947444315e-06,0,0
9194,nigeria,3,5.509358563746952e-06,3,6.8342889947444315e-06,0,0
9205,misery,3,5.509358563746952e-06,3,6.8342889947444315e-06,0,0
9215,miranda,3,5.509358563746952e-06,3,6.8342889947444315e-06,0,0
9219,forged,3,5.509358563746952e-06,3,6.8342889947444315e-06,0,0
9226,madness,3,5.509358563746952e-06,3,6.8342889947444315e-06,0,0
9230,difficulty,3,5.509358563746952e-06,3,6.8342889947444315e-06,0,0
9241,stuffed,3,5.509358563746952e-06,3,6.8342889947444315e-06,0,0
9250,indoctrination,3,5.509358563746952e-06,3,6.8342889947444315e-06,0,0
9268,montoursville,3,5.509358563746952e-06,3,6.8342889947444315e-06,0,0
9288,dam,3,5.509358563746952e-06,3,6.8342889947444315e-06,0,0
9292,miracles,3,5.509358563746952e-06,3,6.8342889947444315e-06,0,0
9300,esther,3,5.509358563746952e-06,3,6.8342889947444315e-06,0,0
9311,preserving,3,5.509358563746952e-06,3,6.8342889947444315e-06,0,0
9338,collins,3,5.509358563746952e-06,3,6.8342889947444315e-06,0,0
9342,hemorrhaging,3,5.509358563746952e-06,3,6.8342889947444315e-06,0,0
9346,actor,3,5.509358563746952e-06,3,6.8342889947444315e-06,0,0
9369,in-person,3,5.509358563746952e-06,3,6.8342889947444315e-06,0,0
9373,error,3,5.509358563746952e-06,3,6.8342889947444315e-06,0,0
9394,durham,3,5.509358563746952e-06,3,6.8342889947444315e-06,0,0
9424,blatantly,3,5.509358563746952e-06,3,6.8342889947444315e-06,0,0
9432,absurd,3,5.509358563746952e-06,3,6.8342889947444315e-06,0,0
9445,specifically,3,5.509358563746952e-06,3,6.8342889947444315e-06,0,0
9449,administered,3,5.509358563746952e-06,3,6.8342889947444315e-06,0,0
9451,hispanic-american,3,5.509358563746952e-06,3,6.8342889947444315e-06,0,0
9479,slam,3,5.509358563746952e-06,3,6.8342889947444315e-06,0,0
9481,margins,3,5.509358563746952e-06,3,6.8342889947444315e-06,0,0
9482,depraved,3,5.509358563746952e-06,3,6.8342889947444315e-06,0,0
9500,flipped,3,5.509358563746952e-06,3,6.8342889947444315e-06,0,0
9545,y,3,5.509358563746952e-06,3,6.8342889947444315e-06,0,0
9583,@ups,3,5.509358563746952e-06,3,6.8342889947444315e-06,0,0
9588,navarro,3,5.509358563746952e-06,3,6.8342889947444315e-06,0,0
9590,sufficient,3,5.509358563746952e-06,3,6.8342889947444315e-06,0,0
9595,johnstown,3,5.509358563746952e-06,3,6.8342889947444315e-06,0,0
9600,italian,3,5.509358563746952e-06,3,6.8342889947444315e-06,0,0
9601,2000000,3,5.509358563746952e-06,3,6.8342889947444315e-06,0,0
9611,harvest,3,5.509358563746952e-06,3,6.8342889947444315e-06,0,0
9655,examined,3,5.509358563746952e-06,3,6.8342889947444315e-06,0,0
9657,corrupted,3,5.509358563746952e-06,3,6.8342889947444315e-06,0,0
9656,@dniratcliffe,3,5.509358563746952e-06,3,6.8342889947444315e-06,0,0
9665,operating,3,5.509358563746952e-06,3,6.8342889947444315e-06,0,0
9677,stifling,3,5.509358563746952e-06,3,6.8342889947444315e-06,0,0
9688,libyan,3,5.509358563746952e-06,3,6.8342889947444315e-06,0,0
9692,destroys,3,5.509358563746952e-06,3,6.8342889947444315e-06,0,0
9693,forts,3,5.509358563746952e-06,3,6.8342889947444315e-06,0,0
9699,windows,3,5.509358563746952e-06,3,6.8342889947444315e-06,0,0
9702,laxalt,3,5.509358563746952e-06,3,6.8342889947444315e-06,0,0
9721,nessel,3,5.509358563746952e-06,3,6.8342889947444315e-06,0,0
9729,matthew,3,5.509358563746952e-06,3,6.8342889947444315e-06,0,0
9754,landscaping,3,5.509358563746952e-06,3,6.8342889947444315e-06,0,0
9755,encounter,3,5.509358563746952e-06,3,6.8342889947444315e-06,0,0
9775,thieves,3,5.509358563746952e-06,3,6.8342889947444315e-06,0,0
9776,instance,3,5.509358563746952e-06,3,6.8342889947444315e-06,0,0
9792,categories,3,5.509358563746952e-06,3,6.8342889947444315e-06,0,0
9796,distribute,3,5.509358563746952e-06,3,6.8342889947444315e-06,0,0
9807,counterterrorism,3,5.509358563746952e-06,3,6.8342889947444315e-06,0,0
9822,excess,3,5.509358563746952e-06,3,6.8342889947444315e-06,0,0
9820,az,3,5.509358563746952e-06,3,6.8342889947444315e-06,0,0
9827,allegedly,3,5.509358563746952e-06,3,6.8342889947444315e-06,0,0
9857,noted,3,5.509358563746952e-06,3,6.8342889947444315e-06,0,0
9877,tucker,3,5.509358563746952e-06,3,6.8342889947444315e-06,0,0
9894,myer,3,5.509358563746952e-06,3,6.8342889947444315e-06,0,0
9900,#stopthebias,3,5.509358563746952e-06,3,6.8342889947444315e-06,0,0
9914,australias,3,5.509358563746952e-06,3,6.8342889947444315e-06,0,0
9969,@elisestefanik,3,5.509358563746952e-06,3,6.8342889947444315e-06,0,0
9989,booker,3,5.509358563746952e-06,3,6.8342889947444315e-06,0,0
9993,@mirandadevine,3,5.509358563746952e-06,3,6.8342889947444315e-06,0,0
10006,27000,3,5.509358563746952e-06,3,6.8342889947444315e-06,0,0
10031,disrespectful,3,5.509358563746952e-06,3,6.8342889947444315e-06,0,0
10037,#medalofhonorday,3,5.509358563746952e-06,3,6.8342889947444315e-06,0,0
10039,eternally,3,5.509358563746952e-06,3,6.8342889947444315e-06,0,0
10043,exceptions,3,5.509358563746952e-06,3,6.8342889947444315e-06,0,0
10054,prevalent,3,5.509358563746952e-06,3,6.8342889947444315e-06,0,0
10052,distort,3,5.509358563746952e-06,3,6.8342889947444315e-06,0,0
10064,confiscate,3,5.509358563746952e-06,3,6.8342889947444315e-06,0,0
10077,delta,3,5.509358563746952e-06,3,6.8342889947444315e-06,0,0
10087,limitless,3,5.509358563746952e-06,3,6.8342889947444315e-06,0,0
10092,conservation,3,5.509358563746952e-06,3,6.8342889947444315e-06,0,0
10095,performed,3,5.509358563746952e-06,3,6.8342889947444315e-06,0,0
10099,gen,3,5.509358563746952e-06,3,6.8342889947444315e-06,0,0
10108,chanting,3,5.509358563746952e-06,3,6.8342889947444315e-06,0,0
10115,fried,3,5.509358563746952e-06,3,6.8342889947444315e-06,0,0
10144,من,3,5.509358563746952e-06,3,6.8342889947444315e-06,0,0
10128,با,3,5.509358563746952e-06,3,6.8342889947444315e-06,0,0
10155,swift,3,5.509358563746952e-06,3,6.8342889947444315e-06,0,0
10162,@govkristinoem,3,5.509358563746952e-06,3,6.8342889947444315e-06,0,0
10195,defraud,3,5.509358563746952e-06,3,6.8342889947444315e-06,0,0
10216,reelection,3,5.509358563746952e-06,3,6.8342889947444315e-06,0,0
10233,دوباره,3,5.509358563746952e-06,3,6.8342889947444315e-06,0,0
10240,نظاره,3,5.509358563746952e-06,3,6.8342889947444315e-06,0,0
10244,گر,3,5.509358563746952e-06,3,6.8342889947444315e-06,0,0
10249,drilling,3,5.509358563746952e-06,3,6.8342889947444315e-06,0,0
10268,@sencapito,3,5.509358563746952e-06,3,6.8342889947444315e-06,0,0
10270,pensions,3,5.509358563746952e-06,3,6.8342889947444315e-06,0,0
10277,doctrine,3,5.509358563746952e-06,3,6.8342889947444315e-06,0,0
10279,deployed,3,5.509358563746952e-06,3,6.8342889947444315e-06,0,0
10281,hallowed,3,5.509358563746952e-06,3,6.8342889947444315e-06,0,0
10302,innovators,3,5.509358563746952e-06,3,6.8342889947444315e-06,0,0
10348,advisory,3,5.509358563746952e-06,3,6.8342889947444315e-06,0,0
10366,profoundly,3,5.509358563746952e-06,3,6.8342889947444315e-06,0,0
10367,lsu,3,5.509358563746952e-06,3,6.8342889947444315e-06,0,0
10369,properties,3,5.509358563746952e-06,3,6.8342889947444315e-06,0,0
10379,@stephenmoore,3,5.509358563746952e-06,3,6.8342889947444315e-06,0,0
10381,lapdog,3,5.509358563746952e-06,3,6.8342889947444315e-06,0,0
10390,basically,3,5.509358563746952e-06,3,6.8342889947444315e-06,0,0
10397,@fda,3,5.509358563746952e-06,3,6.8342889947444315e-06,0,0
10399,@jayinslee,3,5.509358563746952e-06,3,6.8342889947444315e-06,0,0
10404,dumber,3,5.509358563746952e-06,3,6.8342889947444315e-06,0,0
10413,unsourced,3,5.509358563746952e-06,3,6.8342889947444315e-06,0,0
10422,constructive,3,5.509358563746952e-06,3,6.8342889947444315e-06,0,0
10447,wicked,3,5.509358563746952e-06,3,6.8342889947444315e-06,0,0
10445,fate,3,5.509358563746952e-06,3,6.8342889947444315e-06,0,0
10442,despair,3,5.509358563746952e-06,3,6.8342889947444315e-06,0,0
10450,forewoman,3,5.509358563746952e-06,3,6.8342889947444315e-06,0,0
10459,jovita,3,5.509358563746952e-06,3,6.8342889947444315e-06,0,0
10470,inflame,3,5.509358563746952e-06,3,6.8342889947444315e-06,0,0
10493,smear,3,5.509358563746952e-06,3,6.8342889947444315e-06,0,0
10497,outlet,3,5.509358563746952e-06,3,6.8342889947444315e-06,0,0
10498,profusely,3,5.509358563746952e-06,3,6.8342889947444315e-06,0,0
10510,belittling,3,5.509358563746952e-06,3,6.8342889947444315e-06,0,0
10515,environmentally,3,5.509358563746952e-06,3,6.8342889947444315e-06,0,0
10527,lunatic,3,5.509358563746952e-06,3,6.8342889947444315e-06,0,0
10530,@jacobsny27,3,5.509358563746952e-06,3,6.8342889947444315e-06,0,0
10529,#ny27,3,5.509358563746952e-06,3,6.8342889947444315e-06,0,0
10537,astounding,3,5.509358563746952e-06,3,6.8342889947444315e-06,0,0
10542,@paulkrugman,3,5.509358563746952e-06,3,6.8342889947444315e-06,0,0
10543,122,3,5.509358563746952e-06,3,6.8342889947444315e-06,0,0
10565,nickname,3,5.509358563746952e-06,3,6.8342889947444315e-06,0,0
10585,@mowers,3,5.509358563746952e-06,3,6.8342889947444315e-06,0,0
10591,@usacehq,3,5.509358563746952e-06,3,6.8342889947444315e-06,0,0
10592,bed,3,5.509358563746952e-06,3,6.8342889947444315e-06,0,0
10594,javits,3,5.509358563746952e-06,3,6.8342889947444315e-06,0,0
10599,lesko,3,5.509358563746952e-06,3,6.8342889947444315e-06,0,0
10608,rampage,3,5.509358563746952e-06,3,6.8342889947444315e-06,0,0
10624,porous,3,5.509358563746952e-06,3,6.8342889947444315e-06,0,0
10626,useless,3,5.509358563746952e-06,3,6.8342889947444315e-06,0,0
10636,vanity,3,5.509358563746952e-06,3,6.8342889947444315e-06,0,0
10647,operational,3,5.509358563746952e-06,3,6.8342889947444315e-06,0,0
10659,nancys,3,5.509358563746952e-06,3,6.8342889947444315e-06,0,0
10675,deputies,3,5.509358563746952e-06,3,6.8342889947444315e-06,0,0
10682,prisons,3,5.509358563746952e-06,3,6.8342889947444315e-06,0,0
10680,anti-police,3,5.509358563746952e-06,3,6.8342889947444315e-06,0,0
10695,bs,3,5.509358563746952e-06,3,6.8342889947444315e-06,0,0
10712,@govbilllee,3,5.509358563746952e-06,3,6.8342889947444315e-06,0,0
10714,truckers,3,5.509358563746952e-06,3,6.8342889947444315e-06,0,0
10717,cnbc,3,5.509358563746952e-06,3,6.8342889947444315e-06,0,0
10750,experiencing,3,5.509358563746952e-06,3,6.8342889947444315e-06,0,0
10756,grandstander,3,5.509358563746952e-06,3,6.8342889947444315e-06,0,0
10760,miserably,3,5.509358563746952e-06,3,6.8342889947444315e-06,0,0
10776,@billhagertytn,3,5.509358563746952e-06,3,6.8342889947444315e-06,0,0
10794,@gregabbotttx,3,5.509358563746952e-06,3,6.8342889947444315e-06,0,0
10810,truthful,3,5.509358563746952e-06,3,6.8342889947444315e-06,0,0
10808,publisher,3,5.509358563746952e-06,3,6.8342889947444315e-06,0,0
10809,sulzberger,3,5.509358563746952e-06,3,6.8342889947444315e-06,0,0
10817,@christyforca25,3,5.509358563746952e-06,3,6.8342889947444315e-06,0,0
10819,bumping,3,5.509358563746952e-06,3,6.8342889947444315e-06,0,0
10821,mocking,3,5.509358563746952e-06,3,6.8342889947444315e-06,0,0
10824,recused,3,5.509358563746952e-06,3,6.8342889947444315e-06,0,0
10852,powered,3,5.509358563746952e-06,3,6.8342889947444315e-06,0,0
10857,maker,3,5.509358563746952e-06,3,6.8342889947444315e-06,0,0
10872,rushed,3,5.509358563746952e-06,3,6.8342889947444315e-06,0,0
10875,casualties,3,5.509358563746952e-06,3,6.8342889947444315e-06,0,0
10878,campos-duffy,3,5.509358563746952e-06,3,6.8342889947444315e-06,0,0
10912,regional,3,5.509358563746952e-06,3,6.8342889947444315e-06,0,0
10920,gt,3,5.509358563746952e-06,3,6.8342889947444315e-06,0,0
10927,@marcthiessen,3,5.509358563746952e-06,3,6.8342889947444315e-06,0,0
10934,magakag,3,5.509358563746952e-06,3,6.8342889947444315e-06,0,0
10971,corky,3,5.509358563746952e-06,3,6.8342889947444315e-06,0,0
10972,@corkyforsenate,3,5.509358563746952e-06,3,6.8342889947444315e-06,0,0
10976,route,3,5.509358563746952e-06,3,6.8342889947444315e-06,0,0
10982,515,3,5.509358563746952e-06,3,6.8342889947444315e-06,0,0
11003,شده,3,5.509358563746952e-06,3,6.8342889947444315e-06,0,0
11024,kosovo,3,5.509358563746952e-06,3,6.8342889947444315e-06,0,0
11050,deductibility,3,5.509358563746952e-06,3,6.8342889947444315e-06,0,0
11051,entertainment,3,5.509358563746952e-06,3,6.8342889947444315e-06,0,0
11054,@ufc,3,5.509358563746952e-06,3,6.8342889947444315e-06,0,0
11057,gavin,3,5.509358563746952e-06,3,6.8342889947444315e-06,0,0
11059,foolishness,3,5.509358563746952e-06,3,6.8342889947444315e-06,0,0
11070,reflects,3,5.509358563746952e-06,3,6.8342889947444315e-06,0,0
11082,shelley,3,5.509358563746952e-06,3,6.8342889947444315e-06,0,0
11116,routine,3,5.509358563746952e-06,3,6.8342889947444315e-06,0,0
11136,bergdahl,3,5.509358563746952e-06,3,6.8342889947444315e-06,0,0
11141,surgery,3,5.509358563746952e-06,3,6.8342889947444315e-06,0,0
11146,needle,3,5.509358563746952e-06,3,6.8342889947444315e-06,0,0
11144,drag,3,5.509358563746952e-06,3,6.8342889947444315e-06,0,0
11208,@davidmuir,3,5.509358563746952e-06,3,6.8342889947444315e-06,0,0
11214,dynamics,3,5.509358563746952e-06,3,6.8342889947444315e-06,0,0
11219,@honeywell,3,5.509358563746952e-06,3,6.8342889947444315e-06,0,0
11232,ventilator,3,5.509358563746952e-06,3,6.8342889947444315e-06,0,0
11244,wavered,3,5.509358563746952e-06,3,6.8342889947444315e-06,0,0
11248,restriction,3,5.509358563746952e-06,3,6.8342889947444315e-06,0,0
11261,tribal,3,5.509358563746952e-06,3,6.8342889947444315e-06,0,0
11264,factual,3,5.509358563746952e-06,3,6.8342889947444315e-06,0,0
11279,@dougjones,3,5.509358563746952e-06,3,6.8342889947444315e-06,0,0
11314,frack,3,5.509358563746952e-06,3,6.8342889947444315e-06,0,0
11331,#caresact,3,5.509358563746952e-06,3,6.8342889947444315e-06,0,0
11332,@bankofamerica,3,5.509358563746952e-06,3,6.8342889947444315e-06,0,0
11338,triumphant,3,5.509358563746952e-06,3,6.8342889947444315e-06,0,0
11369,#usmca,3,5.509358563746952e-06,3,6.8342889947444315e-06,0,0
11376,christianity,3,5.509358563746952e-06,3,6.8342889947444315e-06,0,0
11387,parental,3,5.509358563746952e-06,3,6.8342889947444315e-06,0,0
11388,repeals,3,5.509358563746952e-06,3,6.8342889947444315e-06,0,0
11403,@kamalaharris,3,5.509358563746952e-06,3,6.8342889947444315e-06,0,0
11410,#2020election,3,5.509358563746952e-06,3,6.8342889947444315e-06,0,0
11419,tracks,3,5.509358563746952e-06,3,6.8342889947444315e-06,0,0
11454,peddling,3,5.509358563746952e-06,3,6.8342889947444315e-06,0,0
11469,@att,3,5.509358563746952e-06,3,6.8342889947444315e-06,0,0
11494,kasich,3,5.509358563746952e-06,3,6.8342889947444315e-06,0,0
11502,polled,3,5.509358563746952e-06,3,6.8342889947444315e-06,0,0
11511,soft,3,5.509358563746952e-06,3,6.8342889947444315e-06,0,0
11528,allocated,3,5.509358563746952e-06,3,6.8342889947444315e-06,0,0
11539,informing,3,5.509358563746952e-06,3,6.8342889947444315e-06,0,0
11544,alarm,3,5.509358563746952e-06,3,6.8342889947444315e-06,0,0
11543,12000,3,5.509358563746952e-06,3,6.8342889947444315e-06,0,0
11556,loosen,3,5.509358563746952e-06,3,6.8342889947444315e-06,0,0
11568,affair,3,5.509358563746952e-06,3,6.8342889947444315e-06,0,0
11573,declined,3,5.509358563746952e-06,3,6.8342889947444315e-06,0,0
11579,artist,3,5.509358563746952e-06,3,6.8342889947444315e-06,0,0
11610,framed,3,5.509358563746952e-06,3,6.8342889947444315e-06,0,0
11636,obstacle,3,5.509358563746952e-06,3,6.8342889947444315e-06,0,0
11653,royal,3,5.509358563746952e-06,3,6.8342889947444315e-06,0,0
11677,resilient,3,5.509358563746952e-06,3,6.8342889947444315e-06,0,0
11684,jacobs,3,5.509358563746952e-06,3,6.8342889947444315e-06,0,0
11704,lynda,3,5.509358563746952e-06,3,6.8342889947444315e-06,0,0
11712,shady,3,5.509358563746952e-06,3,6.8342889947444315e-06,0,0
11715,traveling,3,5.509358563746952e-06,3,6.8342889947444315e-06,0,0
11707,747,3,5.509358563746952e-06,3,6.8342889947444315e-06,0,0
11729,statewide,3,5.509358563746952e-06,3,6.8342889947444315e-06,0,0
11741,affh,3,5.509358563746952e-06,3,6.8342889947444315e-06,0,0
11758,bucks,3,5.509358563746952e-06,3,6.8342889947444315e-06,0,0
11786,strict,3,5.509358563746952e-06,3,6.8342889947444315e-06,0,0
11795,plunge,3,5.509358563746952e-06,3,6.8342889947444315e-06,0,0
11802,@wef,3,5.509358563746952e-06,3,6.8342889947444315e-06,0,0
11818,footprint,3,5.509358563746952e-06,3,6.8342889947444315e-06,0,0
11822,fabulous,3,5.509358563746952e-06,3,6.8342889947444315e-06,0,0
11827,sin,3,5.509358563746952e-06,3,6.8342889947444315e-06,0,0
11829,boltons,3,5.509358563746952e-06,3,6.8342889947444315e-06,0,0
11830,exceedingly,3,5.509358563746952e-06,3,6.8342889947444315e-06,0,0
11841,smash,3,5.509358563746952e-06,3,6.8342889947444315e-06,0,0
11853,considerable,3,5.509358563746952e-06,3,6.8342889947444315e-06,0,0
11899,sara,3,5.509358563746952e-06,3,6.8342889947444315e-06,0,0
11900,blasts,3,5.509358563746952e-06,3,6.8342889947444315e-06,0,0
11905,faulty,3,5.509358563746952e-06,3,6.8342889947444315e-06,0,0
11912,debacle,3,5.509358563746952e-06,3,6.8342889947444315e-06,0,0
11928,jeb,3,5.509358563746952e-06,3,6.8342889947444315e-06,0,0
11935,trove,3,5.509358563746952e-06,3,6.8342889947444315e-06,0,0
11941,slander,3,5.509358563746952e-06,3,6.8342889947444315e-06,0,0
11946,teleprompter,3,5.509358563746952e-06,3,6.8342889947444315e-06,0,0
11947,hacks,3,5.509358563746952e-06,3,6.8342889947444315e-06,0,0
11951,bang,3,5.509358563746952e-06,3,6.8342889947444315e-06,0,0
11977,yellow,3,5.509358563746952e-06,3,6.8342889947444315e-06,0,0
11994,subversive,3,5.509358563746952e-06,3,6.8342889947444315e-06,0,0
12023,exit,3,5.509358563746952e-06,3,6.8342889947444315e-06,0,0
12018,81,3,5.509358563746952e-06,3,6.8342889947444315e-06,0,0
12038,much-needed,3,5.509358563746952e-06,3,6.8342889947444315e-06,0,0
12041,upgrades,3,5.509358563746952e-06,3,6.8342889947444315e-06,0,0
12102,courtesy,3,5.509358563746952e-06,3,6.8342889947444315e-06,0,0
12117,experiences,3,5.509358563746952e-06,3,6.8342889947444315e-06,0,0
12138,205,3,5.509358563746952e-06,3,6.8342889947444315e-06,0,0
12163,@heatherchilders,3,5.509358563746952e-06,3,6.8342889947444315e-06,0,0
12181,navajo,3,5.509358563746952e-06,3,6.8342889947444315e-06,0,0
12186,tele-conference,3,5.509358563746952e-06,3,6.8342889947444315e-06,0,0
12187,pretended,3,5.509358563746952e-06,3,6.8342889947444315e-06,0,0
12203,misrepresentations,3,5.509358563746952e-06,3,6.8342889947444315e-06,0,0
12207,hopeless,3,5.509358563746952e-06,3,6.8342889947444315e-06,0,0
12227,protective,3,5.509358563746952e-06,3,6.8342889947444315e-06,0,0
12232,showcase,3,5.509358563746952e-06,3,6.8342889947444315e-06,0,0
12235,zuckerberg,3,5.509358563746952e-06,3,6.8342889947444315e-06,0,0
12240,predicting,3,5.509358563746952e-06,3,6.8342889947444315e-06,0,0
12239,models,3,5.509358563746952e-06,3,6.8342889947444315e-06,0,0
12260,ppp,3,5.509358563746952e-06,3,6.8342889947444315e-06,0,0
12265,@nycpba,3,5.509358563746952e-06,3,6.8342889947444315e-06,0,0
12271,bogus,3,5.509358563746952e-06,3,6.8342889947444315e-06,0,0
12273,leverage,3,5.509358563746952e-06,3,6.8342889947444315e-06,0,0
12279,intensive,3,5.509358563746952e-06,3,6.8342889947444315e-06,0,0
12288,purely,3,5.509358563746952e-06,3,6.8342889947444315e-06,0,0
12296,foes,3,5.509358563746952e-06,3,6.8342889947444315e-06,0,0
12303,escape,3,5.509358563746952e-06,3,6.8342889947444315e-06,0,0
12318,conceded,3,5.509358563746952e-06,3,6.8342889947444315e-06,0,0
12322,endorsements,3,5.509358563746952e-06,3,6.8342889947444315e-06,0,0
12332,producers,3,5.509358563746952e-06,3,6.8342889947444315e-06,0,0
12359,slot,3,5.509358563746952e-06,3,6.8342889947444315e-06,0,0
12366,uncontrollable,3,5.509358563746952e-06,3,6.8342889947444315e-06,0,0
12367,patterson,3,5.509358563746952e-06,3,6.8342889947444315e-06,0,0
12373,proactive,3,5.509358563746952e-06,3,6.8342889947444315e-06,0,0
12382,sharper,3,5.509358563746952e-06,3,6.8342889947444315e-06,0,0
12413,@cbs,3,5.509358563746952e-06,3,6.8342889947444315e-06,0,0
12414,inflicted,3,5.509358563746952e-06,3,6.8342889947444315e-06,0,0
12422,cowboys,3,5.509358563746952e-06,3,6.8342889947444315e-06,0,0
12430,wet,3,5.509358563746952e-06,3,6.8342889947444315e-06,0,0
12442,@vandrewfornj,3,5.509358563746952e-06,3,6.8342889947444315e-06,0,0
12444,northeast,3,5.509358563746952e-06,3,6.8342889947444315e-06,0,0
12452,retaliation,3,5.509358563746952e-06,3,6.8342889947444315e-06,0,0
12501,mail-ins,3,5.509358563746952e-06,3,6.8342889947444315e-06,0,0
12506,oppressive,3,5.509358563746952e-06,3,6.8342889947444315e-06,0,0
12514,perpetuate,3,5.509358563746952e-06,3,6.8342889947444315e-06,0,0
12525,havoc,3,5.509358563746952e-06,3,6.8342889947444315e-06,0,0
12537,harshly,3,5.509358563746952e-06,3,6.8342889947444315e-06,0,0
12541,unambiguous,3,5.509358563746952e-06,3,6.8342889947444315e-06,0,0
12540,outed,3,5.509358563746952e-06,3,6.8342889947444315e-06,0,0
12538,affirmative,3,5.509358563746952e-06,3,6.8342889947444315e-06,0,0
12546,markwayne,3,5.509358563746952e-06,3,6.8342889947444315e-06,0,0
12587,contemplated,3,5.509358563746952e-06,3,6.8342889947444315e-06,0,0
12599,invoke,3,5.509358563746952e-06,3,6.8342889947444315e-06,0,0
12610,poisonous,3,5.509358563746952e-06,3,6.8342889947444315e-06,0,0
12632,#marchforlife,3,5.509358563746952e-06,3,6.8342889947444315e-06,0,0
12657,afternoons,3,5.509358563746952e-06,3,6.8342889947444315e-06,0,0
12661,nowadays,3,5.509358563746952e-06,3,6.8342889947444315e-06,0,0
12671,executing,3,5.509358563746952e-06,3,6.8342889947444315e-06,0,0
12676,issuing,3,5.509358563746952e-06,3,6.8342889947444315e-06,0,0
12684,vandalism,3,5.509358563746952e-06,3,6.8342889947444315e-06,0,0
12679,beware,3,5.509358563746952e-06,3,6.8342889947444315e-06,0,0
12686,payoff,3,5.509358563746952e-06,3,6.8342889947444315e-06,0,0
12698,tracing,3,5.509358563746952e-06,3,6.8342889947444315e-06,0,0
12711,tyler,3,5.509358563746952e-06,3,6.8342889947444315e-06,0,0
12715,monument,3,5.509358563746952e-06,3,6.8342889947444315e-06,0,0
12729,convict,3,5.509358563746952e-06,3,6.8342889947444315e-06,0,0
12757,denounce,3,5.509358563746952e-06,3,6.8342889947444315e-06,0,0
12759,kangaroo,3,5.509358563746952e-06,3,6.8342889947444315e-06,0,0
12763,ominous,3,5.509358563746952e-06,3,6.8342889947444315e-06,0,0
12773,rant,3,5.509358563746952e-06,3,6.8342889947444315e-06,0,0
12801,ruth,3,5.509358563746952e-06,3,6.8342889947444315e-06,0,0
12812,logan,3,5.509358563746952e-06,3,6.8342889947444315e-06,0,0
12815,douglas,3,5.509358563746952e-06,3,6.8342889947444315e-06,0,0
12829,rushmore,3,5.509358563746952e-06,3,6.8342889947444315e-06,0,0
12833,recieved,3,5.509358563746952e-06,3,6.8342889947444315e-06,0,0
12863,reynolds,3,5.509358563746952e-06,3,6.8342889947444315e-06,0,0
12864,harming,3,5.509358563746952e-06,3,6.8342889947444315e-06,0,0
12870,blagojevich,3,5.509358563746952e-06,3,6.8342889947444315e-06,0,0
12876,lefties,3,5.509358563746952e-06,3,6.8342889947444315e-06,0,0
12891,mn,3,5.509358563746952e-06,3,6.8342889947444315e-06,0,0
12902,maguire,3,5.509358563746952e-06,3,6.8342889947444315e-06,0,0
12904,nascar,3,5.509358563746952e-06,3,6.8342889947444315e-06,0,0
12915,chad,3,5.509358563746952e-06,3,6.8342889947444315e-06,0,0
12916,@elonmusk,3,5.509358563746952e-06,3,6.8342889947444315e-06,0,0
12933,hospitalized,3,5.509358563746952e-06,3,6.8342889947444315e-06,0,0
12946,decrease,3,5.509358563746952e-06,3,6.8342889947444315e-06,0,0
12959,crazier,3,5.509358563746952e-06,3,6.8342889947444315e-06,0,0
12983,mailed,3,5.509358563746952e-06,3,6.8342889947444315e-06,0,0
12985,indication,3,5.509358563746952e-06,3,6.8342889947444315e-06,0,0
12992,richardson,3,5.509358563746952e-06,3,6.8342889947444315e-06,0,0
12994,relevance,3,5.509358563746952e-06,3,6.8342889947444315e-06,0,0
12996,prosecute,3,5.509358563746952e-06,3,6.8342889947444315e-06,0,0
12998,negatively,3,5.509358563746952e-06,3,6.8342889947444315e-06,0,0
13010,lecturing,3,5.509358563746952e-06,3,6.8342889947444315e-06,0,0
13028,@tedcruz,3,5.509358563746952e-06,3,6.8342889947444315e-06,0,0
13029,enforcing,3,5.509358563746952e-06,3,6.8342889947444315e-06,0,0
13030,shaping,3,5.509358563746952e-06,3,6.8342889947444315e-06,0,0
13063,implemented,3,5.509358563746952e-06,3,6.8342889947444315e-06,0,0
13061,blackouts,3,5.509358563746952e-06,3,6.8342889947444315e-06,0,0
13066,safest,3,5.509358563746952e-06,3,6.8342889947444315e-06,0,0
13068,founder,3,5.509358563746952e-06,3,6.8342889947444315e-06,0,0
13083,richly,3,5.509358563746952e-06,3,6.8342889947444315e-06,0,0
13086,palestinians,3,5.509358563746952e-06,3,6.8342889947444315e-06,0,0
13090,klacik,3,5.509358563746952e-06,3,6.8342889947444315e-06,0,0
13095,rollins,3,5.509358563746952e-06,3,6.8342889947444315e-06,0,0
13097,cuomos,3,5.509358563746952e-06,3,6.8342889947444315e-06,0,0
13100,christ,3,5.509358563746952e-06,3,6.8342889947444315e-06,0,0
13107,handing,3,5.509358563746952e-06,3,6.8342889947444315e-06,0,0
13108,matches,3,5.509358563746952e-06,3,6.8342889947444315e-06,0,0
13121,metropolitan,3,5.509358563746952e-06,3,6.8342889947444315e-06,0,0
13128,jumped,3,5.509358563746952e-06,3,6.8342889947444315e-06,0,0
13146,playbook,3,5.509358563746952e-06,3,6.8342889947444315e-06,0,0
13160,hemisphere,3,5.509358563746952e-06,3,6.8342889947444315e-06,0,0
13172,farming,3,5.509358563746952e-06,3,6.8342889947444315e-06,0,0
13197,bedford,3,5.509358563746952e-06,3,6.8342889947444315e-06,0,0
13200,indirectly,3,5.509358563746952e-06,3,6.8342889947444315e-06,0,0
13204,mini-strokes,3,5.509358563746952e-06,3,6.8342889947444315e-06,0,0
13210,@yankees,3,5.509358563746952e-06,3,6.8342889947444315e-06,0,0
13216,anna,3,5.509358563746952e-06,3,6.8342889947444315e-06,0,0
13231,@senthomtillis,3,5.509358563746952e-06,3,6.8342889947444315e-06,0,0
13232,conman,3,5.509358563746952e-06,3,6.8342889947444315e-06,0,0
13260,imposing,3,5.509358563746952e-06,3,6.8342889947444315e-06,0,0
13282,formula,3,5.509358563746952e-06,3,6.8342889947444315e-06,0,0
13339,spews,3,5.509358563746952e-06,3,6.8342889947444315e-06,0,0
13338,creep,3,5.509358563746952e-06,3,6.8342889947444315e-06,0,0
13350,stockpile,3,5.509358563746952e-06,3,6.8342889947444315e-06,0,0
13351,@davidasmanfox,3,5.509358563746952e-06,3,6.8342889947444315e-06,0,0
13372,communication,3,5.509358563746952e-06,3,6.8342889947444315e-06,0,0
13390,@marthamcsally,3,5.509358563746952e-06,3,6.8342889947444315e-06,0,0
13398,injustice,3,5.509358563746952e-06,3,6.8342889947444315e-06,0,0
13407,hbcus,3,5.509358563746952e-06,3,6.8342889947444315e-06,0,0
13415,lier,3,5.509358563746952e-06,3,6.8342889947444315e-06,0,0
13417,@cpac,3,5.509358563746952e-06,3,6.8342889947444315e-06,0,0
13420,unpleasant,3,5.509358563746952e-06,3,6.8342889947444315e-06,0,0
13463,लिए,3,5.509358563746952e-06,3,6.8342889947444315e-06,0,0
13471,@gregformontana,3,5.509358563746952e-06,3,6.8342889947444315e-06,0,0
13482,का,3,5.509358563746952e-06,3,6.8342889947444315e-06,0,0
13475,अमेरिका,3,5.509358563746952e-06,3,6.8342889947444315e-06,0,0
13509,chaotic,3,5.509358563746952e-06,3,6.8342889947444315e-06,0,0
13572,hows,3,5.509358563746952e-06,3,6.8342889947444315e-06,0,0
13582,loading,3,5.509358563746952e-06,3,6.8342889947444315e-06,0,0
13583,acknowledged,3,5.509358563746952e-06,3,6.8342889947444315e-06,0,0
13587,disclosed,3,5.509358563746952e-06,3,6.8342889947444315e-06,0,0
13589,extent,3,5.509358563746952e-06,3,6.8342889947444315e-06,0,0
13586,desire,3,5.509358563746952e-06,3,6.8342889947444315e-06,0,0
13591,disagreed,3,5.509358563746952e-06,3,6.8342889947444315e-06,0,0
13597,flies,3,5.509358563746952e-06,3,6.8342889947444315e-06,0,0
13602,drum,3,5.509358563746952e-06,3,6.8342889947444315e-06,0,0
13646,salon,3,5.509358563746952e-06,3,6.8342889947444315e-06,0,0
13647,lawn,3,5.509358563746952e-06,3,6.8342889947444315e-06,0,0
13653,execute,3,5.509358563746952e-06,3,6.8342889947444315e-06,0,0
13678,liberalism,3,5.509358563746952e-06,3,6.8342889947444315e-06,0,0
13693,accuses,3,5.509358563746952e-06,3,6.8342889947444315e-06,0,0
13704,humiliating,3,5.509358563746952e-06,3,6.8342889947444315e-06,0,0
13713,amateur,3,5.509358563746952e-06,3,6.8342889947444315e-06,0,0
13728,motivated,3,5.509358563746952e-06,3,6.8342889947444315e-06,0,0
13754,shaped,3,5.509358563746952e-06,3,6.8342889947444315e-06,0,0
13771,phyllis,3,5.509358563746952e-06,3,6.8342889947444315e-06,0,0
13791,lester,3,5.509358563746952e-06,3,6.8342889947444315e-06,0,0
13818,247,3,5.509358563746952e-06,3,6.8342889947444315e-06,0,0
13826,panicking,3,5.509358563746952e-06,3,6.8342889947444315e-06,0,0
13834,compliment,3,5.509358563746952e-06,3,6.8342889947444315e-06,0,0
13843,@repleezeldin,3,5.509358563746952e-06,3,6.8342889947444315e-06,0,0
13850,sickness,3,5.509358563746952e-06,3,6.8342889947444315e-06,0,0
13867,recognizable,3,5.509358563746952e-06,3,6.8342889947444315e-06,0,0
13895,tunnels,3,5.509358563746952e-06,3,6.8342889947444315e-06,0,0
13899,evenings,3,5.509358563746952e-06,3,6.8342889947444315e-06,0,0
13920,blamed,3,5.509358563746952e-06,3,6.8342889947444315e-06,0,0
13923,droves,3,5.509358563746952e-06,3,6.8342889947444315e-06,0,0
13940,resume,3,5.509358563746952e-06,3,6.8342889947444315e-06,0,0
13948,whitmer,3,5.509358563746952e-06,3,6.8342889947444315e-06,0,0
13966,pilots,3,5.509358563746952e-06,3,6.8342889947444315e-06,0,0
13983,lightly,3,5.509358563746952e-06,3,6.8342889947444315e-06,0,0
13986,nda,3,5.509358563746952e-06,3,6.8342889947444315e-06,0,0
13993,effectively,3,5.509358563746952e-06,3,6.8342889947444315e-06,0,0
14009,excerpt--lewandowski,3,5.509358563746952e-06,3,6.8342889947444315e-06,0,0
14034,@cbsnews,3,5.509358563746952e-06,3,6.8342889947444315e-06,0,0
14046,lenin,3,5.509358563746952e-06,3,6.8342889947444315e-06,0,0
14047,moreno,3,5.509358563746952e-06,3,6.8342889947444315e-06,0,0
14060,slower,3,5.509358563746952e-06,3,6.8342889947444315e-06,0,0
14064,disarray,3,5.509358563746952e-06,3,6.8342889947444315e-06,0,0
14083,@abcnews,3,5.509358563746952e-06,3,6.8342889947444315e-06,0,0
14093,bureau,3,5.509358563746952e-06,3,6.8342889947444315e-06,0,0
14109,ali,3,5.509358563746952e-06,3,6.8342889947444315e-06,0,0
14113,needing,3,5.509358563746952e-06,3,6.8342889947444315e-06,0,0
14124,actively,3,5.509358563746952e-06,3,6.8342889947444315e-06,0,0
14135,angrily,3,5.509358563746952e-06,3,6.8342889947444315e-06,0,0
14158,pertains,3,5.509358563746952e-06,3,6.8342889947444315e-06,0,0
14174,curt,3,5.509358563746952e-06,3,6.8342889947444315e-06,0,0
14177,booed,3,5.509358563746952e-06,3,6.8342889947444315e-06,0,0
14183,vehicle,3,5.509358563746952e-06,3,6.8342889947444315e-06,0,0
14189,believer,3,5.509358563746952e-06,3,6.8342889947444315e-06,0,0
14193,survived,3,5.509358563746952e-06,3,6.8342889947444315e-06,0,0
14196,outstripping,3,5.509358563746952e-06,3,6.8342889947444315e-06,0,0
14199,reveals,3,5.509358563746952e-06,3,6.8342889947444315e-06,0,0
14200,@charleshurt,3,5.509358563746952e-06,3,6.8342889947444315e-06,0,0
14221,zoning,3,5.509358563746952e-06,3,6.8342889947444315e-06,0,0
14225,reinstating,3,5.509358563746952e-06,3,6.8342889947444315e-06,0,0
14231,older,3,5.509358563746952e-06,3,6.8342889947444315e-06,0,0
14235,regis,3,5.509358563746952e-06,3,6.8342889947444315e-06,0,0
14241,jupiter,3,5.509358563746952e-06,3,6.8342889947444315e-06,0,0
14244,declassification,3,5.509358563746952e-06,3,6.8342889947444315e-06,0,0
14245,pertaining,3,5.509358563746952e-06,3,6.8342889947444315e-06,0,0
14247,courses,3,5.509358563746952e-06,3,6.8342889947444315e-06,0,0
14263,@sarahhuckabee,3,5.509358563746952e-06,3,6.8342889947444315e-06,0,0
14275,reconciliation,3,5.509358563746952e-06,3,6.8342889947444315e-06,0,0
14281,unused,3,5.509358563746952e-06,3,6.8342889947444315e-06,0,0
14282,indicating,3,5.509358563746952e-06,3,6.8342889947444315e-06,0,0
14315,fading,3,5.509358563746952e-06,3,6.8342889947444315e-06,0,0
14322,cain,3,5.509358563746952e-06,3,6.8342889947444315e-06,0,0
14369,moderator,3,5.509358563746952e-06,3,6.8342889947444315e-06,0,0
14385,cathy,3,5.509358563746952e-06,3,6.8342889947444315e-06,0,0
14398,vicky,3,5.509358563746952e-06,3,6.8342889947444315e-06,0,0
14400,forgive,3,5.509358563746952e-06,3,6.8342889947444315e-06,0,0
14410,chase,3,5.509358563746952e-06,3,6.8342889947444315e-06,0,0
14415,unbreakable,3,5.509358563746952e-06,3,6.8342889947444315e-06,0,0
14413,senselessly,3,5.509358563746952e-06,3,6.8342889947444315e-06,0,0
14416,horse,3,5.509358563746952e-06,3,6.8342889947444315e-06,0,0
14435,financially,3,5.509358563746952e-06,3,6.8342889947444315e-06,0,0
14449,combination,3,5.509358563746952e-06,3,6.8342889947444315e-06,0,0
14457,@rushlimbaugheib,3,5.509358563746952e-06,3,6.8342889947444315e-06,0,0
14458,radio,3,5.509358563746952e-06,3,6.8342889947444315e-06,0,0
14460,@senatordole,3,5.509358563746952e-06,3,6.8342889947444315e-06,0,0
14467,appellate,3,5.509358563746952e-06,3,6.8342889947444315e-06,0,0
14473,foiled,3,5.509358563746952e-06,3,6.8342889947444315e-06,0,0
14484,petro,3,5.509358563746952e-06,3,6.8342889947444315e-06,0,0
14501,newswashington,3,5.509358563746952e-06,3,6.8342889947444315e-06,0,0
14503,oakland,3,5.509358563746952e-06,3,6.8342889947444315e-06,0,0
14527,mandated,3,5.509358563746952e-06,3,6.8342889947444315e-06,0,0
14536,indicator,3,5.509358563746952e-06,3,6.8342889947444315e-06,0,0
14541,concert,3,5.509358563746952e-06,3,6.8342889947444315e-06,0,0
14550,squandered,3,5.509358563746952e-06,3,6.8342889947444315e-06,0,0
14552,pro-growth,3,5.509358563746952e-06,3,6.8342889947444315e-06,0,0
14571,legs,3,5.509358563746952e-06,3,6.8342889947444315e-06,0,0
14568,fundraiser,3,5.509358563746952e-06,3,6.8342889947444315e-06,0,0
14567,forgiveness,3,5.509358563746952e-06,3,6.8342889947444315e-06,0,0
14576,@dcexaminer,3,5.509358563746952e-06,3,6.8342889947444315e-06,0,0
14588,5-0,3,5.509358563746952e-06,3,6.8342889947444315e-06,0,0
14600,cr,3,5.509358563746952e-06,3,6.8342889947444315e-06,0,0
14603,#taxcutsandjobsact,3,5.509358563746952e-06,3,6.8342889947444315e-06,0,0
14606,scalise,3,5.509358563746952e-06,3,6.8342889947444315e-06,0,0
14614,watches,3,5.509358563746952e-06,3,6.8342889947444315e-06,0,0
14625,design,3,5.509358563746952e-06,3,6.8342889947444315e-06,0,0
14632,lewandowski,3,5.509358563746952e-06,3,6.8342889947444315e-06,0,0
14637,@shopfloornam,3,5.509358563746952e-06,3,6.8342889947444315e-06,0,0
14638,outlook,3,5.509358563746952e-06,3,6.8342889947444315e-06,0,0
14668,separated,3,5.509358563746952e-06,3,6.8342889947444315e-06,0,0
14674,wapo,3,5.509358563746952e-06,3,6.8342889947444315e-06,0,0
14675,#armynavygame,3,5.509358563746952e-06,3,6.8342889947444315e-06,0,0
14691,fulfilled,3,5.509358563746952e-06,3,6.8342889947444315e-06,0,0
14705,directing,3,5.509358563746952e-06,3,6.8342889947444315e-06,0,0
14761,@theresamay,3,5.509358563746952e-06,3,6.8342889947444315e-06,0,0
14798,cowardly,3,5.509358563746952e-06,3,6.8342889947444315e-06,0,0
14806,erdogan,3,5.509358563746952e-06,3,6.8342889947444315e-06,0,0
14821,shoplifting,3,5.509358563746952e-06,3,6.8342889947444315e-06,0,0
14832,remainder,3,5.509358563746952e-06,3,6.8342889947444315e-06,0,0
14852,investigative,3,5.509358563746952e-06,3,6.8342889947444315e-06,0,0
14851,chemical,3,5.509358563746952e-06,3,6.8342889947444315e-06,0,0
14866,#makeamericagreatagain🇺🇸,3,5.509358563746952e-06,3,6.8342889947444315e-06,0,0
14898,sovereign,3,5.509358563746952e-06,3,6.8342889947444315e-06,0,0
14922,noko,3,5.509358563746952e-06,3,6.8342889947444315e-06,0,0
14926,peninsula,3,5.509358563746952e-06,3,6.8342889947444315e-06,0,0
14934,disposed,3,5.509358563746952e-06,3,6.8342889947444315e-06,0,0
14947,yield,3,5.509358563746952e-06,3,6.8342889947444315e-06,0,0
14991,grieving,3,5.509358563746952e-06,3,6.8342889947444315e-06,0,0
14996,import,3,5.509358563746952e-06,3,6.8342889947444315e-06,0,0
15018,jfk,3,5.509358563746952e-06,3,6.8342889947444315e-06,0,0
15022,#jfkfiles,3,5.509358563746952e-06,3,6.8342889947444315e-06,0,0
15032,diane,3,5.509358563746952e-06,3,6.8342889947444315e-06,0,0
15053,ovations,3,5.509358563746952e-06,3,6.8342889947444315e-06,0,0
15068,plead,3,5.509358563746952e-06,3,6.8342889947444315e-06,0,0
15077,@geraldorivera,3,5.509358563746952e-06,3,6.8342889947444315e-06,0,0
15102,violates,3,5.509358563746952e-06,3,6.8342889947444315e-06,0,0
15114,newspapers,3,5.509358563746952e-06,3,6.8342889947444315e-06,0,0
15121,fueled,3,5.509358563746952e-06,3,6.8342889947444315e-06,0,0
15126,laffer,3,5.509358563746952e-06,3,6.8342889947444315e-06,0,0
15130,southwest,3,5.509358563746952e-06,3,6.8342889947444315e-06,0,0
15145,encourages,3,5.509358563746952e-06,3,6.8342889947444315e-06,0,0
15151,clips,3,5.509358563746952e-06,3,6.8342889947444315e-06,0,0
15154,9pme,3,5.509358563746952e-06,3,6.8342889947444315e-06,0,0
15169,penguins,3,5.509358563746952e-06,3,6.8342889947444315e-06,0,0
15170,lessons,3,5.509358563746952e-06,3,6.8342889947444315e-06,0,0
15174,pen,3,5.509358563746952e-06,3,6.8342889947444315e-06,0,0
15181,cutsreform,3,5.509358563746952e-06,3,6.8342889947444315e-06,0,0
15188,negotiators,3,5.509358563746952e-06,3,6.8342889947444315e-06,0,0
15189,8pme,3,5.509358563746952e-06,3,6.8342889947444315e-06,0,0
15202,#prstrong🇵🇷,3,5.509358563746952e-06,3,6.8342889947444315e-06,0,0
15205,mapp,3,5.509358563746952e-06,3,6.8342889947444315e-06,0,0
15220,virgin,3,5.509358563746952e-06,3,6.8342889947444315e-06,0,0
15218,#fema,3,5.509358563746952e-06,3,6.8342889947444315e-06,0,0
15221,ricardo,3,5.509358563746952e-06,3,6.8342889947444315e-06,0,0
15234,#teamscalise,3,5.509358563746952e-06,3,6.8342889947444315e-06,0,0
15241,hcare,3,5.509358563746952e-06,3,6.8342889947444315e-06,0,0
15265,#hurricaneflorence,3,5.509358563746952e-06,3,6.8342889947444315e-06,0,0
15279,leagues,3,5.509358563746952e-06,3,6.8342889947444315e-06,0,0
15285,#usaatunga🇺🇸,3,5.509358563746952e-06,3,6.8342889947444315e-06,0,0
15298,graham-cassidy,3,5.509358563746952e-06,3,6.8342889947444315e-06,0,0
15300,abbas,3,5.509358563746952e-06,3,6.8342889947444315e-06,0,0
15306,nukes,3,5.509358563746952e-06,3,6.8342889947444315e-06,0,0
15342,feelings,3,5.509358563746952e-06,3,6.8342889947444315e-06,0,0
15345,blames,3,5.509358563746952e-06,3,6.8342889947444315e-06,0,0
15364,reimbursement,3,5.509358563746952e-06,3,6.8342889947444315e-06,0,0
15369,proportion,3,5.509358563746952e-06,3,6.8342889947444315e-06,0,0
15373,extremism,3,5.509358563746952e-06,3,6.8342889947444315e-06,0,0
15377,amir,3,5.509358563746952e-06,3,6.8342889947444315e-06,0,0
15420,#harvey,3,5.509358563746952e-06,3,6.8342889947444315e-06,0,0
15423,renegotiation,3,5.509358563746952e-06,3,6.8342889947444315e-06,0,0
15443,☑️,3,5.509358563746952e-06,3,6.8342889947444315e-06,0,0
15446,dynamic,3,5.509358563746952e-06,3,6.8342889947444315e-06,0,0
15447,tones,3,5.509358563746952e-06,3,6.8342889947444315e-06,0,0
15448,somber,3,5.509358563746952e-06,3,6.8342889947444315e-06,0,0
15459,customs,3,5.509358563746952e-06,3,6.8342889947444315e-06,0,0
15481,condemns,3,5.509358563746952e-06,3,6.8342889947444315e-06,0,0
15517,@ivankatrump,3,5.509358563746952e-06,3,6.8342889947444315e-06,0,0
15527,unfunded,3,5.509358563746952e-06,3,6.8342889947444315e-06,0,0
15532,deregulation,3,5.509358563746952e-06,3,6.8342889947444315e-06,0,0
15549,mazda,3,5.509358563746952e-06,3,6.8342889947444315e-06,0,0
15567,switch,3,5.509358563746952e-06,3,6.8342889947444315e-06,0,0
15574,alexandria,3,5.509358563746952e-06,3,6.8342889947444315e-06,0,0
15576,ridding,3,5.509358563746952e-06,3,6.8342889947444315e-06,0,0
15597,protectionist,3,5.509358563746952e-06,3,6.8342889947444315e-06,0,0
15613,@secretaryzinke,3,5.509358563746952e-06,3,6.8342889947444315e-06,0,0
15660,abcwashington,3,5.509358563746952e-06,3,6.8342889947444315e-06,0,0
15703,blessing,3,5.509358563746952e-06,3,6.8342889947444315e-06,0,0
15704,triumph,3,5.509358563746952e-06,3,6.8342889947444315e-06,0,0
15718,middle-east,3,5.509358563746952e-06,3,6.8342889947444315e-06,0,0
15760,boat,3,5.509358563746952e-06,3,6.8342889947444315e-06,0,0
15772,dhs,3,5.509358563746952e-06,3,6.8342889947444315e-06,0,0
15780,handel,3,5.509358563746952e-06,3,6.8342889947444315e-06,0,0
15828,ty,3,5.509358563746952e-06,3,6.8342889947444315e-06,0,0
15833,impeccable,3,5.509358563746952e-06,3,6.8342889947444315e-06,0,0
15840,qatar,3,5.509358563746952e-06,3,6.8342889947444315e-06,0,0
15857,lame,3,5.509358563746952e-06,3,6.8342889947444315e-06,0,0
15859,#memorialday🇺🇸,3,5.509358563746952e-06,3,6.8342889947444315e-06,0,0
15861,british,3,5.509358563746952e-06,3,6.8342889947444315e-06,0,0
15873,sergio,3,5.509358563746952e-06,3,6.8342889947444315e-06,0,0
15878,#potusabroad,3,5.509358563746952e-06,3,6.8342889947444315e-06,0,0
15881,belgium,3,5.509358563746952e-06,3,6.8342889947444315e-06,0,0
15905,#peaceofficersmemorialday,3,5.509358563746952e-06,3,6.8342889947444315e-06,0,0
15925,dir,3,5.509358563746952e-06,3,6.8342889947444315e-06,0,0
15930,prestige,3,5.509358563746952e-06,3,6.8342889947444315e-06,0,0
15948,@turnbullmalcolm,3,5.509358563746952e-06,3,6.8342889947444315e-06,0,0
15947,75th,3,5.509358563746952e-06,3,6.8342889947444315e-06,0,0
15972,vacations,3,5.509358563746952e-06,3,6.8342889947444315e-06,0,0
15977,eo,3,5.509358563746952e-06,3,6.8342889947444315e-06,0,0
15989,@nasas,3,5.509358563746952e-06,3,6.8342889947444315e-06,0,0
15994,forests,3,5.509358563746952e-06,3,6.8342889947444315e-06,0,0
15995,lakes,3,5.509358563746952e-06,3,6.8342889947444315e-06,0,0
16002,regulatory,3,5.509358563746952e-06,3,6.8342889947444315e-06,0,0
16010,hollywood,3,5.509358563746952e-06,3,6.8342889947444315e-06,0,0
16011,eleven,3,5.509358563746952e-06,3,6.8342889947444315e-06,0,0
16037,@wwp,3,5.509358563746952e-06,3,6.8342889947444315e-06,0,0
16054,#repealandreplace,3,5.509358563746952e-06,3,6.8342889947444315e-06,0,0
16067,smiling,3,5.509358563746952e-06,3,6.8342889947444315e-06,0,0
16083,german,3,5.509358563746952e-06,3,6.8342889947444315e-06,0,0
16103,@repcummings,3,5.509358563746952e-06,3,6.8342889947444315e-06,0,0
16106,infighting,3,5.509358563746952e-06,3,6.8342889947444315e-06,0,0
16115,schwarzenegger,3,5.509358563746952e-06,3,6.8342889947444315e-06,0,0
16120,mccarthyism,3,5.509358563746952e-06,3,6.8342889947444315e-06,0,0
16149,306,3,5.509358563746952e-06,3,6.8342889947444315e-06,0,0
16159,benjamin,3,5.509358563746952e-06,3,6.8342889947444315e-06,0,0
16176,canadian,3,5.509358563746952e-06,3,6.8342889947444315e-06,0,0
16182,@thebigeasy,3,5.509358563746952e-06,3,6.8342889947444315e-06,0,0
16184,ernie,3,5.509358563746952e-06,3,6.8342889947444315e-06,0,0
16245,executed,3,5.509358563746952e-06,3,6.8342889947444315e-06,0,0
16248,dwindling,3,5.509358563746952e-06,3,6.8342889947444315e-06,0,0
16279,president-elect,3,5.509358563746952e-06,3,6.8342889947444315e-06,0,0
16281,lockheed,3,5.509358563746952e-06,3,6.8342889947444315e-06,0,0
16287,bikers,3,5.509358563746952e-06,3,6.8342889947444315e-06,0,0
16331,longtime,3,5.509358563746952e-06,3,6.8342889947444315e-06,0,0
16332,jane,3,5.509358563746952e-06,3,6.8342889947444315e-06,0,0
16337,@erictrump,3,5.509358563746952e-06,3,6.8342889947444315e-06,0,0
16350,julian,3,5.509358563746952e-06,3,6.8342889947444315e-06,0,0
16349,assange,3,5.509358563746952e-06,3,6.8342889947444315e-06,0,0
16376,immoral,3,5.509358563746952e-06,3,6.8342889947444315e-06,0,0
16378,2006,3,5.509358563746952e-06,3,6.8342889947444315e-06,0,0
16389,strictly,3,5.509358563746952e-06,3,6.8342889947444315e-06,0,0
16395,actors,3,5.509358563746952e-06,3,6.8342889947444315e-06,0,0
16404,renovating,3,5.509358563746952e-06,3,6.8342889947444315e-06,0,0
16426,shanahan,3,5.509358563746952e-06,3,6.8342889947444315e-06,0,0
16432,27th,3,5.509358563746952e-06,3,6.8342889947444315e-06,0,0
16440,bi-partisan,3,5.509358563746952e-06,3,6.8342889947444315e-06,0,0
16446,217-185,3,5.509358563746952e-06,3,6.8342889947444315e-06,0,0
16450,retiring,3,5.509358563746952e-06,3,6.8342889947444315e-06,0,0
16461,charities,3,5.509358563746952e-06,3,6.8342889947444315e-06,0,0
16479,henninger,3,5.509358563746952e-06,3,6.8342889947444315e-06,0,0
16481,flynns,3,5.509358563746952e-06,3,6.8342889947444315e-06,0,0
16487,smugglers,3,5.509358563746952e-06,3,6.8342889947444315e-06,0,0
16493,rat,3,5.509358563746952e-06,3,6.8342889947444315e-06,0,0
16524,wrongly,3,5.509358563746952e-06,3,6.8342889947444315e-06,0,0
16529,recall,3,5.509358563746952e-06,3,6.8342889947444315e-06,0,0
16548,nikki,3,5.509358563746952e-06,3,6.8342889947444315e-06,0,0
16570,flows,3,5.509358563746952e-06,3,6.8342889947444315e-06,0,0
16605,defying,3,5.509358563746952e-06,3,6.8342889947444315e-06,0,0
16635,kinds,3,5.509358563746952e-06,3,6.8342889947444315e-06,0,0
16641,separation,3,5.509358563746952e-06,3,6.8342889947444315e-06,0,0
16649,hanson,3,5.509358563746952e-06,3,6.8342889947444315e-06,0,0
16660,jams,3,5.509358563746952e-06,3,6.8342889947444315e-06,0,0
16677,footage,3,5.509358563746952e-06,3,6.8342889947444315e-06,0,0
16692,fearful,3,5.509358563746952e-06,3,6.8342889947444315e-06,0,0
16702,steelworkers,3,5.509358563746952e-06,3,6.8342889947444315e-06,0,0
16737,243rd,3,5.509358563746952e-06,3,6.8342889947444315e-06,0,0
16744,subsidizes,3,5.509358563746952e-06,3,6.8342889947444315e-06,0,0
16751,1130,3,5.509358563746952e-06,3,6.8342889947444315e-06,0,0
16763,girardeau,3,5.509358563746952e-06,3,6.8342889947444315e-06,0,0
16764,mccaskill,3,5.509358563746952e-06,3,6.8342889947444315e-06,0,0
16773,requesting,3,5.509358563746952e-06,3,6.8342889947444315e-06,0,0
16788,@dannytarkanian,3,5.509358563746952e-06,3,6.8342889947444315e-06,0,0
16804,braun,3,5.509358563746952e-06,3,6.8342889947444315e-06,0,0
16826,warmly,3,5.509358563746952e-06,3,6.8342889947444315e-06,0,0
16833,@jason2cd,3,5.509358563746952e-06,3,6.8342889947444315e-06,0,0
16843,bolsonaro,3,5.509358563746952e-06,3,6.8342889947444315e-06,0,0
16880,unfortunate,3,5.509358563746952e-06,3,6.8342889947444315e-06,0,0
16893,@giuseppeconteit,3,5.509358563746952e-06,3,6.8342889947444315e-06,0,0
16896,turnaround,3,5.509358563746952e-06,3,6.8342889947444315e-06,0,0
16904,sooooo,3,5.509358563746952e-06,3,6.8342889947444315e-06,0,0
16941,needless,3,5.509358563746952e-06,3,6.8342889947444315e-06,0,0
16948,capitalize,3,5.509358563746952e-06,3,6.8342889947444315e-06,0,0
16966,thiessen,3,5.509358563746952e-06,3,6.8342889947444315e-06,0,0
16975,forthcoming,3,5.509358563746952e-06,3,6.8342889947444315e-06,0,0
16996,screens,3,5.509358563746952e-06,3,6.8342889947444315e-06,0,0
17050,wedding,3,5.509358563746952e-06,3,6.8342889947444315e-06,0,0
17052,1969,3,5.509358563746952e-06,3,6.8342889947444315e-06,0,0
17073,median,3,5.509358563746952e-06,3,6.8342889947444315e-06,0,0
17072,african-americans,3,5.509358563746952e-06,3,6.8342889947444315e-06,0,0
17079,zeldin,3,5.509358563746952e-06,3,6.8342889947444315e-06,0,0
17089,rouhani,3,5.509358563746952e-06,3,6.8342889947444315e-06,0,0
17093,@alsisiofficial,3,5.509358563746952e-06,3,6.8342889947444315e-06,0,0
17107,identified,3,5.509358563746952e-06,3,6.8342889947444315e-06,0,0
17124,ranting,3,5.509358563746952e-06,3,6.8342889947444315e-06,0,0
17132,redacted,3,5.509358563746952e-06,3,6.8342889947444315e-06,0,0
17137,morici,3,5.509358563746952e-06,3,6.8342889947444315e-06,0,0
17141,governmental,3,5.509358563746952e-06,3,6.8342889947444315e-06,0,0
17154,@edrollins,3,5.509358563746952e-06,3,6.8342889947444315e-06,0,0
17171,convictions,3,5.509358563746952e-06,3,6.8342889947444315e-06,0,0
17176,#september11th,3,5.509358563746952e-06,3,6.8342889947444315e-06,0,0
17179,strzok-page,3,5.509358563746952e-06,3,6.8342889947444315e-06,0,0
17198,disproven,3,5.509358563746952e-06,3,6.8342889947444315e-06,0,0
17200,minus,3,5.509358563746952e-06,3,6.8342889947444315e-06,0,0
17224,felons,3,5.509358563746952e-06,3,6.8342889947444315e-06,0,0
17231,forecasts,3,5.509358563746952e-06,3,6.8342889947444315e-06,0,0
17243,retribution,3,5.509358563746952e-06,3,6.8342889947444315e-06,0,0
17244,someones,3,5.509358563746952e-06,3,6.8342889947444315e-06,0,0
17250,appear,3,5.509358563746952e-06,3,6.8342889947444315e-06,0,0
17268,mid-terms,3,5.509358563746952e-06,3,6.8342889947444315e-06,0,0
17271,trumka,3,5.509358563746952e-06,3,6.8342889947444315e-06,0,0
17270,afl-cio,3,5.509358563746952e-06,3,6.8342889947444315e-06,0,0
17281,connected,3,5.509358563746952e-06,3,6.8342889947444315e-06,0,0
17283,conclude,3,5.509358563746952e-06,3,6.8342889947444315e-06,0,0
17300,wildest,3,5.509358563746952e-06,3,6.8342889947444315e-06,0,0
17309,lanny,3,5.509358563746952e-06,3,6.8342889947444315e-06,0,0
17313,exercises,3,5.509358563746952e-06,3,6.8342889947444315e-06,0,0
17312,disputes,3,5.509358563746952e-06,3,6.8342889947444315e-06,0,0
17327,tearing,3,5.509358563746952e-06,3,6.8342889947444315e-06,0,0
17329,controlling,3,5.509358563746952e-06,3,6.8342889947444315e-06,0,0
17349,vince,3,5.509358563746952e-06,3,6.8342889947444315e-06,0,0
17353,morrison,3,5.509358563746952e-06,3,6.8342889947444315e-06,0,0
17354,#hurricanelane,3,5.509358563746952e-06,3,6.8342889947444315e-06,0,0
17356,censorship,3,5.509358563746952e-06,3,6.8342889947444315e-06,0,0
17383,brennans,3,5.509358563746952e-06,3,6.8342889947444315e-06,0,0
17393,multi-million,3,5.509358563746952e-06,3,6.8342889947444315e-06,0,0
17417,pushback,3,5.509358563746952e-06,3,6.8342889947444315e-06,0,0
17424,farrell,3,5.509358563746952e-06,3,6.8342889947444315e-06,0,0
17438,skinny,3,5.509358563746952e-06,3,6.8342889947444315e-06,0,0
17464,non-disclosure,3,5.509358563746952e-06,3,6.8342889947444315e-06,0,0
17494,diverted,3,5.509358563746952e-06,3,6.8342889947444315e-06,0,0
17507,renegotiated,3,5.509358563746952e-06,3,6.8342889947444315e-06,0,0
17518,stamps,3,5.509358563746952e-06,3,6.8342889947444315e-06,0,0
17547,jeanine,3,5.509358563746952e-06,3,6.8342889947444315e-06,0,0
17568,granite,3,5.509358563746952e-06,3,6.8342889947444315e-06,0,0
17573,lng,3,5.509358563746952e-06,3,6.8342889947444315e-06,0,0
17585,heels,3,5.509358563746952e-06,3,6.8342889947444315e-06,0,0
17592,@vfwhq,3,5.509358563746952e-06,3,6.8342889947444315e-06,0,0
17591,#vfwconvention,3,5.509358563746952e-06,3,6.8342889947444315e-06,0,0
17610,damaging,3,5.509358563746952e-06,3,6.8342889947444315e-06,0,0
17611,inconceivable,3,5.509358563746952e-06,3,6.8342889947444315e-06,0,0
17625,boxing,3,5.509358563746952e-06,3,6.8342889947444315e-06,0,0
17627,#helsinki2018,3,5.509358563746952e-06,3,6.8342889947444315e-06,0,0
17649,thailand,3,5.509358563746952e-06,3,6.8342889947444315e-06,0,0
17664,fraudster,3,5.509358563746952e-06,3,6.8342889947444315e-06,0,0
17666,savage,3,5.509358563746952e-06,3,6.8342889947444315e-06,0,0
17667,smears,3,5.509358563746952e-06,3,6.8342889947444315e-06,0,0
17668,pruitt,3,5.509358563746952e-06,3,6.8342889947444315e-06,0,0
17687,flee,3,5.509358563746952e-06,3,6.8342889947444315e-06,0,0
17692,goodlatte,3,5.509358563746952e-06,3,6.8342889947444315e-06,0,0
17698,gazette,3,5.509358563746952e-06,3,6.8342889947444315e-06,0,0
17709,selfless,3,5.509358563746952e-06,3,6.8342889947444315e-06,0,0
17724,donovan,3,5.509358563746952e-06,3,6.8342889947444315e-06,0,0
17763,arrington,3,5.509358563746952e-06,3,6.8342889947444315e-06,0,0
17767,wrapped,3,5.509358563746952e-06,3,6.8342889947444315e-06,0,0
17806,gowdy,3,5.509358563746952e-06,3,6.8342889947444315e-06,0,0
17812,justified,3,5.509358563746952e-06,3,6.8342889947444315e-06,0,0
17816,minions,3,5.509358563746952e-06,3,6.8342889947444315e-06,0,0
17845,engagement,3,5.509358563746952e-06,3,6.8342889947444315e-06,0,0
17869,practiced,3,5.509358563746952e-06,3,6.8342889947444315e-06,0,0
17883,operate,3,5.509358563746952e-06,3,6.8342889947444315e-06,0,0
17911,sport,3,5.509358563746952e-06,3,6.8342889947444315e-06,0,0
17929,restrictive,3,5.509358563746952e-06,3,6.8342889947444315e-06,0,0
17930,830,3,5.509358563746952e-06,3,6.8342889947444315e-06,0,0
17945,#righttotry,3,5.509358563746952e-06,3,6.8342889947444315e-06,0,0
17947,roseanne,3,5.509358563746952e-06,3,6.8342889947444315e-06,0,0
17954,mid-term,3,5.509358563746952e-06,3,6.8342889947444315e-06,0,0
17976,turley,3,5.509358563746952e-06,3,6.8342889947444315e-06,0,0
18023,asa,3,5.509358563746952e-06,3,6.8342889947444315e-06,0,0
18026,detailed,3,5.509358563746952e-06,3,6.8342889947444315e-06,0,0
18034,composed,3,5.509358563746952e-06,3,6.8342889947444315e-06,0,0
18054,typically,3,5.509358563746952e-06,3,6.8342889947444315e-06,0,0
18081,impacts,3,5.509358563746952e-06,3,6.8342889947444315e-06,0,0
18105,avail,3,5.509358563746952e-06,3,6.8342889947444315e-06,0,0
18122,bonkers,3,5.509358563746952e-06,3,6.8342889947444315e-06,0,0
18124,migrant,3,5.509358563746952e-06,3,6.8342889947444315e-06,0,0
18176,142,3,5.509358563746952e-06,3,6.8342889947444315e-06,0,0
18189,@jpnpmo,3,5.509358563746952e-06,3,6.8342889947444315e-06,0,0
18212,cooperative,3,5.509358563746952e-06,3,6.8342889947444315e-06,0,0
18229,tide,3,5.509358563746952e-06,3,6.8342889947444315e-06,0,0
18231,enlightenment,3,5.509358563746952e-06,3,6.8342889947444315e-06,0,0
18234,crossed,3,5.509358563746952e-06,3,6.8342889947444315e-06,0,0
18248,ip,3,5.509358563746952e-06,3,6.8342889947444315e-06,0,0
18266,fakers,3,5.509358563746952e-06,3,6.8342889947444315e-06,0,0
18285,interim,3,5.509358563746952e-06,3,6.8342889947444315e-06,0,0
18287,affairs,3,5.509358563746952e-06,3,6.8342889947444315e-06,0,0
18368,#america,3,5.509358563746952e-06,3,6.8342889947444315e-06,0,0
18415,bonus,3,5.509358563746952e-06,3,6.8342889947444315e-06,0,0
18424,sicko,3,5.509358563746952e-06,3,6.8342889947444315e-06,0,0
18460,rob,3,5.509358563746952e-06,3,6.8342889947444315e-06,0,0
18461,allegation,3,5.509358563746952e-06,3,6.8342889947444315e-06,0,0
18462,indictment,3,5.509358563746952e-06,3,6.8342889947444315e-06,0,0
18473,disturbed,3,5.509358563746952e-06,3,6.8342889947444315e-06,0,0
18499,proclaim,3,5.509358563746952e-06,3,6.8342889947444315e-06,0,0
18516,cows,3,5.509358563746952e-06,3,6.8342889947444315e-06,0,0
18556,non-citizens,3,5.509358563746952e-06,3,6.8342889947444315e-06,0,0
18633,constitutionally,3,5.509358563746952e-06,3,6.8342889947444315e-06,0,0
18636,speakership,3,5.509358563746952e-06,3,6.8342889947444315e-06,0,0
18655,suicide,3,5.509358563746952e-06,3,6.8342889947444315e-06,0,0
18662,confronted,3,5.509358563746952e-06,3,6.8342889947444315e-06,0,0
18664,presidencies,3,5.509358563746952e-06,3,6.8342889947444315e-06,0,0
18665,revived,3,5.509358563746952e-06,3,6.8342889947444315e-06,0,0
18668,outrages,3,5.509358563746952e-06,3,6.8342889947444315e-06,0,0
18673,wreck,3,5.509358563746952e-06,3,6.8342889947444315e-06,0,0
18684,itand,3,5.509358563746952e-06,3,6.8342889947444315e-06,0,0
18686,constituents,3,5.509358563746952e-06,3,6.8342889947444315e-06,0,0
18692,structural,3,5.509358563746952e-06,3,6.8342889947444315e-06,0,0
18694,chill,3,5.509358563746952e-06,3,6.8342889947444315e-06,0,0
18717,quitting,3,5.509358563746952e-06,3,6.8342889947444315e-06,0,0
18746,alliance,3,5.509358563746952e-06,3,6.8342889947444315e-06,0,0
18758,replaces,3,5.509358563746952e-06,3,6.8342889947444315e-06,0,0
18762,backfire,3,5.509358563746952e-06,3,6.8342889947444315e-06,0,0
18783,plainly,3,5.509358563746952e-06,3,6.8342889947444315e-06,0,0
18797,sondlands,3,5.509358563746952e-06,3,6.8342889947444315e-06,0,0
18804,@shannonbream,3,5.509358563746952e-06,3,6.8342889947444315e-06,0,0
18812,tons,3,5.509358563746952e-06,3,6.8342889947444315e-06,0,0
18813,bribe,3,5.509358563746952e-06,3,6.8342889947444315e-06,0,0
18825,proceeding,3,5.509358563746952e-06,3,6.8342889947444315e-06,0,0
18857,reverse,3,5.509358563746952e-06,3,6.8342889947444315e-06,0,0
18860,farce,3,5.509358563746952e-06,3,6.8342889947444315e-06,0,0
18867,uncovered,3,5.509358563746952e-06,3,6.8342889947444315e-06,0,0
18868,enriching,3,5.509358563746952e-06,3,6.8342889947444315e-06,0,0
18886,checkers,3,5.509358563746952e-06,3,6.8342889947444315e-06,0,0
18929,manipulated,3,5.509358563746952e-06,3,6.8342889947444315e-06,0,0
18931,shiftys,3,5.509358563746952e-06,3,6.8342889947444315e-06,0,0
18947,louisianas,3,5.509358563746952e-06,3,6.8342889947444315e-06,0,0
19063,dressed,3,5.509358563746952e-06,3,6.8342889947444315e-06,0,0
19117,transcribed,3,5.509358563746952e-06,3,6.8342889947444315e-06,0,0
19150,quantities,3,5.509358563746952e-06,3,6.8342889947444315e-06,0,0
19156,@bensasse,3,5.509358563746952e-06,3,6.8342889947444315e-06,0,0
19199,fragile,3,5.509358563746952e-06,3,6.8342889947444315e-06,0,0
19222,devalued,3,5.509358563746952e-06,3,6.8342889947444315e-06,0,0
19241,pompous,3,5.509358563746952e-06,3,6.8342889947444315e-06,0,0
19258,waiver,3,5.509358563746952e-06,3,6.8342889947444315e-06,0,0
19268,snakes,3,5.509358563746952e-06,3,6.8342889947444315e-06,0,0
19271,controversy,3,5.509358563746952e-06,3,6.8342889947444315e-06,0,0
19380,@billdeblasio,3,5.509358563746952e-06,3,6.8342889947444315e-06,0,0
19400,@marianorivera,3,5.509358563746952e-06,3,6.8342889947444315e-06,0,0
19407,monetary,3,5.509358563746952e-06,3,6.8342889947444315e-06,0,0
19412,remake,3,5.509358563746952e-06,3,6.8342889947444315e-06,0,0
19427,israeli,3,5.509358563746952e-06,3,6.8342889947444315e-06,0,0
19429,comcastnbc,3,5.509358563746952e-06,3,6.8342889947444315e-06,0,0
19454,studio,3,5.509358563746952e-06,3,6.8342889947444315e-06,0,0
19459,naming,3,5.509358563746952e-06,3,6.8342889947444315e-06,0,0
19469,stooges,3,5.509358563746952e-06,3,6.8342889947444315e-06,0,0
19472,appalachian,3,5.509358563746952e-06,3,6.8342889947444315e-06,0,0
19499,grazed,3,5.509358563746952e-06,3,6.8342889947444315e-06,0,0
19539,e-15,3,5.509358563746952e-06,3,6.8342889947444315e-06,0,0
19540,refineries,3,5.509358563746952e-06,3,6.8342889947444315e-06,0,0
19607,bedbugs,3,5.509358563746952e-06,3,6.8342889947444315e-06,0,0
19608,stephens,3,5.509358563746952e-06,3,6.8342889947444315e-06,0,0
19613,conte,3,5.509358563746952e-06,3,6.8342889947444315e-06,0,0
19616,#g7biarritz,3,5.509358563746952e-06,3,6.8342889947444315e-06,0,0
19632,partially,3,5.509358563746952e-06,3,6.8342889947444315e-06,0,0
19678,tensions,3,5.509358563746952e-06,3,6.8342889947444315e-06,0,0
19681,divorced,3,5.509358563746952e-06,3,6.8342889947444315e-06,0,0
19709,grandmother,3,5.509358563746952e-06,3,6.8342889947444315e-06,0,0
19750,donny,3,5.509358563746952e-06,3,6.8342889947444315e-06,0,0
19773,purporting,3,5.509358563746952e-06,3,6.8342889947444315e-06,0,0
19778,joaquin,3,5.509358563746952e-06,3,6.8342889947444315e-06,0,0
19779,juaquin,3,5.509358563746952e-06,3,6.8342889947444315e-06,0,0
19780,shepard,3,5.509358563746952e-06,3,6.8342889947444315e-06,0,0
19793,subvert,3,5.509358563746952e-06,3,6.8342889947444315e-06,0,0
19794,@sundarpichai,3,5.509358563746952e-06,3,6.8342889947444315e-06,0,0
19798,contributed,3,5.509358563746952e-06,3,6.8342889947444315e-06,0,0
19874,reimbursed,3,5.509358563746952e-06,3,6.8342889947444315e-06,0,0
19953,@usminority,3,5.509358563746952e-06,3,6.8342889947444315e-06,0,0
19965,visible,3,5.509358563746952e-06,3,6.8342889947444315e-06,0,0
20006,devalue,3,5.509358563746952e-06,3,6.8342889947444315e-06,0,0
20010,@mitchellvii,3,5.509358563746952e-06,3,6.8342889947444315e-06,0,0
20014,#socialmediasummit,3,5.509358563746952e-06,3,6.8342889947444315e-06,0,0
20046,coatesville,3,5.509358563746952e-06,3,6.8342889947444315e-06,0,0
20076,#salutetoamerica🇺🇸,3,5.509358563746952e-06,3,6.8342889947444315e-06,0,0
20081,culminating,3,5.509358563746952e-06,3,6.8342889947444315e-06,0,0
20082,flyovers,3,5.509358563746952e-06,3,6.8342889947444315e-06,0,0
20094,ph,3,5.509358563746952e-06,3,6.8342889947444315e-06,0,0
20105,bestselling,3,5.509358563746952e-06,3,6.8342889947444315e-06,0,0
20107,unfreedom,3,5.509358563746952e-06,3,6.8342889947444315e-06,0,0
20116,@wallstreetjour,3,5.509358563746952e-06,3,6.8342889947444315e-06,0,0
20120,huawei,3,5.509358563746952e-06,3,6.8342889947444315e-06,0,0
20136,mario,3,5.509358563746952e-06,3,6.8342889947444315e-06,0,0
20277,rivlin,3,5.509358563746952e-06,3,6.8342889947444315e-06,0,0
20327,emperor,3,5.509358563746952e-06,3,6.8342889947444315e-06,0,0
20352,majesty,3,5.509358563746952e-06,3,6.8342889947444315e-06,0,0
20475,tables,3,5.509358563746952e-06,3,6.8342889947444315e-06,0,0
20560,poway,3,5.509358563746952e-06,3,6.8342889947444315e-06,0,0
20625,@themasters,3,5.509358563746952e-06,3,6.8342889947444315e-06,0,0
20671,@rjc,3,5.509358563746952e-06,3,6.8342889947444315e-06,0,0
20679,smuggled,3,5.509358563746952e-06,3,6.8342889947444315e-06,0,0
20723,golan,3,5.509358563746952e-06,3,6.8342889947444315e-06,0,0
20879,covington,3,5.509358563746952e-06,3,6.8342889947444315e-06,0,0
20922,۴۰,3,5.509358563746952e-06,3,6.8342889947444315e-06,0,0
20915,سال,3,5.509358563746952e-06,3,6.8342889947444315e-06,0,0
20960,guaido,3,5.509358563746952e-06,3,6.8342889947444315e-06,0,0
102,tops,2,3.6729057091646343e-06,1,2.2780963315814773e-06,1,9.472836640932127e-06
107,progressbut,2,3.6729057091646343e-06,0,0,2,1.8945673281864254e-05
160,bucket,2,3.6729057091646343e-06,0,0,2,1.8945673281864254e-05
173,healthier,2,3.6729057091646343e-06,1,2.2780963315814773e-06,1,9.472836640932127e-06
295,dishes,2,3.6729057091646343e-06,0,0,2,1.8945673281864254e-05
439,crude,2,3.6729057091646343e-06,1,2.2780963315814773e-06,1,9.472836640932127e-06
479,dozen,2,3.6729057091646343e-06,1,2.2780963315814773e-06,1,9.472836640932127e-06
505,trick-or-treat,2,3.6729057091646343e-06,0,0,2,1.8945673281864254e-05
506,candy,2,3.6729057091646343e-06,1,2.2780963315814773e-06,1,9.472836640932127e-06
513,incarcerated,2,3.6729057091646343e-06,0,0,2,1.8945673281864254e-05
553,176,2,3.6729057091646343e-06,0,0,2,1.8945673281864254e-05
600,tooth,2,3.6729057091646343e-06,1,2.2780963315814773e-06,1,9.472836640932127e-06
653,√,2,3.6729057091646343e-06,0,0,2,1.8945673281864254e-05
694,kippur,2,3.6729057091646343e-06,1,2.2780963315814773e-06,1,9.472836640932127e-06
706,realand,2,3.6729057091646343e-06,0,0,2,1.8945673281864254e-05
709,principled,2,3.6729057091646343e-06,0,0,2,1.8945673281864254e-05
715,#constitutionday,2,3.6729057091646343e-06,1,2.2780963315814773e-06,1,9.472836640932127e-06
732,oldest,2,3.6729057091646343e-06,1,2.2780963315814773e-06,1,9.472836640932127e-06
738,shanah,2,3.6729057091646343e-06,0,0,2,1.8945673281864254e-05
739,tovah,2,3.6729057091646343e-06,0,0,2,1.8945673281864254e-05
777,non-proliferation,2,3.6729057091646343e-06,0,0,2,1.8945673281864254e-05
792,173000,2,3.6729057091646343e-06,0,0,2,1.8945673281864254e-05
811,behind-the-scenes,2,3.6729057091646343e-06,0,0,2,1.8945673281864254e-05
810,alaskathe,2,3.6729057091646343e-06,0,0,2,1.8945673281864254e-05
819,updating,2,3.6729057091646343e-06,1,2.2780963315814773e-06,1,9.472836640932127e-06
855,stack,2,3.6729057091646343e-06,0,0,2,1.8945673281864254e-05
861,@usarmys,2,3.6729057091646343e-06,1,2.2780963315814773e-06,1,9.472836640932127e-06
867,curb,2,3.6729057091646343e-06,1,2.2780963315814773e-06,1,9.472836640932127e-06
905,73000,2,3.6729057091646343e-06,0,0,2,1.8945673281864254e-05
944,obtaining,2,3.6729057091646343e-06,1,2.2780963315814773e-06,1,9.472836640932127e-06
968,scrutiny,2,3.6729057091646343e-06,1,2.2780963315814773e-06,1,9.472836640932127e-06
979,fantasy,2,3.6729057091646343e-06,1,2.2780963315814773e-06,1,9.472836640932127e-06
982,acquire,2,3.6729057091646343e-06,1,2.2780963315814773e-06,1,9.472836640932127e-06
996,54th,2,3.6729057091646343e-06,0,0,2,1.8945673281864254e-05
1026,140,2,3.6729057091646343e-06,0,0,2,1.8945673281864254e-05
1036,appearance,2,3.6729057091646343e-06,0,0,2,1.8945673281864254e-05
1041,#ada25,2,3.6729057091646343e-06,0,0,2,1.8945673281864254e-05
1057,mubarak,2,3.6729057091646343e-06,0,0,2,1.8945673281864254e-05
1080,mandatory,2,3.6729057091646343e-06,1,2.2780963315814773e-06,1,9.472836640932127e-06
1086,tag,2,3.6729057091646343e-06,0,0,2,1.8945673281864254e-05
1089,neighborhoods,2,3.6729057091646343e-06,1,2.2780963315814773e-06,1,9.472836640932127e-06
1141,punishment,2,3.6729057091646343e-06,1,2.2780963315814773e-06,1,9.472836640932127e-06
1145,jails,2,3.6729057091646343e-06,1,2.2780963315814773e-06,1,9.472836640932127e-06
1156,completing,2,3.6729057091646343e-06,1,2.2780963315814773e-06,1,9.472836640932127e-06
1160,determines,2,3.6729057091646343e-06,0,0,2,1.8945673281864254e-05
1169,out-of-pocket,2,3.6729057091646343e-06,0,0,2,1.8945673281864254e-05
1167,contraceptive,2,3.6729057091646343e-06,0,0,2,1.8945673281864254e-05
1187,priced,2,3.6729057091646343e-06,1,2.2780963315814773e-06,1,9.472836640932127e-06
1233,two-year,2,3.6729057091646343e-06,1,2.2780963315814773e-06,1,9.472836640932127e-06
1234,223000,2,3.6729057091646343e-06,0,0,2,1.8945673281864254e-05
1267,cumulative,2,3.6729057091646343e-06,1,2.2780963315814773e-06,1,9.472836640932127e-06
1287,uncertain,2,3.6729057091646343e-06,0,0,2,1.8945673281864254e-05
1320,#putsolaronit,2,3.6729057091646343e-06,0,0,2,1.8945673281864254e-05
1333,banner,2,3.6729057091646343e-06,1,2.2780963315814773e-06,1,9.472836640932127e-06
1365,280000,2,3.6729057091646343e-06,0,0,2,1.8945673281864254e-05
1370,#nationalrunningday,2,3.6729057091646343e-06,0,0,2,1.8945673281864254e-05
1376,spark,2,3.6729057091646343e-06,0,0,2,1.8945673281864254e-05
1398,#cleanwaterrules,2,3.6729057091646343e-06,0,0,2,1.8945673281864254e-05
1439,derailment,2,3.6729057091646343e-06,1,2.2780963315814773e-06,1,9.472836640932127e-06
1441,exploration,2,3.6729057091646343e-06,1,2.2780963315814773e-06,1,9.472836640932127e-06
1443,planets,2,3.6729057091646343e-06,0,0,2,1.8945673281864254e-05
1448,beats,2,3.6729057091646343e-06,0,0,2,1.8945673281864254e-05
1460,atmosphere,2,3.6729057091646343e-06,0,0,2,1.8945673281864254e-05
1501,loretta,2,3.6729057091646343e-06,0,0,2,1.8945673281864254e-05
1539,edited,2,3.6729057091646343e-06,1,2.2780963315814773e-06,1,9.472836640932127e-06
1540,omitted,2,3.6729057091646343e-06,1,2.2780963315814773e-06,1,9.472836640932127e-06
1572,#nationalhighfiveday,2,3.6729057091646343e-06,0,0,2,1.8945673281864254e-05
1580,therapy,2,3.6729057091646343e-06,1,2.2780963315814773e-06,1,9.472836640932127e-06
1582,#eastereggroll,2,3.6729057091646343e-06,0,0,2,1.8945673281864254e-05
1634,careers,2,3.6729057091646343e-06,1,2.2780963315814773e-06,1,9.472836640932127e-06
1637,nail,2,3.6729057091646343e-06,1,2.2780963315814773e-06,1,9.472836640932127e-06
1655,#whfilmfest,2,3.6729057091646343e-06,0,0,2,1.8945673281864254e-05
1681,#canilive,2,3.6729057091646343e-06,0,0,2,1.8945673281864254e-05
1683,combating,2,3.6729057091646343e-06,1,2.2780963315814773e-06,1,9.472836640932127e-06
1725,whites,2,3.6729057091646343e-06,1,2.2780963315814773e-06,1,9.472836640932127e-06
1730,teaches,2,3.6729057091646343e-06,0,0,2,1.8945673281864254e-05
1733,powerless,2,3.6729057091646343e-06,1,2.2780963315814773e-06,1,9.472836640932127e-06
1746,#letgirlslearn,2,3.6729057091646343e-06,0,0,2,1.8945673281864254e-05
1752,passionate,2,3.6729057091646343e-06,0,0,2,1.8945673281864254e-05
1755,broaden,2,3.6729057091646343e-06,0,0,2,1.8945673281864254e-05
1754,#womenshistorymonth,2,3.6729057091646343e-06,0,0,2,1.8945673281864254e-05
1765,leonard,2,3.6729057091646343e-06,1,2.2780963315814773e-06,1,9.472836640932127e-06
1794,#loveyourpetday,2,3.6729057091646343e-06,0,0,2,1.8945673281864254e-05
1819,sleeves,2,3.6729057091646343e-06,1,2.2780963315814773e-06,1,9.472836640932127e-06
1832,jobsand,2,3.6729057091646343e-06,0,0,2,1.8945673281864254e-05
1887,possibleand,2,3.6729057091646343e-06,0,0,2,1.8945673281864254e-05
1896,maternity,2,3.6729057091646343e-06,0,0,2,1.8945673281864254e-05
1919,climbing,2,3.6729057091646343e-06,1,2.2780963315814773e-06,1,9.472836640932127e-06
1931,112,2,3.6729057091646343e-06,1,2.2780963315814773e-06,1,9.472836640932127e-06
1937,shoulder,2,3.6729057091646343e-06,0,0,2,1.8945673281864254e-05
1949,1984,2,3.6729057091646343e-06,1,2.2780963315814773e-06,1,9.472836640932127e-06
1964,resurgence,2,3.6729057091646343e-06,0,0,2,1.8945673281864254e-05
1970,@latimes,2,3.6729057091646343e-06,1,2.2780963315814773e-06,1,9.472836640932127e-06
1980,inchip,2,3.6729057091646343e-06,0,0,2,1.8945673281864254e-05
1999,@stephenathome,2,3.6729057091646343e-06,0,0,2,1.8945673281864254e-05
2002,stamp,2,3.6729057091646343e-06,1,2.2780963315814773e-06,1,9.472836640932127e-06
2003,@time,2,3.6729057091646343e-06,1,2.2780963315814773e-06,1,9.472836640932127e-06
2012,#happyhanukkah,2,3.6729057091646343e-06,1,2.2780963315814773e-06,1,9.472836640932127e-06
2027,#investinus,2,3.6729057091646343e-06,0,0,2,1.8945673281864254e-05
2035,strivers,2,3.6729057091646343e-06,0,0,2,1.8945673281864254e-05
2038,shadows,2,3.6729057091646343e-06,0,0,2,1.8945673281864254e-05
2042,populations,2,3.6729057091646343e-06,1,2.2780963315814773e-06,1,9.472836640932127e-06
2045,tangible,2,3.6729057091646343e-06,0,0,2,1.8945673281864254e-05
2068,healthbut,2,3.6729057091646343e-06,0,0,2,1.8945673281864254e-05
2070,gridlock,2,3.6729057091646343e-06,0,0,2,1.8945673281864254e-05
2089,stalled,2,3.6729057091646343e-06,1,2.2780963315814773e-06,1,9.472836640932127e-06
2112,ambitious,2,3.6729057091646343e-06,1,2.2780963315814773e-06,1,9.472836640932127e-06
2115,gatekeepers,2,3.6729057091646343e-06,1,2.2780963315814773e-06,1,9.472836640932127e-06
2130,squeeze,2,3.6729057091646343e-06,1,2.2780963315814773e-06,1,9.472836640932127e-06
2136,tricks,2,3.6729057091646343e-06,1,2.2780963315814773e-06,1,9.472836640932127e-06
2137,#scarierthanhalloween,2,3.6729057091646343e-06,0,0,2,1.8945673281864254e-05
2141,engineering,2,3.6729057091646343e-06,0,0,2,1.8945673281864254e-05
2154,rhode,2,3.6729057091646343e-06,1,2.2780963315814773e-06,1,9.472836640932127e-06
2158,big-hearted,2,3.6729057091646343e-06,0,0,2,1.8945673281864254e-05
2179,countdown,2,3.6729057091646343e-06,0,0,2,1.8945673281864254e-05
2177,#healthcarecountdown,2,3.6729057091646343e-06,0,0,2,1.8945673281864254e-05
2183,economyand,2,3.6729057091646343e-06,0,0,2,1.8945673281864254e-05
2204,cleared,2,3.6729057091646343e-06,1,2.2780963315814773e-06,1,9.472836640932127e-06
2215,trickled,2,3.6729057091646343e-06,0,0,2,1.8945673281864254e-05
2221,reforming,2,3.6729057091646343e-06,0,0,2,1.8945673281864254e-05
2238,detect,2,3.6729057091646343e-06,1,2.2780963315814773e-06,1,9.472836640932127e-06
2278,tolerance,2,3.6729057091646343e-06,0,0,2,1.8945673281864254e-05
2291,guided,2,3.6729057091646343e-06,1,2.2780963315814773e-06,1,9.472836640932127e-06
2300,americorps,2,3.6729057091646343e-06,0,0,2,1.8945673281864254e-05
2299,#americorps20,2,3.6729057091646343e-06,0,0,2,1.8945673281864254e-05
2304,isil,2,3.6729057091646343e-06,0,0,2,1.8945673281864254e-05
2313,posed,2,3.6729057091646343e-06,1,2.2780963315814773e-06,1,9.472836640932127e-06
2326,scientific,2,3.6729057091646343e-06,0,0,2,1.8945673281864254e-05
2332,10m,2,3.6729057091646343e-06,1,2.2780963315814773e-06,1,9.472836640932127e-06
2335,rein,2,3.6729057091646343e-06,0,0,2,1.8945673281864254e-05
2344,#alconvention,2,3.6729057091646343e-06,0,0,2,1.8945673281864254e-05
2360,shout,2,3.6729057091646343e-06,1,2.2780963315814773e-06,1,9.472836640932127e-06
2374,intensifying,2,3.6729057091646343e-06,1,2.2780963315814773e-06,1,9.472836640932127e-06
2383,robin,2,3.6729057091646343e-06,0,0,2,1.8945673281864254e-05
2399,ofas,2,3.6729057091646343e-06,0,0,2,1.8945673281864254e-05
2408,historypresident,2,3.6729057091646343e-06,0,0,2,1.8945673281864254e-05
2485,saddled,2,3.6729057091646343e-06,1,2.2780963315814773e-06,1,9.472836640932127e-06
2516,chooses,2,3.6729057091646343e-06,1,2.2780963315814773e-06,1,9.472836640932127e-06
2518,yes-or-no,2,3.6729057091646343e-06,0,0,2,1.8945673281864254e-05
2523,#oneyearnoaction,2,3.6729057091646343e-06,0,0,2,1.8945673281864254e-05
2530,#worldcup,2,3.6729057091646343e-06,0,0,2,1.8945673281864254e-05
2540,struggled,2,3.6729057091646343e-06,1,2.2780963315814773e-06,1,9.472836640932127e-06
2551,bedrock,2,3.6729057091646343e-06,0,0,2,1.8945673281864254e-05
2552,livespresident,2,3.6729057091646343e-06,0,0,2,1.8945673281864254e-05
2574,prohibit,2,3.6729057091646343e-06,1,2.2780963315814773e-06,1,9.472836640932127e-06
2572,contractors,2,3.6729057091646343e-06,1,2.2780963315814773e-06,1,9.472836640932127e-06
2577,#degreesnotdebt,2,3.6729057091646343e-06,0,0,2,1.8945673281864254e-05
2588,#timeforprogress,2,3.6729057091646343e-06,0,0,2,1.8945673281864254e-05
2590,borrowers,2,3.6729057091646343e-06,0,0,2,1.8945673281864254e-05
2592,brainer,2,3.6729057091646343e-06,1,2.2780963315814773e-06,1,9.472836640932127e-06
2606,#itsourinterest,2,3.6729057091646343e-06,0,0,2,1.8945673281864254e-05
2611,d-day,2,3.6729057091646343e-06,1,2.2780963315814773e-06,1,9.472836640932127e-06
2622,shines,2,3.6729057091646343e-06,0,0,2,1.8945673281864254e-05
2636,loudest,2,3.6729057091646343e-06,1,2.2780963315814773e-06,1,9.472836640932127e-06
2639,@wvalderrama,2,3.6729057091646343e-06,0,0,2,1.8945673281864254e-05
2642,shifted,2,3.6729057091646343e-06,1,2.2780963315814773e-06,1,9.472836640932127e-06
2650,repealers,2,3.6729057091646343e-06,0,0,2,1.8945673281864254e-05
2652,@madeleine,2,3.6729057091646343e-06,0,0,2,1.8945673281864254e-05
2659,enterprises,2,3.6729057091646343e-06,1,2.2780963315814773e-06,1,9.472836640932127e-06
2668,dreamed,2,3.6729057091646343e-06,1,2.2780963315814773e-06,1,9.472836640932127e-06
2693,hashoah,2,3.6729057091646343e-06,1,2.2780963315814773e-06,1,9.472836640932127e-06
2697,isaac,2,3.6729057091646343e-06,0,0,2,1.8945673281864254e-05
2709,truman,2,3.6729057091646343e-06,1,2.2780963315814773e-06,1,9.472836640932127e-06
2712,runners,2,3.6729057091646343e-06,1,2.2780963315814773e-06,1,9.472836640932127e-06
2710,#bostonstrong,2,3.6729057091646343e-06,0,0,2,1.8945673281864254e-05
2734,#costofinaction,2,3.6729057091646343e-06,0,0,2,1.8945673281864254e-05
2737,unchallenged,2,3.6729057091646343e-06,1,2.2780963315814773e-06,1,9.472836640932127e-06
2739,votepresident,2,3.6729057091646343e-06,0,0,2,1.8945673281864254e-05
2760,anybodys,2,3.6729057091646343e-06,0,0,2,1.8945673281864254e-05
2789,@umich,2,3.6729057091646343e-06,0,0,2,1.8945673281864254e-05
2796,messy,2,3.6729057091646343e-06,1,2.2780963315814773e-06,1,9.472836640932127e-06
2801,year-round,2,3.6729057091646343e-06,1,2.2780963315814773e-06,1,9.472836640932127e-06
2813,#beatthebuzzer,2,3.6729057091646343e-06,0,0,2,1.8945673281864254e-05
2825,somethingand,2,3.6729057091646343e-06,0,0,2,1.8945673281864254e-05
2840,bread,2,3.6729057091646343e-06,0,0,2,1.8945673281864254e-05
2856,timeand,2,3.6729057091646343e-06,1,2.2780963315814773e-06,1,9.472836640932127e-06
2862,tweeting,2,3.6729057091646343e-06,0,0,2,1.8945673281864254e-05
2861,#14daysleft,2,3.6729057091646343e-06,0,0,2,1.8945673281864254e-05
2867,pi,2,3.6729057091646343e-06,0,0,2,1.8945673281864254e-05
2873,budged,2,3.6729057091646343e-06,0,0,2,1.8945673281864254e-05
2876,realistic,2,3.6729057091646343e-06,1,2.2780963315814773e-06,1,9.472836640932127e-06
2880,#up4climate,2,3.6729057091646343e-06,0,0,2,1.8945673281864254e-05
2889,squarely,2,3.6729057091646343e-06,1,2.2780963315814773e-06,1,9.472836640932127e-06
2894,diverse,2,3.6729057091646343e-06,1,2.2780963315814773e-06,1,9.472836640932127e-06
2916,punishing,2,3.6729057091646343e-06,1,2.2780963315814773e-06,1,9.472836640932127e-06
2941,urban,2,3.6729057091646343e-06,1,2.2780963315814773e-06,1,9.472836640932127e-06
2955,deciding,2,3.6729057091646343e-06,1,2.2780963315814773e-06,1,9.472836640932127e-06
2965,youand,2,3.6729057091646343e-06,1,2.2780963315814773e-06,1,9.472836640932127e-06
2974,85m,2,3.6729057091646343e-06,0,0,2,1.8945673281864254e-05
2978,researchers,2,3.6729057091646343e-06,1,2.2780963315814773e-06,1,9.472836640932127e-06
2975,invent,2,3.6729057091646343e-06,0,0,2,1.8945673281864254e-05
2982,debut,2,3.6729057091646343e-06,0,0,2,1.8945673281864254e-05
3004,3d,2,3.6729057091646343e-06,1,2.2780963315814773e-06,1,9.472836640932127e-06
3006,compelling,2,3.6729057091646343e-06,1,2.2780963315814773e-06,1,9.472836640932127e-06
3032,contracts,2,3.6729057091646343e-06,1,2.2780963315814773e-06,1,9.472836640932127e-06
3036,priceless,2,3.6729057091646343e-06,1,2.2780963315814773e-06,1,9.472836640932127e-06
3038,#coveramerica,2,3.6729057091646343e-06,0,0,2,1.8945673281864254e-05
3049,brush,2,3.6729057091646343e-06,0,0,2,1.8945673281864254e-05
3055,neighbor,2,3.6729057091646343e-06,1,2.2780963315814773e-06,1,9.472836640932127e-06
3062,luis,2,3.6729057091646343e-06,0,0,2,1.8945673281864254e-05
3060,anxious,2,3.6729057091646343e-06,1,2.2780963315814773e-06,1,9.472836640932127e-06
3067,#puppybowl,2,3.6729057091646343e-06,0,0,2,1.8945673281864254e-05
3066,#letsfetch,2,3.6729057091646343e-06,0,0,2,1.8945673281864254e-05
3088,winfrey,2,3.6729057091646343e-06,1,2.2780963315814773e-06,1,9.472836640932127e-06
3094,groceries,2,3.6729057091646343e-06,0,0,2,1.8945673281864254e-05
3108,world-class,2,3.6729057091646343e-06,0,0,2,1.8945673281864254e-05
3112,defining,2,3.6729057091646343e-06,1,2.2780963315814773e-06,1,9.472836640932127e-06
3119,draft,2,3.6729057091646343e-06,1,2.2780963315814773e-06,1,9.472836640932127e-06
3131,alonepresident,2,3.6729057091646343e-06,0,0,2,1.8945673281864254e-05
3154,volunteering,2,3.6729057091646343e-06,0,0,2,1.8945673281864254e-05
3170,dropout,2,3.6729057091646343e-06,1,2.2780963315814773e-06,1,9.472836640932127e-06
3175,#innovationnation,2,3.6729057091646343e-06,0,0,2,1.8945673281864254e-05
3203,orthodox,2,3.6729057091646343e-06,1,2.2780963315814773e-06,1,9.472836640932127e-06
3208,statistics,2,3.6729057091646343e-06,1,2.2780963315814773e-06,1,9.472836640932127e-06
3222,320,2,3.6729057091646343e-06,1,2.2780963315814773e-06,1,9.472836640932127e-06
3230,pregnancy,2,3.6729057091646343e-06,0,0,2,1.8945673281864254e-05
3233,#happynewyear,2,3.6729057091646343e-06,1,2.2780963315814773e-06,1,9.472836640932127e-06
3242,expires,2,3.6729057091646343e-06,0,0,2,1.8945673281864254e-05
3257,averaging,2,3.6729057091646343e-06,0,0,2,1.8945673281864254e-05
3302,joyful,2,3.6729057091646343e-06,1,2.2780963315814773e-06,1,9.472836640932127e-06
3306,bent,2,3.6729057091646343e-06,1,2.2780963315814773e-06,1,9.472836640932127e-06
3305,arc,2,3.6729057091646343e-06,0,0,2,1.8945673281864254e-05
3310,conditionslike,2,3.6729057091646343e-06,0,0,2,1.8945673281864254e-05
3309,allergies,2,3.6729057091646343e-06,0,0,2,1.8945673281864254e-05
3324,1979,2,3.6729057091646343e-06,0,0,2,1.8945673281864254e-05
3334,#wad2013,2,3.6729057091646343e-06,0,0,2,1.8945673281864254e-05
3340,reflect,2,3.6729057091646343e-06,0,0,2,1.8945673281864254e-05
3347,fifty,2,3.6729057091646343e-06,1,2.2780963315814773e-06,1,9.472836640932127e-06
3356,shrink,2,3.6729057091646343e-06,0,0,2,1.8945673281864254e-05
3359,outpaced,2,3.6729057091646343e-06,1,2.2780963315814773e-06,1,9.472836640932127e-06
3366,forwardpresident,2,3.6729057091646343e-06,0,0,2,1.8945673281864254e-05
3371,pre-obamacare,2,3.6729057091646343e-06,0,0,2,1.8945673281864254e-05
3370,diagnosed,2,3.6729057091646343e-06,0,0,2,1.8945673281864254e-05
3386,ear,2,3.6729057091646343e-06,0,0,2,1.8945673281864254e-05
3394,limiting,2,3.6729057091646343e-06,1,2.2780963315814773e-06,1,9.472836640932127e-06
3395,#ready4reform,2,3.6729057091646343e-06,0,0,2,1.8945673281864254e-05
3396,aloha,2,3.6729057091646343e-06,0,0,2,1.8945673281864254e-05
3400,worn,2,3.6729057091646343e-06,1,2.2780963315814773e-06,1,9.472836640932127e-06
3399,uniforms,2,3.6729057091646343e-06,1,2.2780963315814773e-06,1,9.472836640932127e-06
3402,@epas,2,3.6729057091646343e-06,0,0,2,1.8945673281864254e-05
3416,@nhlblackhawks,2,3.6729057091646343e-06,0,0,2,1.8945673281864254e-05
3427,#worldseries,2,3.6729057091646343e-06,1,2.2780963315814773e-06,1,9.472836640932127e-06
3430,lens,2,3.6729057091646343e-06,0,0,2,1.8945673281864254e-05
3449,@hillaryclinton,2,3.6729057091646343e-06,0,0,2,1.8945673281864254e-05
3467,#justfixit,2,3.6729057091646343e-06,0,0,2,1.8945673281864254e-05
3473,disfunction,2,3.6729057091646343e-06,1,2.2780963315814773e-06,1,9.472836640932127e-06
3474,furloughed,2,3.6729057091646343e-06,0,0,2,1.8945673281864254e-05
3489,faction,2,3.6729057091646343e-06,0,0,2,1.8945673281864254e-05
3492,tactic,2,3.6729057091646343e-06,1,2.2780963315814773e-06,1,9.472836640932127e-06
3498,shelters,2,3.6729057091646343e-06,1,2.2780963315814773e-06,1,9.472836640932127e-06
3500,extract,2,3.6729057091646343e-06,1,2.2780963315814773e-06,1,9.472836640932127e-06
3518,irresponsible,2,3.6729057091646343e-06,1,2.2780963315814773e-06,1,9.472836640932127e-06
3519,#governmentshutdown,2,3.6729057091646343e-06,0,0,2,1.8945673281864254e-05
3523,#boehnershutdown,2,3.6729057091646343e-06,0,0,2,1.8945673281864254e-05
3525,americansnot,2,3.6729057091646343e-06,0,0,2,1.8945673281864254e-05
3536,awayand,2,3.6729057091646343e-06,1,2.2780963315814773e-06,1,9.472836640932127e-06
3542,disrupted,2,3.6729057091646343e-06,0,0,2,1.8945673281864254e-05
3558,#cgi2013,2,3.6729057091646343e-06,0,0,2,1.8945673281864254e-05
3568,1995,2,3.6729057091646343e-06,0,0,2,1.8945673281864254e-05
3570,2008-2012equal,2,3.6729057091646343e-06,0,0,2,1.8945673281864254e-05
3591,68m,2,3.6729057091646343e-06,1,2.2780963315814773e-06,1,9.472836640932127e-06
3599,providers,2,3.6729057091646343e-06,1,2.2780963315814773e-06,1,9.472836640932127e-06
3623,1963,2,3.6729057091646343e-06,0,0,2,1.8945673281864254e-05
3624,fierce,2,3.6729057091646343e-06,0,0,2,1.8945673281864254e-05
3695,arrivals,2,3.6729057091646343e-06,0,0,2,1.8945673281864254e-05
3716,ranking,2,3.6729057091646343e-06,1,2.2780963315814773e-06,1,9.472836640932127e-06
3722,fi,2,3.6729057091646343e-06,1,2.2780963315814773e-06,1,9.472836640932127e-06
3723,pendleton,2,3.6729057091646343e-06,0,0,2,1.8945673281864254e-05
3742,sings,2,3.6729057091646343e-06,0,0,2,1.8945673281864254e-05
3762,#notbackingdown,2,3.6729057091646343e-06,0,0,2,1.8945673281864254e-05
3771,economists,2,3.6729057091646343e-06,1,2.2780963315814773e-06,1,9.472836640932127e-06
3773,output,2,3.6729057091646343e-06,1,2.2780963315814773e-06,1,9.472836640932127e-06
3782,units,2,3.6729057091646343e-06,0,0,2,1.8945673281864254e-05
3787,#sequester,2,3.6729057091646343e-06,0,0,2,1.8945673281864254e-05
3804,baracks,2,3.6729057091646343e-06,0,0,2,1.8945673281864254e-05
3837,duke,2,3.6729057091646343e-06,1,2.2780963315814773e-06,1,9.472836640932127e-06
3883,#goobamacare,2,3.6729057091646343e-06,0,0,2,1.8945673281864254e-05
3888,muslims,2,3.6729057091646343e-06,0,0,2,1.8945673281864254e-05
3891,generated,2,3.6729057091646343e-06,0,0,2,1.8945673281864254e-05
3893,sidelines,2,3.6729057091646343e-06,0,0,2,1.8945673281864254e-05
3920,prop,2,3.6729057091646343e-06,1,2.2780963315814773e-06,1,9.472836640932127e-06
3924,1k,2,3.6729057091646343e-06,1,2.2780963315814773e-06,1,9.472836640932127e-06
3945,#teamobamacare,2,3.6729057091646343e-06,0,0,2,1.8945673281864254e-05
3947,@lisamurkowski,2,3.6729057091646343e-06,1,2.2780963315814773e-06,1,9.472836640932127e-06
3953,bodies,2,3.6729057091646343e-06,0,0,2,1.8945673281864254e-05
3962,#daca,2,3.6729057091646343e-06,0,0,2,1.8945673281864254e-05
3963,dreaming,2,3.6729057091646343e-06,1,2.2780963315814773e-06,1,9.472836640932127e-06
3967,#newtown,2,3.6729057091646343e-06,0,0,2,1.8945673281864254e-05
3990,wives,2,3.6729057091646343e-06,0,0,2,1.8945673281864254e-05
3993,#standwithdreamers,2,3.6729057091646343e-06,0,0,2,1.8945673281864254e-05
3999,deport,2,3.6729057091646343e-06,1,2.2780963315814773e-06,1,9.472836640932127e-06
4001,wifi,2,3.6729057091646343e-06,1,2.2780963315814773e-06,1,9.472836640932127e-06
4003,retain,2,3.6729057091646343e-06,1,2.2780963315814773e-06,1,9.472836640932127e-06
4005,#prekforall,2,3.6729057091646343e-06,0,0,2,1.8945673281864254e-05
4008,spurs,2,3.6729057091646343e-06,1,2.2780963315814773e-06,1,9.472836640932127e-06
4009,#mentalhealthmatters,2,3.6729057091646343e-06,0,0,2,1.8945673281864254e-05
4024,suits,2,3.6729057091646343e-06,1,2.2780963315814773e-06,1,9.472836640932127e-06
4029,fellowship,2,3.6729057091646343e-06,0,0,2,1.8945673281864254e-05
4034,sectors,2,3.6729057091646343e-06,0,0,2,1.8945673281864254e-05
4040,@redcross,2,3.6729057091646343e-06,1,2.2780963315814773e-06,1,9.472836640932127e-06
4044,todaypresident,2,3.6729057091646343e-06,0,0,2,1.8945673281864254e-05
4045,donepresident,2,3.6729057091646343e-06,0,0,2,1.8945673281864254e-05
4058,americapresident,2,3.6729057091646343e-06,0,0,2,1.8945673281864254e-05
4066,750000,2,3.6729057091646343e-06,0,0,2,1.8945673281864254e-05
4075,steadfast,2,3.6729057091646343e-06,1,2.2780963315814773e-06,1,9.472836640932127e-06
4076,terrorized,2,3.6729057091646343e-06,0,0,2,1.8945673281864254e-05
4091,aftermath,2,3.6729057091646343e-06,1,2.2780963315814773e-06,1,9.472836640932127e-06
4093,generosity,2,3.6729057091646343e-06,1,2.2780963315814773e-06,1,9.472836640932127e-06
4095,concern,2,3.6729057091646343e-06,1,2.2780963315814773e-06,1,9.472836640932127e-06
4099,defeats,2,3.6729057091646343e-06,1,2.2780963315814773e-06,1,9.472836640932127e-06
4100,#equalpayday,2,3.6729057091646343e-06,0,0,2,1.8945673281864254e-05
4101,bury,2,3.6729057091646343e-06,0,0,2,1.8945673281864254e-05
4125,bullet,2,3.6729057091646343e-06,1,2.2780963315814773e-06,1,9.472836640932127e-06
4135,#votegunsense,2,3.6729057091646343e-06,0,0,2,1.8945673281864254e-05
4136,binds,2,3.6729057091646343e-06,0,0,2,1.8945673281864254e-05
4158,elseand,2,3.6729057091646343e-06,1,2.2780963315814773e-06,1,9.472836640932127e-06
4167,decadesand,2,3.6729057091646343e-06,0,0,2,1.8945673281864254e-05
4172,salesand,2,3.6729057091646343e-06,0,0,2,1.8945673281864254e-05
4191,holiness,2,3.6729057091646343e-06,1,2.2780963315814773e-06,1,9.472836640932127e-06
4189,beings,2,3.6729057091646343e-06,1,2.2780963315814773e-06,1,9.472836640932127e-06
4197,transferred,2,3.6729057091646343e-06,1,2.2780963315814773e-06,1,9.472836640932127e-06
4205,empowering,2,3.6729057091646343e-06,1,2.2780963315814773e-06,1,9.472836640932127e-06
4206,#cutswecantafford,2,3.6729057091646343e-06,0,0,2,1.8945673281864254e-05
4217,89,2,3.6729057091646343e-06,1,2.2780963315814773e-06,1,9.472836640932127e-06
4235,simplest,2,3.6729057091646343e-06,0,0,2,1.8945673281864254e-05
4236,unveiling,2,3.6729057091646343e-06,0,0,2,1.8945673281864254e-05
4239,shifting,2,3.6729057091646343e-06,1,2.2780963315814773e-06,1,9.472836640932127e-06
4278,#livingwage,2,3.6729057091646343e-06,0,0,2,1.8945673281864254e-05
4285,outnot,2,3.6729057091646343e-06,0,0,2,1.8945673281864254e-05
4294,debated,2,3.6729057091646343e-06,0,0,2,1.8945673281864254e-05
4314,randall,2,3.6729057091646343e-06,1,2.2780963315814773e-06,1,9.472836640932127e-06
4321,sellers,2,3.6729057091646343e-06,1,2.2780963315814773e-06,1,9.472836640932127e-06
4323,grandfather,2,3.6729057091646343e-06,1,2.2780963315814773e-06,1,9.472836640932127e-06
4331,military-style,2,3.6729057091646343e-06,0,0,2,1.8945673281864254e-05
4329,10-round,2,3.6729057091646343e-06,0,0,2,1.8945673281864254e-05
4333,defiance,2,3.6729057091646343e-06,1,2.2780963315814773e-06,1,9.472836640932127e-06
4334,spurred,2,3.6729057091646343e-06,0,0,2,1.8945673281864254e-05
4338,@gabbygiffords,2,3.6729057091646343e-06,0,0,2,1.8945673281864254e-05
4357,reasoned,2,3.6729057091646343e-06,1,2.2780963315814773e-06,1,9.472836640932127e-06
4363,evident,2,3.6729057091646343e-06,1,2.2780963315814773e-06,1,9.472836640932127e-06
4367,shrinking,2,3.6729057091646343e-06,0,0,2,1.8945673281864254e-05
4376,@obamainaugural,2,3.6729057091646343e-06,0,0,2,1.8945673281864254e-05
4408,broader,2,3.6729057091646343e-06,0,0,2,1.8945673281864254e-05
4420,wound,2,3.6729057091646343e-06,1,2.2780963315814773e-06,1,9.472836640932127e-06
4427,considerably,2,3.6729057091646343e-06,1,2.2780963315814773e-06,1,9.472836640932127e-06
4441,responds,2,3.6729057091646343e-06,0,0,2,1.8945673281864254e-05
4462,114,2,3.6729057091646343e-06,0,0,2,1.8945673281864254e-05
4472,ashes,2,3.6729057091646343e-06,1,2.2780963315814773e-06,1,9.472836640932127e-06
4475,listens,2,3.6729057091646343e-06,0,0,2,1.8945673281864254e-05
4504,silver,2,3.6729057091646343e-06,1,2.2780963315814773e-06,1,9.472836640932127e-06
4501,nailed,2,3.6729057091646343e-06,1,2.2780963315814773e-06,1,9.472836640932127e-06
4538,handful,2,3.6729057091646343e-06,0,0,2,1.8945673281864254e-05
4553,afforded,2,3.6729057091646343e-06,1,2.2780963315814773e-06,1,9.472836640932127e-06
4572,nation-building,2,3.6729057091646343e-06,0,0,2,1.8945673281864254e-05
4577,springsteen,2,3.6729057091646343e-06,0,0,2,1.8945673281864254e-05
4589,crack,2,3.6729057091646343e-06,0,0,2,1.8945673281864254e-05
4591,reckless,2,3.6729057091646343e-06,0,0,2,1.8945673281864254e-05
4593,inconvenient,2,3.6729057091646343e-06,0,0,2,1.8945673281864254e-05
4596,rubber-stamp,2,3.6729057091646343e-06,0,0,2,1.8945673281864254e-05
4594,congressthats,2,3.6729057091646343e-06,0,0,2,1.8945673281864254e-05
4597,repackage,2,3.6729057091646343e-06,0,0,2,1.8945673281864254e-05
4609,post-911,2,3.6729057091646343e-06,0,0,2,1.8945673281864254e-05
4624,educationpresident,2,3.6729057091646343e-06,0,0,2,1.8945673281864254e-05
4629,exploding,2,3.6729057091646343e-06,0,0,2,1.8945673281864254e-05
4645,mentor,2,3.6729057091646343e-06,1,2.2780963315814773e-06,1,9.472836640932127e-06
4662,foreclosures,2,3.6729057091646343e-06,0,0,2,1.8945673281864254e-05
4668,dignified,2,3.6729057091646343e-06,1,2.2780963315814773e-06,1,9.472836640932127e-06
4679,four-star,2,3.6729057091646343e-06,1,2.2780963315814773e-06,1,9.472836640932127e-06
4682,faint,2,3.6729057091646343e-06,1,2.2780963315814773e-06,1,9.472836640932127e-06
4685,setbacks,2,3.6729057091646343e-06,1,2.2780963315814773e-06,1,9.472836640932127e-06
4691,agendawe,2,3.6729057091646343e-06,0,0,2,1.8945673281864254e-05
4696,dress,2,3.6729057091646343e-06,1,2.2780963315814773e-06,1,9.472836640932127e-06
4711,quicklybut,2,3.6729057091646343e-06,1,2.2780963315814773e-06,1,9.472836640932127e-06
4725,contributing,2,3.6729057091646343e-06,1,2.2780963315814773e-06,1,9.472836640932127e-06
4735,ohioans,2,3.6729057091646343e-06,0,0,2,1.8945673281864254e-05
4743,seconds,2,3.6729057091646343e-06,1,2.2780963315814773e-06,1,9.472836640932127e-06
4765,verge,2,3.6729057091646343e-06,0,0,2,1.8945673281864254e-05
4770,worryobamacare,2,3.6729057091646343e-06,0,0,2,1.8945673281864254e-05
4768,romnesia,2,3.6729057091646343e-06,0,0,2,1.8945673281864254e-05
4774,tarmac,2,3.6729057091646343e-06,1,2.2780963315814773e-06,1,9.472836640932127e-06
4785,statutory,2,3.6729057091646343e-06,1,2.2780963315814773e-06,1,9.472836640932127e-06
4787,akin,2,3.6729057091646343e-06,1,2.2780963315814773e-06,1,9.472836640932127e-06
4797,mourdock,2,3.6729057091646343e-06,0,0,2,1.8945673281864254e-05
4806,citing,2,3.6729057091646343e-06,1,2.2780963315814773e-06,1,9.472836640932127e-06
4816,greeting,2,3.6729057091646343e-06,1,2.2780963315814773e-06,1,9.472836640932127e-06
4825,taping,2,3.6729057091646343e-06,1,2.2780963315814773e-06,1,9.472836640932127e-06
4837,leno,2,3.6729057091646343e-06,1,2.2780963315814773e-06,1,9.472836640932127e-06
4841,16000,2,3.6729057091646343e-06,0,0,2,1.8945673281864254e-05
4846,mercy,2,3.6729057091646343e-06,0,0,2,1.8945673281864254e-05
4860,high-five,2,3.6729057091646343e-06,0,0,2,1.8945673281864254e-05
4876,messor,2,3.6729057091646343e-06,0,0,2,1.8945673281864254e-05
4878,1980s,2,3.6729057091646343e-06,1,2.2780963315814773e-06,1,9.472836640932127e-06
4885,debatebut,2,3.6729057091646343e-06,0,0,2,1.8945673281864254e-05
4886,titled,2,3.6729057091646343e-06,0,0,2,1.8945673281864254e-05
4902,digging,2,3.6729057091646343e-06,1,2.2780963315814773e-06,1,9.472836640932127e-06
4909,afghans,2,3.6729057091646343e-06,1,2.2780963315814773e-06,1,9.472836640932127e-06
4933,9-11,2,3.6729057091646343e-06,1,2.2780963315814773e-06,1,9.472836640932127e-06
4949,womenor,2,3.6729057091646343e-06,0,0,2,1.8945673281864254e-05
4951,outlawing,2,3.6729057091646343e-06,0,0,2,1.8945673281864254e-05
4953,conveniently,2,3.6729057091646343e-06,1,2.2780963315814773e-06,1,9.472836640932127e-06
4954,insurer,2,3.6729057091646343e-06,0,0,2,1.8945673281864254e-05
4968,#romneysbinders,2,3.6729057091646343e-06,0,0,2,1.8945673281864254e-05
4972,#obamawinsdebate,2,3.6729057091646343e-06,0,0,2,1.8945673281864254e-05
4985,binders,2,3.6729057091646343e-06,0,0,2,1.8945673281864254e-05
4986,#teambarack,2,3.6729057091646343e-06,0,0,2,1.8945673281864254e-05
5001,comfortable,2,3.6729057091646343e-06,1,2.2780963315814773e-06,1,9.472836640932127e-06
5006,specifics,2,3.6729057091646343e-06,0,0,2,1.8945673281864254e-05
5035,skewed,2,3.6729057091646343e-06,0,0,2,1.8945673281864254e-05
5040,#therealromneys,2,3.6729057091646343e-06,0,0,2,1.8945673281864254e-05
5057,canvassing,2,3.6729057091646343e-06,0,0,2,1.8945673281864254e-05
5063,toughness,2,3.6729057091646343e-06,1,2.2780963315814773e-06,1,9.472836640932127e-06
5069,towel,2,3.6729057091646343e-06,0,0,2,1.8945673281864254e-05
5086,#factsmatter,2,3.6729057091646343e-06,0,0,2,1.8945673281864254e-05
5119,buckeyes,2,3.6729057091646343e-06,0,0,2,1.8945673281864254e-05
5125,live-tweeting,2,3.6729057091646343e-06,0,0,2,1.8945673281864254e-05
5134,til,2,3.6729057091646343e-06,0,0,2,1.8945673281864254e-05
5136,decimating,2,3.6729057091646343e-06,1,2.2780963315814773e-06,1,9.472836640932127e-06
5141,votethen,2,3.6729057091646343e-06,0,0,2,1.8945673281864254e-05
5156,sesame,2,3.6729057091646343e-06,0,0,2,1.8945673281864254e-05
5158,@ofawi,2,3.6729057091646343e-06,0,0,2,1.8945673281864254e-05
5161,#forwardnotback,2,3.6729057091646343e-06,0,0,2,1.8945673281864254e-05
5166,onstage,2,3.6729057091646343e-06,0,0,2,1.8945673281864254e-05
5167,spirited,2,3.6729057091646343e-06,1,2.2780963315814773e-06,1,9.472836640932127e-06
5169,defensive,2,3.6729057091646343e-06,1,2.2780963315814773e-06,1,9.472836640932127e-06
5177,recipe,2,3.6729057091646343e-06,0,0,2,1.8945673281864254e-05
5215,texting,2,3.6729057091646343e-06,0,0,2,1.8945673281864254e-05
5214,msgsmth,2,3.6729057091646343e-06,0,0,2,1.8945673281864254e-05
5216,fec,2,3.6729057091646343e-06,0,0,2,1.8945673281864254e-05
5218,106,2,3.6729057091646343e-06,1,2.2780963315814773e-06,1,9.472836640932127e-06
5229,saturdays,2,3.6729057091646343e-06,0,0,2,1.8945673281864254e-05
5234,spouse,2,3.6729057091646343e-06,1,2.2780963315814773e-06,1,9.472836640932127e-06
5243,till,2,3.6729057091646343e-06,1,2.2780963315814773e-06,1,9.472836640932127e-06
5247,weekends,2,3.6729057091646343e-06,1,2.2780963315814773e-06,1,9.472836640932127e-06
5256,rewardedpresident,2,3.6729057091646343e-06,0,0,2,1.8945673281864254e-05
5261,simplify,2,3.6729057091646343e-06,0,0,2,1.8945673281864254e-05
5266,chicken,2,3.6729057091646343e-06,1,2.2780963315814773e-06,1,9.472836640932127e-06
5272,regular,2,3.6729057091646343e-06,1,2.2780963315814773e-06,1,9.472836640932127e-06
5271,refs,2,3.6729057091646343e-06,0,0,2,1.8945673281864254e-05
5281,44th,2,3.6729057091646343e-06,0,0,2,1.8945673281864254e-05
5291,clearer,2,3.6729057091646343e-06,1,2.2780963315814773e-06,1,9.472836640932127e-06
5321,void,2,3.6729057091646343e-06,1,2.2780963315814773e-06,1,9.472836640932127e-06
5336,beyoncé,2,3.6729057091646343e-06,0,0,2,1.8945673281864254e-05
5346,economypresident,2,3.6729057091646343e-06,0,0,2,1.8945673281864254e-05
5355,painful,2,3.6729057091646343e-06,0,0,2,1.8945673281864254e-05
5356,gif,2,3.6729057091646343e-06,0,0,2,1.8945673281864254e-05
5375,yesterdayand,2,3.6729057091646343e-06,0,0,2,1.8945673281864254e-05
5384,weekthank,2,3.6729057091646343e-06,1,2.2780963315814773e-06,1,9.472836640932127e-06
5389,itpresident,2,3.6729057091646343e-06,0,0,2,1.8945673281864254e-05
5392,notion,2,3.6729057091646343e-06,0,0,2,1.8945673281864254e-05
5410,kerrys,2,3.6729057091646343e-06,1,2.2780963315814773e-06,1,9.472836640932127e-06
5424,reins,2,3.6729057091646343e-06,0,0,2,1.8945673281864254e-05
5441,10pm,2,3.6729057091646343e-06,0,0,2,1.8945673281864254e-05
5457,handy,2,3.6729057091646343e-06,0,0,2,1.8945673281864254e-05
5455,app,2,3.6729057091646343e-06,1,2.2780963315814773e-06,1,9.472836640932127e-06
5459,bepresident,2,3.6729057091646343e-06,0,0,2,1.8945673281864254e-05
5464,keynote,2,3.6729057091646343e-06,1,2.2780963315814773e-06,1,9.472836640932127e-06
5466,gottaregister․com,2,3.6729057091646343e-06,0,0,2,1.8945673281864254e-05
5474,rerun,2,3.6729057091646343e-06,0,0,2,1.8945673281864254e-05
5472,black-and-white,2,3.6729057091646343e-06,0,0,2,1.8945673281864254e-05
5478,pitched,2,3.6729057091646343e-06,0,0,2,1.8945673281864254e-05
5502,unjust,2,3.6729057091646343e-06,0,0,2,1.8945673281864254e-05
5503,reddit,2,3.6729057091646343e-06,0,0,2,1.8945673281864254e-05
5511,christie,2,3.6729057091646343e-06,1,2.2780963315814773e-06,1,9.472836640932127e-06
5516,keys,2,3.6729057091646343e-06,1,2.2780963315814773e-06,1,9.472836640932127e-06
5517,luxuryits,2,3.6729057091646343e-06,0,0,2,1.8945673281864254e-05
5522,mug,2,3.6729057091646343e-06,0,0,2,1.8945673281864254e-05
5529,rational,2,3.6729057091646343e-06,1,2.2780963315814773e-06,1,9.472836640932127e-06
5530,20-year,2,3.6729057091646343e-06,0,0,2,1.8945673281864254e-05
5534,classes,2,3.6729057091646343e-06,1,2.2780963315814773e-06,1,9.472836640932127e-06
5553,copay,2,3.6729057091646343e-06,0,0,2,1.8945673281864254e-05
5554,coveragediscrimination,2,3.6729057091646343e-06,0,0,2,1.8945673281864254e-05
5556,cosponsored,2,3.6729057091646343e-06,0,0,2,1.8945673281864254e-05
5560,offensive,2,3.6729057091646343e-06,1,2.2780963315814773e-06,1,9.472836640932127e-06
5566,tying,2,3.6729057091646343e-06,1,2.2780963315814773e-06,1,9.472836640932127e-06
5567,rehire,2,3.6729057091646343e-06,1,2.2780963315814773e-06,1,9.472836640932127e-06
5578,nose,2,3.6729057091646343e-06,1,2.2780963315814773e-06,1,9.472836640932127e-06
5587,handshake,2,3.6729057091646343e-06,1,2.2780963315814773e-06,1,9.472836640932127e-06
5592,37000,2,3.6729057091646343e-06,1,2.2780963315814773e-06,1,9.472836640932127e-06
5594,turbines,2,3.6729057091646343e-06,0,0,2,1.8945673281864254e-05
5593,homesor,2,3.6729057091646343e-06,0,0,2,1.8945673281864254e-05
5598,powering,2,3.6729057091646343e-06,1,2.2780963315814773e-06,1,9.472836640932127e-06
5620,whod,2,3.6729057091646343e-06,0,0,2,1.8945673281864254e-05
5628,legends,2,3.6729057091646343e-06,0,0,2,1.8945673281864254e-05
5632,paths,2,3.6729057091646343e-06,0,0,2,1.8945673281864254e-05
5633,instagram,2,3.6729057091646343e-06,1,2.2780963315814773e-06,1,9.472836640932127e-06
5646,elena,2,3.6729057091646343e-06,0,0,2,1.8945673281864254e-05
5649,#2200dollars,2,3.6729057091646343e-06,0,0,2,1.8945673281864254e-05
5650,easy-to-use,2,3.6729057091646343e-06,0,0,2,1.8945673281864254e-05
5651,wayand,2,3.6729057091646343e-06,1,2.2780963315814773e-06,1,9.472836640932127e-06
5660,gymnastics,2,3.6729057091646343e-06,0,0,2,1.8945673281864254e-05
5669,fare,2,3.6729057091646343e-06,1,2.2780963315814773e-06,1,9.472836640932127e-06
5684,crush,2,3.6729057091646343e-06,1,2.2780963315814773e-06,1,9.472836640932127e-06
5690,gutting,2,3.6729057091646343e-06,1,2.2780963315814773e-06,1,9.472836640932127e-06
5703,#congresstodolist,2,3.6729057091646343e-06,0,0,2,1.8945673281864254e-05
5708,countryfind,2,3.6729057091646343e-06,0,0,2,1.8945673281864254e-05
5710,prospering,2,3.6729057091646343e-06,1,2.2780963315814773e-06,1,9.472836640932127e-06
5723,distorting,2,3.6729057091646343e-06,1,2.2780963315814773e-06,1,9.472836640932127e-06
5742,outsourcers,2,3.6729057091646343e-06,0,0,2,1.8945673281864254e-05
5763,councils,2,3.6729057091646343e-06,1,2.2780963315814773e-06,1,9.472836640932127e-06
5773,transforming,2,3.6729057091646343e-06,1,2.2780963315814773e-06,1,9.472836640932127e-06
5772,continent,2,3.6729057091646343e-06,1,2.2780963315814773e-06,1,9.472836640932127e-06
5776,retroactively,2,3.6729057091646343e-06,1,2.2780963315814773e-06,1,9.472836640932127e-06
5795,cookie,2,3.6729057091646343e-06,1,2.2780963315814773e-06,1,9.472836640932127e-06
5801,weighted,2,3.6729057091646343e-06,1,2.2780963315814773e-06,1,9.472836640932127e-06
5810,disclosure,2,3.6729057091646343e-06,1,2.2780963315814773e-06,1,9.472836640932127e-06
5814,cayman,2,3.6729057091646343e-06,0,0,2,1.8945673281864254e-05
5818,cream,2,3.6729057091646343e-06,0,0,2,1.8945673281864254e-05
5817,cedar,2,3.6729057091646343e-06,1,2.2780963315814773e-06,1,9.472836640932127e-06
5825,@azizansari,2,3.6729057091646343e-06,0,0,2,1.8945673281864254e-05
5829,fiber,2,3.6729057091646343e-06,1,2.2780963315814773e-06,1,9.472836640932127e-06
5834,flyers,2,3.6729057091646343e-06,1,2.2780963315814773e-06,1,9.472836640932127e-06
5841,wholl,2,3.6729057091646343e-06,0,0,2,1.8945673281864254e-05
5844,maumee,2,3.6729057091646343e-06,0,0,2,1.8945673281864254e-05
5846,downpresident,2,3.6729057091646343e-06,0,0,2,1.8945673281864254e-05
5860,actthen,2,3.6729057091646343e-06,0,0,2,1.8945673281864254e-05
5863,quiz,2,3.6729057091646343e-06,0,0,2,1.8945673281864254e-05
5868,co-pay,2,3.6729057091646343e-06,0,0,2,1.8945673281864254e-05
5873,bike,2,3.6729057091646343e-06,0,0,2,1.8945673281864254e-05
5876,junes,2,3.6729057091646343e-06,1,2.2780963315814773e-06,1,9.472836640932127e-06
5884,erica,2,3.6729057091646343e-06,1,2.2780963315814773e-06,1,9.472836640932127e-06
5889,electronics,2,3.6729057091646343e-06,1,2.2780963315814773e-06,1,9.472836640932127e-06
5901,tilt,2,3.6729057091646343e-06,0,0,2,1.8945673281864254e-05
5909,fee,2,3.6729057091646343e-06,1,2.2780963315814773e-06,1,9.472836640932127e-06
5938,recruiting,2,3.6729057091646343e-06,0,0,2,1.8945673281864254e-05
5945,stalemate,2,3.6729057091646343e-06,1,2.2780963315814773e-06,1,9.472836640932127e-06
5950,guidance,2,3.6729057091646343e-06,1,2.2780963315814773e-06,1,9.472836640932127e-06
5966,ticking,2,3.6729057091646343e-06,1,2.2780963315814773e-06,1,9.472836640932127e-06
5983,internships,2,3.6729057091646343e-06,0,0,2,1.8945673281864254e-05
5982,intern,2,3.6729057091646343e-06,0,0,2,1.8945673281864254e-05
5987,firemen,2,3.6729057091646343e-06,1,2.2780963315814773e-06,1,9.472836640932127e-06
5991,@theellenshow,2,3.6729057091646343e-06,0,0,2,1.8945673281864254e-05
6000,eisenhower,2,3.6729057091646343e-06,0,0,2,1.8945673281864254e-05
6012,25-year-old,2,3.6729057091646343e-06,0,0,2,1.8945673281864254e-05
6015,todaya,2,3.6729057091646343e-06,0,0,2,1.8945673281864254e-05
6026,215,2,3.6729057091646343e-06,0,0,2,1.8945673281864254e-05
6028,skyrocketed,2,3.6729057091646343e-06,1,2.2780963315814773e-06,1,9.472836640932127e-06
6063,candid,2,3.6729057091646343e-06,1,2.2780963315814773e-06,1,9.472836640932127e-06
6067,milk,2,3.6729057091646343e-06,1,2.2780963315814773e-06,1,9.472836640932127e-06
6078,ampad,2,3.6729057091646343e-06,0,0,2,1.8945673281864254e-05
6079,walks,2,3.6729057091646343e-06,1,2.2780963315814773e-06,1,9.472836640932127e-06
6083,mil,2,3.6729057091646343e-06,0,0,2,1.8945673281864254e-05
6084,widely,2,3.6729057091646343e-06,1,2.2780963315814773e-06,1,9.472836640932127e-06
6100,bankruptcy,2,3.6729057091646343e-06,0,0,2,1.8945673281864254e-05
6118,mortgages,2,3.6729057091646343e-06,0,0,2,1.8945673281864254e-05
6116,foreclosure,2,3.6729057091646343e-06,0,0,2,1.8945673281864254e-05
6126,load,2,3.6729057091646343e-06,0,0,2,1.8945673281864254e-05
6131,severance,2,3.6729057091646343e-06,0,0,2,1.8945673281864254e-05
6138,persevere,2,3.6729057091646343e-06,0,0,2,1.8945673281864254e-05
6146,ceiling-shattering,2,3.6729057091646343e-06,0,0,2,1.8945673281864254e-05
6162,beliefs,2,3.6729057091646343e-06,1,2.2780963315814773e-06,1,9.472836640932127e-06
6164,dates,2,3.6729057091646343e-06,1,2.2780963315814773e-06,1,9.472836640932127e-06
6179,writings,2,3.6729057091646343e-06,1,2.2780963315814773e-06,1,9.472836640932127e-06
6190,searching,2,3.6729057091646343e-06,1,2.2780963315814773e-06,1,9.472836640932127e-06
6198,georges,2,3.6729057091646343e-06,1,2.2780963315814773e-06,1,9.472836640932127e-06
6201,clooney,2,3.6729057091646343e-06,0,0,2,1.8945673281864254e-05
6203,brand-new,2,3.6729057091646343e-06,0,0,2,1.8945673281864254e-05
6225,sort,2,3.6729057091646343e-06,1,2.2780963315814773e-06,1,9.472836640932127e-06
6238,obamatell,2,3.6729057091646343e-06,0,0,2,1.8945673281864254e-05
6239,unc,2,3.6729057091646343e-06,0,0,2,1.8945673281864254e-05
6250,stare,2,3.6729057091646343e-06,1,2.2780963315814773e-06,1,9.472836640932127e-06
6255,#sumorg12,2,3.6729057091646343e-06,0,0,2,1.8945673281864254e-05
6264,interpreted,2,3.6729057091646343e-06,1,2.2780963315814773e-06,1,9.472836640932127e-06
6269,safeguards,2,3.6729057091646343e-06,1,2.2780963315814773e-06,1,9.472836640932127e-06
6270,toxic,2,3.6729057091646343e-06,1,2.2780963315814773e-06,1,9.472836640932127e-06
6279,chili,2,3.6729057091646343e-06,0,0,2,1.8945673281864254e-05
6284,millionaire,2,3.6729057091646343e-06,0,0,2,1.8945673281864254e-05
6285,bos,2,3.6729057091646343e-06,0,0,2,1.8945673281864254e-05
6289,pet,2,3.6729057091646343e-06,1,2.2780963315814773e-06,1,9.472836640932127e-06
6292,richest,2,3.6729057091646343e-06,1,2.2780963315814773e-06,1,9.472836640932127e-06
6291,low-income,2,3.6729057091646343e-06,0,0,2,1.8945673281864254e-05
6301,bunny,2,3.6729057091646343e-06,0,0,2,1.8945673281864254e-05
6306,22000,2,3.6729057091646343e-06,1,2.2780963315814773e-06,1,9.472836640932127e-06
6310,futures,2,3.6729057091646343e-06,1,2.2780963315814773e-06,1,9.472836640932127e-06
6323,#obama2012s,2,3.6729057091646343e-06,0,0,2,1.8945673281864254e-05
6326,excluded,2,3.6729057091646343e-06,1,2.2780963315814773e-06,1,9.472836640932127e-06
6350,annually,2,3.6729057091646343e-06,1,2.2780963315814773e-06,1,9.472836640932127e-06
6357,vermont,2,3.6729057091646343e-06,1,2.2780963315814773e-06,1,9.472836640932127e-06
6374,washes,2,3.6729057091646343e-06,1,2.2780963315814773e-06,1,9.472836640932127e-06
6380,#gen44,2,3.6729057091646343e-06,0,0,2,1.8945673281864254e-05
6389,adequate,2,3.6729057091646343e-06,0,0,2,1.8945673281864254e-05
6410,pocket,2,3.6729057091646343e-06,1,2.2780963315814773e-06,1,9.472836640932127e-06
6423,enjoyment,2,3.6729057091646343e-06,1,2.2780963315814773e-06,1,9.472836640932127e-06
6430,narrated,2,3.6729057091646343e-06,1,2.2780963315814773e-06,1,9.472836640932127e-06
6431,youtube,2,3.6729057091646343e-06,0,0,2,1.8945673281864254e-05
6438,elsepresident,2,3.6729057091646343e-06,0,0,2,1.8945673281864254e-05
6446,16-year,2,3.6729057091646343e-06,1,2.2780963315814773e-06,1,9.472836640932127e-06
6447,faced,2,3.6729057091646343e-06,1,2.2780963315814773e-06,1,9.472836640932127e-06
6448,fortitude,2,3.6729057091646343e-06,1,2.2780963315814773e-06,1,9.472836640932127e-06
6461,visitors,2,3.6729057091646343e-06,1,2.2780963315814773e-06,1,9.472836640932127e-06
6472,refinancing,2,3.6729057091646343e-06,1,2.2780963315814773e-06,1,9.472836640932127e-06
6474,sandra,2,3.6729057091646343e-06,0,0,2,1.8945673281864254e-05
6476,compensation,2,3.6729057091646343e-06,1,2.2780963315814773e-06,1,9.472836640932127e-06
6484,#aipac,2,3.6729057091646343e-06,0,0,2,1.8945673281864254e-05
6496,fries,2,3.6729057091646343e-06,0,0,2,1.8945673281864254e-05
6507,inexcusable,2,3.6729057091646343e-06,1,2.2780963315814773e-06,1,9.472836640932127e-06
6510,cede,2,3.6729057091646343e-06,1,2.2780963315814773e-06,1,9.472836640932127e-06
6514,jeremy,2,3.6729057091646343e-06,1,2.2780963315814773e-06,1,9.472836640932127e-06
6513,bandwagon,2,3.6729057091646343e-06,1,2.2780963315814773e-06,1,9.472836640932127e-06
6517,#afam2012,2,3.6729057091646343e-06,0,0,2,1.8945673281864254e-05
6523,weekpresident,2,3.6729057091646343e-06,0,0,2,1.8945673281864254e-05
6544,gops,2,3.6729057091646343e-06,0,0,2,1.8945673281864254e-05
6557,bb,2,3.6729057091646343e-06,0,0,2,1.8945673281864254e-05
6577,@ofanv,2,3.6729057091646343e-06,0,0,2,1.8945673281864254e-05
6587,manufacture,2,3.6729057091646343e-06,0,0,2,1.8945673281864254e-05
6592,hoodie,2,3.6729057091646343e-06,0,0,2,1.8945673281864254e-05
6604,tyranny,2,3.6729057091646343e-06,0,0,2,1.8945673281864254e-05
6605,candidacy,2,3.6729057091646343e-06,1,2.2780963315814773e-06,1,9.472836640932127e-06
6613,obesity,2,3.6729057091646343e-06,0,0,2,1.8945673281864254e-05
6615,settlement,2,3.6729057091646343e-06,1,2.2780963315814773e-06,1,9.472836640932127e-06
6621,marshmallow,2,3.6729057091646343e-06,0,0,2,1.8945673281864254e-05
6629,features,2,3.6729057091646343e-06,1,2.2780963315814773e-06,1,9.472836640932127e-06
6632,pre-game,2,3.6729057091646343e-06,1,2.2780963315814773e-06,1,9.472836640932127e-06
6633,catching,2,3.6729057091646343e-06,1,2.2780963315814773e-06,1,9.472836640932127e-06
6639,speeding,2,3.6729057091646343e-06,1,2.2780963315814773e-06,1,9.472836640932127e-06
6644,startup,2,3.6729057091646343e-06,1,2.2780963315814773e-06,1,9.472836640932127e-06
6650,regret,2,3.6729057091646343e-06,1,2.2780963315814773e-06,1,9.472836640932127e-06
6651,hangout,2,3.6729057091646343e-06,0,0,2,1.8945673281864254e-05
6653,then-senator,2,3.6729057091646343e-06,0,0,2,1.8945673281864254e-05
6655,postcard,2,3.6729057091646343e-06,0,0,2,1.8945673281864254e-05
6656,convenient,2,3.6729057091646343e-06,1,2.2780963315814773e-06,1,9.472836640932127e-06
6659,overview,2,3.6729057091646343e-06,0,0,2,1.8945673281864254e-05
6661,endures,2,3.6729057091646343e-06,0,0,2,1.8945673281864254e-05
6666,drama,2,3.6729057091646343e-06,1,2.2780963315814773e-06,1,9.472836640932127e-06
6687,aug,2,3.6729057091646343e-06,1,2.2780963315814773e-06,1,9.472836640932127e-06
6702,312,2,3.6729057091646343e-06,1,2.2780963315814773e-06,1,9.472836640932127e-06
6707,staircase,2,3.6729057091646343e-06,1,2.2780963315814773e-06,1,9.472836640932127e-06
6720,taste,2,3.6729057091646343e-06,1,2.2780963315814773e-06,1,9.472836640932127e-06
6731,rallying,2,3.6729057091646343e-06,0,0,2,1.8945673281864254e-05
6744,collaboration,2,3.6729057091646343e-06,1,2.2780963315814773e-06,1,9.472836640932127e-06
6745,designers,2,3.6729057091646343e-06,1,2.2780963315814773e-06,1,9.472836640932127e-06
6750,livelihoods,2,3.6729057091646343e-06,0,0,2,1.8945673281864254e-05
6753,watchdog,2,3.6729057091646343e-06,1,2.2780963315814773e-06,1,9.472836640932127e-06
6767,mugs,2,3.6729057091646343e-06,0,0,2,1.8945673281864254e-05
6776,@petesouza,2,3.6729057091646343e-06,0,0,2,1.8945673281864254e-05
6796,kroft,2,3.6729057091646343e-06,0,0,2,1.8945673281864254e-05
6798,georgetown,2,3.6729057091646343e-06,1,2.2780963315814773e-06,1,9.472836640932127e-06
6797,fdr,2,3.6729057091646343e-06,1,2.2780963315814773e-06,1,9.472836640932127e-06
6805,bullying,2,3.6729057091646343e-06,1,2.2780963315814773e-06,1,9.472836640932127e-06
6812,buffetts,2,3.6729057091646343e-06,0,0,2,1.8945673281864254e-05
6820,110,2,3.6729057091646343e-06,1,2.2780963315814773e-06,1,9.472836640932127e-06
6822,restrict,2,3.6729057091646343e-06,1,2.2780963315814773e-06,1,9.472836640932127e-06
6823,chocolate,2,3.6729057091646343e-06,1,2.2780963315814773e-06,1,9.472836640932127e-06
6858,neutrality,2,3.6729057091646343e-06,1,2.2780963315814773e-06,1,9.472836640932127e-06
6869,personalized,2,3.6729057091646343e-06,0,0,2,1.8945673281864254e-05
6900,unilaterally,2,3.6729057091646343e-06,1,2.2780963315814773e-06,1,9.472836640932127e-06
6910,1000000,2,3.6729057091646343e-06,1,2.2780963315814773e-06,1,9.472836640932127e-06
6914,by-the-numbers,2,3.6729057091646343e-06,0,0,2,1.8945673281864254e-05
6922,fact-checking,2,3.6729057091646343e-06,1,2.2780963315814773e-06,1,9.472836640932127e-06
6934,@cfpb,2,3.6729057091646343e-06,1,2.2780963315814773e-06,1,9.472836640932127e-06
6949,toss,2,3.6729057091646343e-06,0,0,2,1.8945673281864254e-05
6954,responses,2,3.6729057091646343e-06,1,2.2780963315814773e-06,1,9.472836640932127e-06
6957,189,2,3.6729057091646343e-06,1,2.2780963315814773e-06,1,9.472836640932127e-06
6973,double-downs,2,3.6729057091646343e-06,0,0,2,1.8945673281864254e-05
6979,grill,2,3.6729057091646343e-06,1,2.2780963315814773e-06,1,9.472836640932127e-06
6978,bbq,2,3.6729057091646343e-06,0,0,2,1.8945673281864254e-05
6982,-president,2,3.6729057091646343e-06,0,0,2,1.8945673281864254e-05
6993,presents,2,3.6729057091646343e-06,1,2.2780963315814773e-06,1,9.472836640932127e-06
7012,nominates,2,3.6729057091646343e-06,1,2.2780963315814773e-06,1,9.472836640932127e-06
7009,advisers,2,3.6729057091646343e-06,1,2.2780963315814773e-06,1,9.472836640932127e-06
7038,#gopdebate,2,3.6729057091646343e-06,0,0,2,1.8945673281864254e-05
7042,backtracks,2,3.6729057091646343e-06,0,0,2,1.8945673281864254e-05
7041,#scoreboard,2,3.6729057091646343e-06,0,0,2,1.8945673281864254e-05
7053,outlines,2,3.6729057091646343e-06,1,2.2780963315814773e-06,1,9.472836640932127e-06
7062,strive,2,3.6729057091646343e-06,0,0,2,1.8945673281864254e-05
7078,contacting,2,3.6729057091646343e-06,0,0,2,1.8945673281864254e-05
7079,amid,2,3.6729057091646343e-06,1,2.2780963315814773e-06,1,9.472836640932127e-06
7082,@petesessions,2,3.6729057091646343e-06,1,2.2780963315814773e-06,1,9.472836640932127e-06
7107,@repkevinbrady,2,3.6729057091646343e-06,1,2.2780963315814773e-06,1,9.472836640932127e-06
7155,@reppeteking,2,3.6729057091646343e-06,1,2.2780963315814773e-06,1,9.472836640932127e-06
7163,@auctnr1,2,3.6729057091646343e-06,1,2.2780963315814773e-06,1,9.472836640932127e-06
7174,@kevinyoder,2,3.6729057091646343e-06,1,2.2780963315814773e-06,1,9.472836640932127e-06
7225,handles,2,3.6729057091646343e-06,1,2.2780963315814773e-06,1,9.472836640932127e-06
7226,1020,2,3.6729057091646343e-06,1,2.2780963315814773e-06,1,9.472836640932127e-06
7228,norwegian,2,3.6729057091646343e-06,1,2.2780963315814773e-06,1,9.472836640932127e-06
7232,avoiding,2,3.6729057091646343e-06,1,2.2780963315814773e-06,1,9.472836640932127e-06
7240,one-year,2,3.6729057091646343e-06,1,2.2780963315814773e-06,1,9.472836640932127e-06
7246,hard-fought,2,3.6729057091646343e-06,1,2.2780963315814773e-06,1,9.472836640932127e-06
7248,gotta,2,3.6729057091646343e-06,1,2.2780963315814773e-06,1,9.472836640932127e-06
7252,1-1,2,3.6729057091646343e-06,0,0,2,1.8945673281864254e-05
7284,#dinnerwithbarackandjoe,2,3.6729057091646343e-06,0,0,2,1.8945673281864254e-05
7289,ramps,2,3.6729057091646343e-06,1,2.2780963315814773e-06,1,9.472836640932127e-06
7299,2004,2,3.6729057091646343e-06,1,2.2780963315814773e-06,1,9.472836640932127e-06
7302,kathy,2,3.6729057091646343e-06,1,2.2780963315814773e-06,1,9.472836640932127e-06
7306,principals,2,3.6729057091646343e-06,1,2.2780963315814773e-06,1,9.472836640932127e-06
7316,chile,2,3.6729057091646343e-06,1,2.2780963315814773e-06,1,9.472836640932127e-06
7322,330pm,2,3.6729057091646343e-06,0,0,2,1.8945673281864254e-05
7324,ideal,2,3.6729057091646343e-06,1,2.2780963315814773e-06,1,9.472836640932127e-06
7328,territories,2,3.6729057091646343e-06,1,2.2780963315814773e-06,1,9.472836640932127e-06
7333,4pm,2,3.6729057091646343e-06,1,2.2780963315814773e-06,1,9.472836640932127e-06
7335,crews,2,3.6729057091646343e-06,1,2.2780963315814773e-06,1,9.472836640932127e-06
7348,plouffe,2,3.6729057091646343e-06,0,0,2,1.8945673281864254e-05
7357,forbidden,2,3.6729057091646343e-06,1,2.2780963315814773e-06,1,9.472836640932127e-06
7363,high-speed,2,3.6729057091646343e-06,0,0,2,1.8945673281864254e-05
7377,paychecks,2,3.6729057091646343e-06,1,2.2780963315814773e-06,1,9.472836640932127e-06
7380,commemoration,2,3.6729057091646343e-06,1,2.2780963315814773e-06,1,9.472836640932127e-06
7381,kennedys,2,3.6729057091646343e-06,0,0,2,1.8945673281864254e-05
7384,stephanie,2,3.6729057091646343e-06,1,2.2780963315814773e-06,1,9.472836640932127e-06
7385,lifting,2,3.6729057091646343e-06,1,2.2780963315814773e-06,1,9.472836640932127e-06
7391,1130am,2,3.6729057091646343e-06,1,2.2780963315814773e-06,1,9.472836640932127e-06
7398,disappointing,2,3.6729057091646343e-06,1,2.2780963315814773e-06,1,9.472836640932127e-06
7407,benefited,2,3.6729057091646343e-06,1,2.2780963315814773e-06,1,9.472836640932127e-06
7413,symbols,2,3.6729057091646343e-06,1,2.2780963315814773e-06,1,9.472836640932127e-06
7430,canvass,2,3.6729057091646343e-06,0,0,2,1.8945673281864254e-05
7432,soand,2,3.6729057091646343e-06,1,2.2780963315814773e-06,1,9.472836640932127e-06
7442,#dontwait,2,3.6729057091646343e-06,0,0,2,1.8945673281864254e-05
7452,barackobamacomlive,2,3.6729057091646343e-06,0,0,2,1.8945673281864254e-05
7455,@johnlegend,2,3.6729057091646343e-06,1,2.2780963315814773e-06,1,9.472836640932127e-06
7474,detrimental,2,3.6729057091646343e-06,1,2.2780963315814773e-06,1,9.472836640932127e-06
7475,prospects,2,3.6729057091646343e-06,1,2.2780963315814773e-06,1,9.472836640932127e-06
7478,sway,2,3.6729057091646343e-06,1,2.2780963315814773e-06,1,9.472836640932127e-06
7489,engine,2,3.6729057091646343e-06,1,2.2780963315814773e-06,1,9.472836640932127e-06
7499,notions,2,3.6729057091646343e-06,0,0,2,1.8945673281864254e-05
7505,modernize,2,3.6729057091646343e-06,1,2.2780963315814773e-06,1,9.472836640932127e-06
7508,iraqs,2,3.6729057091646343e-06,0,0,2,1.8945673281864254e-05
7509,awed,2,3.6729057091646343e-06,1,2.2780963315814773e-06,1,9.472836640932127e-06
7512,demonstrated,2,3.6729057091646343e-06,1,2.2780963315814773e-06,1,9.472836640932127e-06
7519,partisanship,2,3.6729057091646343e-06,1,2.2780963315814773e-06,1,9.472836640932127e-06
7533,do-nothing,2,3.6729057091646343e-06,1,2.2780963315814773e-06,1,9.472836640932127e-06
7534,maneuvering,2,3.6729057091646343e-06,1,2.2780963315814773e-06,1,9.472836640932127e-06
7549,enacting,2,3.6729057091646343e-06,1,2.2780963315814773e-06,1,9.472836640932127e-06
7552,renews,2,3.6729057091646343e-06,1,2.2780963315814773e-06,1,9.472836640932127e-06
7553,accelerate,2,3.6729057091646343e-06,1,2.2780963315814773e-06,1,9.472836640932127e-06
7555,fears,2,3.6729057091646343e-06,1,2.2780963315814773e-06,1,9.472836640932127e-06
7564,#patientsbillofrights,2,3.6729057091646343e-06,0,0,2,1.8945673281864254e-05
7571,unending,2,3.6729057091646343e-06,1,2.2780963315814773e-06,1,9.472836640932127e-06
7574,resulting,2,3.6729057091646343e-06,1,2.2780963315814773e-06,1,9.472836640932127e-06
7575,clean-energy,2,3.6729057091646343e-06,0,0,2,1.8945673281864254e-05
7581,approaches,2,3.6729057091646343e-06,1,2.2780963315814773e-06,1,9.472836640932127e-06
7593,1600,2,3.6729057091646343e-06,1,2.2780963315814773e-06,1,9.472836640932127e-06
7598,murkowski,2,3.6729057091646343e-06,1,2.2780963315814773e-06,1,9.472836640932127e-06
7612,advocated,2,3.6729057091646343e-06,1,2.2780963315814773e-06,1,9.472836640932127e-06
7621,@usdol,2,3.6729057091646343e-06,1,2.2780963315814773e-06,1,9.472836640932127e-06
7633,entertainer,2,3.6729057091646343e-06,1,2.2780963315814773e-06,1,9.472836640932127e-06
7636,embodies,2,3.6729057091646343e-06,1,2.2780963315814773e-06,1,9.472836640932127e-06
7653,dorothy,2,3.6729057091646343e-06,1,2.2780963315814773e-06,1,9.472836640932127e-06
7657,proliferation,2,3.6729057091646343e-06,1,2.2780963315814773e-06,1,9.472836640932127e-06
7662,polish,2,3.6729057091646343e-06,1,2.2780963315814773e-06,1,9.472836640932127e-06
7669,injuries,2,3.6729057091646343e-06,1,2.2780963315814773e-06,1,9.472836640932127e-06
7730,prevailed,2,3.6729057091646343e-06,1,2.2780963315814773e-06,1,9.472836640932127e-06
7745,coakley,2,3.6729057091646343e-06,0,0,2,1.8945673281864254e-05
7748,itthe,2,3.6729057091646343e-06,0,0,2,1.8945673281864254e-05
7749,pls,2,3.6729057091646343e-06,0,0,2,1.8945673281864254e-05
7760,waves,2,3.6729057091646343e-06,1,2.2780963315814773e-06,1,9.472836640932127e-06
7770,blog,2,3.6729057091646343e-06,0,0,2,1.8945673281864254e-05
7777,202-559-1161,2,3.6729057091646343e-06,0,0,2,1.8945673281864254e-05
7792,800pm,2,3.6729057091646343e-06,1,2.2780963315814773e-06,1,9.472836640932127e-06
7807,220,2,3.6729057091646343e-06,1,2.2780963315814773e-06,1,9.472836640932127e-06
7814,imminent,2,3.6729057091646343e-06,1,2.2780963315814773e-06,1,9.472836640932127e-06
7822,smoke,2,3.6729057091646343e-06,1,2.2780963315814773e-06,1,9.472836640932127e-06
7826,humbled,2,3.6729057091646343e-06,1,2.2780963315814773e-06,1,9.472836640932127e-06
7831,overhaul,2,3.6729057091646343e-06,1,2.2780963315814773e-06,1,9.472836640932127e-06
7835,insurance…,2,3.6729057091646343e-06,0,0,2,1.8945673281864254e-05
7838,noon,2,3.6729057091646343e-06,1,2.2780963315814773e-06,1,9.472836640932127e-06
7840,busts,2,3.6729057091646343e-06,1,2.2780963315814773e-06,1,9.472836640932127e-06
7848,input,2,3.6729057091646343e-06,1,2.2780963315814773e-06,1,9.472836640932127e-06
7871,reaffirms,2,3.6729057091646343e-06,1,2.2780963315814773e-06,1,9.472836640932127e-06
7876,emission,2,3.6729057091646343e-06,1,2.2780963315814773e-06,1,9.472836640932127e-06
7879,56333,2,3.6729057091646343e-06,0,0,2,1.8945673281864254e-05
7895,normalization,2,3.6729057091646343e-06,2,4.556192663162955e-06,0,0
7901,cesspool,2,3.6729057091646343e-06,2,4.556192663162955e-06,0,0
7900,@mschlapp,2,3.6729057091646343e-06,2,4.556192663162955e-06,0,0
7899,@adamlaxalt,2,3.6729057091646343e-06,2,4.556192663162955e-06,0,0
7906,statutorily,2,3.6729057091646343e-06,2,4.556192663162955e-06,0,0
7904,@reince,2,3.6729057091646343e-06,2,4.556192663162955e-06,0,0
7907,laced,2,3.6729057091646343e-06,2,4.556192663162955e-06,0,0
7913,pluses,2,3.6729057091646343e-06,2,4.556192663162955e-06,0,0
7923,infamy,2,3.6729057091646343e-06,2,4.556192663162955e-06,0,0
7921,guardians,2,3.6729057091646343e-06,2,4.556192663162955e-06,0,0
7938,abcwapo,2,3.6729057091646343e-06,2,4.556192663162955e-06,0,0
7939,quinnipiac,2,3.6729057091646343e-06,2,4.556192663162955e-06,0,0
7941,@quinnipiacpoll,2,3.6729057091646343e-06,2,4.556192663162955e-06,0,0
7944,nbcwsj,2,3.6729057091646343e-06,2,4.556192663162955e-06,0,0
7952,bureaucracy,2,3.6729057091646343e-06,2,4.556192663162955e-06,0,0
7966,electors,2,3.6729057091646343e-06,2,4.556192663162955e-06,0,0
7974,baier,2,3.6729057091646343e-06,2,4.556192663162955e-06,0,0
7988,withdrew,2,3.6729057091646343e-06,2,4.556192663162955e-06,0,0
7990,emboldened,2,3.6729057091646343e-06,2,4.556192663162955e-06,0,0
8018,@deptofdefense,2,3.6729057091646343e-06,2,4.556192663162955e-06,0,0
8019,@dhswolf,2,3.6729057091646343e-06,2,4.556192663162955e-06,0,0
8021,@secbernhardt,2,3.6729057091646343e-06,2,4.556192663162955e-06,0,0
8034,ellipse,2,3.6729057091646343e-06,2,4.556192663162955e-06,0,0
8040,pennsylvanias,2,3.6729057091646343e-06,2,4.556192663162955e-06,0,0
8058,245th,2,3.6729057091646343e-06,2,4.556192663162955e-06,0,0
8102,usb,2,3.6729057091646343e-06,2,4.556192663162955e-06,0,0
8123,statistical,2,3.6729057091646343e-06,2,4.556192663162955e-06,0,0
8156,stripped,2,3.6729057091646343e-06,2,4.556192663162955e-06,0,0
8160,canvassers,2,3.6729057091646343e-06,2,4.556192663162955e-06,0,0
8171,taxing,2,3.6729057091646343e-06,2,4.556192663162955e-06,0,0
8193,discrepancy,2,3.6729057091646343e-06,2,4.556192663162955e-06,0,0
8200,impenetrable,2,3.6729057091646343e-06,2,4.556192663162955e-06,0,0
8204,cybersecurity,2,3.6729057091646343e-06,2,4.556192663162955e-06,0,0
8207,carney,2,3.6729057091646343e-06,2,4.556192663162955e-06,0,0
8213,usage,2,3.6729057091646343e-06,2,4.556192663162955e-06,0,0
8218,xs,2,3.6729057091646343e-06,2,4.556192663162955e-06,0,0
8238,politico,2,3.6729057091646343e-06,2,4.556192663162955e-06,0,0
8246,stays,2,3.6729057091646343e-06,2,4.556192663162955e-06,0,0
8250,@whnsc,2,3.6729057091646343e-06,2,4.556192663162955e-06,0,0
8262,715,2,3.6729057091646343e-06,2,4.556192663162955e-06,0,0
8270,@realamvoice,2,3.6729057091646343e-06,2,4.556192663162955e-06,0,0
8295,illegality,2,3.6729057091646343e-06,2,4.556192663162955e-06,0,0
8306,spells,2,3.6729057091646343e-06,2,4.556192663162955e-06,0,0
8303,issa,2,3.6729057091646343e-06,2,4.556192663162955e-06,0,0
8317,forgets,2,3.6729057091646343e-06,2,4.556192663162955e-06,0,0
8325,73000000,2,3.6729057091646343e-06,2,4.556192663162955e-06,0,0
8351,lid,2,3.6729057091646343e-06,2,4.556192663162955e-06,0,0
8359,admission,2,3.6729057091646343e-06,2,4.556192663162955e-06,0,0
8361,uttered,2,3.6729057091646343e-06,2,4.556192663162955e-06,0,0
8384,demonstrations,2,3.6729057091646343e-06,2,4.556192663162955e-06,0,0
8389,darin,2,3.6729057091646343e-06,2,4.556192663162955e-06,0,0
8404,intrusion,2,3.6729057091646343e-06,2,4.556192663162955e-06,0,0
8406,bowden,2,3.6729057091646343e-06,2,4.556192663162955e-06,0,0
8415,predicts,2,3.6729057091646343e-06,2,4.556192663162955e-06,0,0
8426,flooded,2,3.6729057091646343e-06,2,4.556192663162955e-06,0,0
8428,unaccounted,2,3.6729057091646343e-06,2,4.556192663162955e-06,0,0
8433,cartel,2,3.6729057091646343e-06,2,4.556192663162955e-06,0,0
8443,brann,2,3.6729057091646343e-06,2,4.556192663162955e-06,0,0
8441,900000,2,3.6729057091646343e-06,2,4.556192663162955e-06,0,0
8464,versus,2,3.6729057091646343e-06,2,4.556192663162955e-06,0,0
8466,hapless,2,3.6729057091646343e-06,2,4.556192663162955e-06,0,0
8475,@darrellissa,2,3.6729057091646343e-06,2,4.556192663162955e-06,0,0
8479,receives,2,3.6729057091646343e-06,2,4.556192663162955e-06,0,0
8487,audit,2,3.6729057091646343e-06,2,4.556192663162955e-06,0,0
8504,refers,2,3.6729057091646343e-06,2,4.556192663162955e-06,0,0
8512,@larrykudlow,2,3.6729057091646343e-06,2,4.556192663162955e-06,0,0
8519,unsuspecting,2,3.6729057091646343e-06,2,4.556192663162955e-06,0,0
8522,initial,2,3.6729057091646343e-06,2,4.556192663162955e-06,0,0
8525,protocols,2,3.6729057091646343e-06,2,4.556192663162955e-06,0,0
8539,goose,2,3.6729057091646343e-06,2,4.556192663162955e-06,0,0
8548,switched,2,3.6729057091646343e-06,2,4.556192663162955e-06,0,0
8571,confined,2,3.6729057091646343e-06,2,4.556192663162955e-06,0,0
8598,@drpaulgosar,2,3.6729057091646343e-06,2,4.556192663162955e-06,0,0
8609,disturbing,2,3.6729057091646343e-06,2,4.556192663162955e-06,0,0
8628,brooklyn,2,3.6729057091646343e-06,2,4.556192663162955e-06,0,0
8631,@amyklobuchar,2,3.6729057091646343e-06,2,4.556192663162955e-06,0,0
8643,@realdrgina,2,3.6729057091646343e-06,2,4.556192663162955e-06,0,0
8646,omaha,2,3.6729057091646343e-06,2,4.556192663162955e-06,0,0
8652,shielding,2,3.6729057091646343e-06,2,4.556192663162955e-06,0,0
8680,20s,2,3.6729057091646343e-06,2,4.556192663162955e-06,0,0
8691,@sensasse,2,3.6729057091646343e-06,2,4.556192663162955e-06,0,0
8705,gladly,2,3.6729057091646343e-06,2,4.556192663162955e-06,0,0
8712,freely,2,3.6729057091646343e-06,2,4.556192663162955e-06,0,0
8715,@senatorcollins,2,3.6729057091646343e-06,2,4.556192663162955e-06,0,0
8723,twitters,2,3.6729057091646343e-06,2,4.556192663162955e-06,0,0
8730,mooch,2,3.6729057091646343e-06,2,4.556192663162955e-06,0,0
8742,exposes,2,3.6729057091646343e-06,2,4.556192663162955e-06,0,0
8750,liberties,2,3.6729057091646343e-06,2,4.556192663162955e-06,0,0
8758,thundering,2,3.6729057091646343e-06,2,4.556192663162955e-06,0,0
8766,jenna,2,3.6729057091646343e-06,2,4.556192663162955e-06,0,0
8765,ellis,2,3.6729057091646343e-06,2,4.556192663162955e-06,0,0
8774,aggressively,2,3.6729057091646343e-06,2,4.556192663162955e-06,0,0
8782,rebuffed,2,3.6729057091646343e-06,2,4.556192663162955e-06,0,0
8781,elderly,2,3.6729057091646343e-06,2,4.556192663162955e-06,0,0
8816,rv,2,3.6729057091646343e-06,2,4.556192663162955e-06,0,0
8815,camps,2,3.6729057091646343e-06,2,4.556192663162955e-06,0,0
8818,abysmal,2,3.6729057091646343e-06,2,4.556192663162955e-06,0,0
8819,indianas,2,3.6729057091646343e-06,2,4.556192663162955e-06,0,0
8822,inspections,2,3.6729057091646343e-06,2,4.556192663162955e-06,0,0
8845,lenders,2,3.6729057091646343e-06,2,4.556192663162955e-06,0,0
8873,disdain,2,3.6729057091646343e-06,2,4.556192663162955e-06,0,0
8895,goodyear,2,3.6729057091646343e-06,2,4.556192663162955e-06,0,0
8902,1993,2,3.6729057091646343e-06,2,4.556192663162955e-06,0,0
8912,weddings,2,3.6729057091646343e-06,2,4.556192663162955e-06,0,0
8931,travelers,2,3.6729057091646343e-06,2,4.556192663162955e-06,0,0
8938,continuously,2,3.6729057091646343e-06,2,4.556192663162955e-06,0,0
8941,indonesia,2,3.6729057091646343e-06,2,4.556192663162955e-06,0,0
8950,razor,2,3.6729057091646343e-06,2,4.556192663162955e-06,0,0
8952,assisting,2,3.6729057091646343e-06,2,4.556192663162955e-06,0,0
8960,@gamebredfighter,2,3.6729057091646343e-06,2,4.556192663162955e-06,0,0
8962,aide,2,3.6729057091646343e-06,2,4.556192663162955e-06,0,0
8975,fo,2,3.6729057091646343e-06,2,4.556192663162955e-06,0,0
9001,promoted,2,3.6729057091646343e-06,2,4.556192663162955e-06,0,0
9003,staffer,2,3.6729057091646343e-06,2,4.556192663162955e-06,0,0
9006,@joenbc,2,3.6729057091646343e-06,2,4.556192663162955e-06,0,0
9038,indoor,2,3.6729057091646343e-06,2,4.556192663162955e-06,0,0
9037,dining,2,3.6729057091646343e-06,2,4.556192663162955e-06,0,0
9040,americanow,2,3.6729057091646343e-06,2,4.556192663162955e-06,0,0
9046,panic,2,3.6729057091646343e-06,2,4.556192663162955e-06,0,0
9057,herrell,2,3.6729057091646343e-06,2,4.556192663162955e-06,0,0
9056,@yvette4congress,2,3.6729057091646343e-06,2,4.556192663162955e-06,0,0
9055,#nm02,2,3.6729057091646343e-06,2,4.556192663162955e-06,0,0
9059,ellison,2,3.6729057091646343e-06,2,4.556192663162955e-06,0,0
9067,pollak,2,3.6729057091646343e-06,2,4.556192663162955e-06,0,0
9084,clouded,2,3.6729057091646343e-06,2,4.556192663162955e-06,0,0
9085,indoctrinated,2,3.6729057091646343e-06,2,4.556192663162955e-06,0,0
9100,poisoned,2,3.6729057091646343e-06,2,4.556192663162955e-06,0,0
9101,relatively,2,3.6729057091646343e-06,2,4.556192663162955e-06,0,0
9121,twisted,2,3.6729057091646343e-06,2,4.556192663162955e-06,0,0
9120,outsider,2,3.6729057091646343e-06,2,4.556192663162955e-06,0,0
9124,cheerleader,2,3.6729057091646343e-06,2,4.556192663162955e-06,0,0
9131,lg,2,3.6729057091646343e-06,2,4.556192663162955e-06,0,0
9134,governed,2,3.6729057091646343e-06,2,4.556192663162955e-06,0,0
9144,#election2020,2,3.6729057091646343e-06,2,4.556192663162955e-06,0,0
9146,cutler,2,3.6729057091646343e-06,2,4.556192663162955e-06,0,0
9155,overwhelm,2,3.6729057091646343e-06,2,4.556192663162955e-06,0,0
9157,staggering,2,3.6729057091646343e-06,2,4.556192663162955e-06,0,0
9163,stab,2,3.6729057091646343e-06,2,4.556192663162955e-06,0,0
9161,cronies,2,3.6729057091646343e-06,2,4.556192663162955e-06,0,0
9165,tanking,2,3.6729057091646343e-06,2,4.556192663162955e-06,0,0
9180,@jdanbishop,2,3.6729057091646343e-06,2,4.556192663162955e-06,0,0
9183,cunningham,2,3.6729057091646343e-06,2,4.556192663162955e-06,0,0
9186,intervening,2,3.6729057091646343e-06,2,4.556192663162955e-06,0,0
9187,affidavits,2,3.6729057091646343e-06,2,4.556192663162955e-06,0,0
9196,salutes,2,3.6729057091646343e-06,2,4.556192663162955e-06,0,0
9199,1230,2,3.6729057091646343e-06,2,4.556192663162955e-06,0,0
9204,insiders,2,3.6729057091646343e-06,2,4.556192663162955e-06,0,0
9207,treachery,2,3.6729057091646343e-06,2,4.556192663162955e-06,0,0
9216,posted,2,3.6729057091646343e-06,2,4.556192663162955e-06,0,0
9218,wipe,2,3.6729057091646343e-06,2,4.556192663162955e-06,0,0
9223,mayhem,2,3.6729057091646343e-06,2,4.556192663162955e-06,0,0
9225,solicited,2,3.6729057091646343e-06,2,4.556192663162955e-06,0,0
9234,walz,2,3.6729057091646343e-06,2,4.556192663162955e-06,0,0
9239,immune,2,3.6729057091646343e-06,2,4.556192663162955e-06,0,0
9256,relying,2,3.6729057091646343e-06,2,4.556192663162955e-06,0,0
9265,sahara,2,3.6729057091646343e-06,2,4.556192663162955e-06,0,0
9271,morocco,2,3.6729057091646343e-06,2,4.556192663162955e-06,0,0
9278,beverly,2,3.6729057091646343e-06,2,4.556192663162955e-06,0,0
9279,silenced,2,3.6729057091646343e-06,2,4.556192663162955e-06,0,0
9285,tamed,2,3.6729057091646343e-06,2,4.556192663162955e-06,0,0
9287,bureaucratic,2,3.6729057091646343e-06,2,4.556192663162955e-06,0,0
9314,businesswoman,2,3.6729057091646343e-06,2,4.556192663162955e-06,0,0
9320,rancher,2,3.6729057091646343e-06,2,4.556192663162955e-06,0,0
9322,@jimjusticewv,2,3.6729057091646343e-06,2,4.556192663162955e-06,0,0
9339,genevieve,2,3.6729057091646343e-06,2,4.556192663162955e-06,0,0
9340,bluff,2,3.6729057091646343e-06,2,4.556192663162955e-06,0,0
9343,predators,2,3.6729057091646343e-06,2,4.556192663162955e-06,0,0
9347,regarded,2,3.6729057091646343e-06,2,4.556192663162955e-06,0,0
9354,flash,2,3.6729057091646343e-06,2,4.556192663162955e-06,0,0
9384,shouts,2,3.6729057091646343e-06,2,4.556192663162955e-06,0,0
9390,recorded331,2,3.6729057091646343e-06,2,4.556192663162955e-06,0,0
9391,disappointment,2,3.6729057091646343e-06,2,4.556192663162955e-06,0,0
9404,dubuque,2,3.6729057091646343e-06,2,4.556192663162955e-06,0,0
9414,factory,2,3.6729057091646343e-06,2,4.556192663162955e-06,0,0
9442,punishable,2,3.6729057091646343e-06,2,4.556192663162955e-06,0,0
9443,adjustment,2,3.6729057091646343e-06,2,4.556192663162955e-06,0,0
9458,gaga,2,3.6729057091646343e-06,2,4.556192663162955e-06,0,0
9462,routed,2,3.6729057091646343e-06,2,4.556192663162955e-06,0,0
9471,defaming,2,3.6729057091646343e-06,2,4.556192663162955e-06,0,0
9487,establish,2,3.6729057091646343e-06,2,4.556192663162955e-06,0,0
9490,floating,2,3.6729057091646343e-06,2,4.556192663162955e-06,0,0
9492,unedited,2,3.6729057091646343e-06,2,4.556192663162955e-06,0,0
9493,12000000,2,3.6729057091646343e-06,2,4.556192663162955e-06,0,0
9494,3000000,2,3.6729057091646343e-06,2,4.556192663162955e-06,0,0
9499,lobster,2,3.6729057091646343e-06,2,4.556192663162955e-06,0,0
9502,solicitor,2,3.6729057091646343e-06,2,4.556192663162955e-06,0,0
9501,flagrantly,2,3.6729057091646343e-06,2,4.556192663162955e-06,0,0
9507,outlaw,2,3.6729057091646343e-06,2,4.556192663162955e-06,0,0
9513,shuttered,2,3.6729057091646343e-06,2,4.556192663162955e-06,0,0
9515,roam,2,3.6729057091646343e-06,2,4.556192663162955e-06,0,0
9523,#americandreamplan,2,3.6729057091646343e-06,2,4.556192663162955e-06,0,0
9544,una,2,3.6729057091646343e-06,2,4.556192663162955e-06,0,0
9538,para,2,3.6729057091646343e-06,2,4.556192663162955e-06,0,0
9532,fe,2,3.6729057091646343e-06,2,4.556192663162955e-06,0,0
9551,pro-american,2,3.6729057091646343e-06,2,4.556192663162955e-06,0,0
9557,extinguish,2,3.6729057091646343e-06,2,4.556192663162955e-06,0,0
9574,pardoned,2,3.6729057091646343e-06,2,4.556192663162955e-06,0,0
9587,alleging,2,3.6729057091646343e-06,2,4.556192663162955e-06,0,0
9592,des,2,3.6729057091646343e-06,2,4.556192663162955e-06,0,0
9593,moines,2,3.6729057091646343e-06,2,4.556192663162955e-06,0,0
9614,@nba,2,3.6729057091646343e-06,2,4.556192663162955e-06,0,0
9621,306-223,2,3.6729057091646343e-06,2,4.556192663162955e-06,0,0
9630,shield,2,3.6729057091646343e-06,2,4.556192663162955e-06,0,0
9633,disqualifying,2,3.6729057091646343e-06,2,4.556192663162955e-06,0,0
9643,random,2,3.6729057091646343e-06,2,4.556192663162955e-06,0,0
9648,fingers,2,3.6729057091646343e-06,2,4.556192663162955e-06,0,0
9674,communism,2,3.6729057091646343e-06,2,4.556192663162955e-06,0,0
9697,reigning,2,3.6729057091646343e-06,2,4.556192663162955e-06,0,0
9706,wan,2,3.6729057091646343e-06,2,4.556192663162955e-06,0,0
9707,measly,2,3.6729057091646343e-06,2,4.556192663162955e-06,0,0
9715,rotten,2,3.6729057091646343e-06,2,4.556192663162955e-06,0,0
9723,questioning,2,3.6729057091646343e-06,2,4.556192663162955e-06,0,0
9725,proceedings,2,3.6729057091646343e-06,2,4.556192663162955e-06,0,0
9728,@eveningedit,2,3.6729057091646343e-06,2,4.556192663162955e-06,0,0
9735,2022,2,3.6729057091646343e-06,2,4.556192663162955e-06,0,0
9744,tractors,2,3.6729057091646343e-06,2,4.556192663162955e-06,0,0
9748,205000,2,3.6729057091646343e-06,2,4.556192663162955e-06,0,0
9756,glitch,2,3.6729057091646343e-06,2,4.556192663162955e-06,0,0
9759,71000000,2,3.6729057091646343e-06,2,4.556192663162955e-06,0,0
9760,accordance,2,3.6729057091646343e-06,2,4.556192663162955e-06,0,0
9771,mattered,2,3.6729057091646343e-06,2,4.556192663162955e-06,0,0
9781,dispatched,2,3.6729057091646343e-06,2,4.556192663162955e-06,0,0
9783,dissent,2,3.6729057091646343e-06,2,4.556192663162955e-06,0,0
9790,submission,2,3.6729057091646343e-06,2,4.556192663162955e-06,0,0
9795,2k,2,3.6729057091646343e-06,2,4.556192663162955e-06,0,0
9800,blake,2,3.6729057091646343e-06,2,4.556192663162955e-06,0,0
9804,mariannette,2,3.6729057091646343e-06,2,4.556192663162955e-06,0,0
9826,admired,2,3.6729057091646343e-06,2,4.556192663162955e-06,0,0
9828,odd,2,3.6729057091646343e-06,2,4.556192663162955e-06,0,0
9840,slams,2,3.6729057091646343e-06,2,4.556192663162955e-06,0,0
9841,sore,2,3.6729057091646343e-06,2,4.556192663162955e-06,0,0
9845,lining,2,3.6729057091646343e-06,2,4.556192663162955e-06,0,0
9846,locational,2,3.6729057091646343e-06,2,4.556192663162955e-06,0,0
9847,stopthesteal,2,3.6729057091646343e-06,2,4.556192663162955e-06,0,0
9851,ravaged,2,3.6729057091646343e-06,2,4.556192663162955e-06,0,0
9852,herschel,2,3.6729057091646343e-06,2,4.556192663162955e-06,0,0
9853,downs,2,3.6729057091646343e-06,2,4.556192663162955e-06,0,0
9859,invalid,2,3.6729057091646343e-06,2,4.556192663162955e-06,0,0
9861,senatorial,2,3.6729057091646343e-06,2,4.556192663162955e-06,0,0
9873,carlson,2,3.6729057091646343e-06,2,4.556192663162955e-06,0,0
9875,monologue,2,3.6729057091646343e-06,2,4.556192663162955e-06,0,0
9881,exaggerated,2,3.6729057091646343e-06,2,4.556192663162955e-06,0,0
9887,revered,2,3.6729057091646343e-06,2,4.556192663162955e-06,0,0
9901,perpetrating,2,3.6729057091646343e-06,2,4.556192663162955e-06,0,0
9907,pastors,2,3.6729057091646343e-06,2,4.556192663162955e-06,0,0
9909,daylight,2,3.6729057091646343e-06,2,4.556192663162955e-06,0,0
9913,312000,2,3.6729057091646343e-06,2,4.556192663162955e-06,0,0
9916,slowdown,2,3.6729057091646343e-06,2,4.556192663162955e-06,0,0
9917,chocker,2,3.6729057091646343e-06,2,4.556192663162955e-06,0,0
9930,aspen,2,3.6729057091646343e-06,2,4.556192663162955e-06,0,0
9936,burrs,2,3.6729057091646343e-06,2,4.556192663162955e-06,0,0
9942,33341,2,3.6729057091646343e-06,2,4.556192663162955e-06,0,0
9947,@johnrobertsfox,2,3.6729057091646343e-06,2,4.556192663162955e-06,0,0
9953,themselvesbut,2,3.6729057091646343e-06,2,4.556192663162955e-06,0,0
9951,othersthank,2,3.6729057091646343e-06,2,4.556192663162955e-06,0,0
9952,stan,2,3.6729057091646343e-06,2,4.556192663162955e-06,0,0
9957,kayleigh,2,3.6729057091646343e-06,2,4.556192663162955e-06,0,0
9970,fiercely,2,3.6729057091646343e-06,2,4.556192663162955e-06,0,0
9998,ramp,2,3.6729057091646343e-06,2,4.556192663162955e-06,0,0
10003,@corybooker,2,3.6729057091646343e-06,2,4.556192663162955e-06,0,0
10009,averages,2,3.6729057091646343e-06,2,4.556192663162955e-06,0,0
10008,70000,2,3.6729057091646343e-06,2,4.556192663162955e-06,0,0
10012,meghan,2,3.6729057091646343e-06,2,4.556192663162955e-06,0,0
10022,impeachments,2,3.6729057091646343e-06,2,4.556192663162955e-06,0,0
10020,@senmcsallyaz,2,3.6729057091646343e-06,2,4.556192663162955e-06,0,0
10044,crossfire,2,3.6729057091646343e-06,2,4.556192663162955e-06,0,0
10047,minden,2,3.6729057091646343e-06,2,4.556192663162955e-06,0,0
10051,henderson,2,3.6729057091646343e-06,2,4.556192663162955e-06,0,0
10056,@jackbrewerbsi,2,3.6729057091646343e-06,2,4.556192663162955e-06,0,0
10060,bookers,2,3.6729057091646343e-06,2,4.556192663162955e-06,0,0
10066,6500,2,3.6729057091646343e-06,2,4.556192663162955e-06,0,0
10070,crazies,2,3.6729057091646343e-06,2,4.556192663162955e-06,0,0
10071,flocking,2,3.6729057091646343e-06,2,4.556192663162955e-06,0,0
10072,suburbia,2,3.6729057091646343e-06,2,4.556192663162955e-06,0,0
10082,interruptions,2,3.6729057091646343e-06,2,4.556192663162955e-06,0,0
10085,qs,2,3.6729057091646343e-06,2,4.556192663162955e-06,0,0
10102,alert,2,3.6729057091646343e-06,2,4.556192663162955e-06,0,0
10106,smashing,2,3.6729057091646343e-06,2,4.556192663162955e-06,0,0
10103,deleting,2,3.6729057091646343e-06,2,4.556192663162955e-06,0,0
10118,askin,2,3.6729057091646343e-06,2,4.556192663162955e-06,0,0
10135,دولت,2,3.6729057091646343e-06,2,4.556192663162955e-06,0,0
10132,خواهد,2,3.6729057091646343e-06,2,4.556192663162955e-06,0,0
10142,ما,2,3.6729057091646343e-06,2,4.556192663162955e-06,0,0
10123,اعتراضات,2,3.6729057091646343e-06,2,4.556192663162955e-06,0,0
10154,@rideuta,2,3.6729057091646343e-06,2,4.556192663162955e-06,0,0
10164,@senatorfischer,2,3.6729057091646343e-06,2,4.556192663162955e-06,0,0
10177,massacre,2,3.6729057091646343e-06,2,4.556192663162955e-06,0,0
10182,plummeting,2,3.6729057091646343e-06,2,4.556192663162955e-06,0,0
10187,broadcasting,2,3.6729057091646343e-06,2,4.556192663162955e-06,0,0
10191,honestly,2,3.6729057091646343e-06,2,4.556192663162955e-06,0,0
10201,#usnscomfort,2,3.6729057091646343e-06,2,4.556192663162955e-06,0,0
10204,norfolk,2,3.6729057091646343e-06,2,4.556192663162955e-06,0,0
10209,maintaining,2,3.6729057091646343e-06,2,4.556192663162955e-06,0,0
10213,catanzara,2,3.6729057091646343e-06,2,4.556192663162955e-06,0,0
10224,باید,2,3.6729057091646343e-06,2,4.556192663162955e-06,0,0
10220,اجازه,2,3.6729057091646343e-06,2,4.556192663162955e-06,0,0
10238,نباید,2,3.6729057091646343e-06,2,4.556192663162955e-06,0,0
10247,ی,2,3.6729057091646343e-06,2,4.556192663162955e-06,0,0
10237,معترضان,2,3.6729057091646343e-06,2,4.556192663162955e-06,0,0
10248,یا,2,3.6729057091646343e-06,2,4.556192663162955e-06,0,0
10229,جهان,2,3.6729057091646343e-06,2,4.556192663162955e-06,0,0
10221,این,2,3.6729057091646343e-06,2,4.556192663162955e-06,0,0
10250,petroleum,2,3.6729057091646343e-06,2,4.556192663162955e-06,0,0
10257,shambles,2,3.6729057091646343e-06,2,4.556192663162955e-06,0,0
10258,walsh,2,3.6729057091646343e-06,2,4.556192663162955e-06,0,0
10259,laundering,2,3.6729057091646343e-06,2,4.556192663162955e-06,0,0
10263,revitalize,2,3.6729057091646343e-06,2,4.556192663162955e-06,0,0
10291,entertaining,2,3.6729057091646343e-06,2,4.556192663162955e-06,0,0
10293,knocks,2,3.6729057091646343e-06,2,4.556192663162955e-06,0,0
10297,bragg,2,3.6729057091646343e-06,2,4.556192663162955e-06,0,0
10300,favoring,2,3.6729057091646343e-06,2,4.556192663162955e-06,0,0
10335,هستند,2,3.6729057091646343e-06,2,4.556192663162955e-06,0,0
10326,دست,2,3.6729057091646343e-06,2,4.556192663162955e-06,0,0
10330,رهبران,2,3.6729057091646343e-06,2,4.556192663162955e-06,0,0
10341,کنند,2,3.6729057091646343e-06,2,4.556192663162955e-06,0,0
10346,@pghtransit,2,3.6729057091646343e-06,2,4.556192663162955e-06,0,0
10353,countriescompetitors,2,3.6729057091646343e-06,2,4.556192663162955e-06,0,0
10362,@jimryun,2,3.6729057091646343e-06,2,4.556192663162955e-06,0,0
10374,shouted,2,3.6729057091646343e-06,2,4.556192663162955e-06,0,0
10389,institutes,2,3.6729057091646343e-06,2,4.556192663162955e-06,0,0
10391,sleeps,2,3.6729057091646343e-06,2,4.556192663162955e-06,0,0
10401,taunted,2,3.6729057091646343e-06,2,4.556192663162955e-06,0,0
10411,troubled,2,3.6729057091646343e-06,2,4.556192663162955e-06,0,0
10412,graves,2,3.6729057091646343e-06,2,4.556192663162955e-06,0,0
10415,mighty,2,3.6729057091646343e-06,2,4.556192663162955e-06,0,0
10418,crusade,2,3.6729057091646343e-06,2,4.556192663162955e-06,0,0
10419,#donothingdemocrats,2,3.6729057091646343e-06,2,4.556192663162955e-06,0,0
10443,destined,2,3.6729057091646343e-06,2,4.556192663162955e-06,0,0
10457,unannounced,2,3.6729057091646343e-06,2,4.556192663162955e-06,0,0
10463,@blueangels,2,3.6729057091646343e-06,2,4.556192663162955e-06,0,0
10462,@afthunderbirds,2,3.6729057091646343e-06,2,4.556192663162955e-06,0,0
10465,impulsive,2,3.6729057091646343e-06,2,4.556192663162955e-06,0,0
10476,doomed,2,3.6729057091646343e-06,2,4.556192663162955e-06,0,0
10488,col,2,3.6729057091646343e-06,2,4.556192663162955e-06,0,0
10490,insubordinate,2,3.6729057091646343e-06,2,4.556192663162955e-06,0,0
10489,contents,2,3.6729057091646343e-06,2,4.556192663162955e-06,0,0
10531,carolinas,2,3.6729057091646343e-06,2,4.556192663162955e-06,0,0
10533,@repdebdingell,2,3.6729057091646343e-06,2,4.556192663162955e-06,0,0
10538,attracted,2,3.6729057091646343e-06,2,4.556192663162955e-06,0,0
10547,nielsen,2,3.6729057091646343e-06,2,4.556192663162955e-06,0,0
10549,streaming,2,3.6729057091646343e-06,2,4.556192663162955e-06,0,0
10563,photoshopped,2,3.6729057091646343e-06,2,4.556192663162955e-06,0,0
10568,@trimet,2,3.6729057091646343e-06,2,4.556192663162955e-06,0,0
10574,intl,2,3.6729057091646343e-06,2,4.556192663162955e-06,0,0
10578,buses,2,3.6729057091646343e-06,2,4.556192663162955e-06,0,0
10589,@superbowl,2,3.6729057091646343e-06,2,4.556192663162955e-06,0,0
10590,2900,2,3.6729057091646343e-06,2,4.556192663162955e-06,0,0
10596,lone,2,3.6729057091646343e-06,2,4.556192663162955e-06,0,0
10598,@repdlesko,2,3.6729057091646343e-06,2,4.556192663162955e-06,0,0
10605,cubans,2,3.6729057091646343e-06,2,4.556192663162955e-06,0,0
10612,29000,2,3.6729057091646343e-06,2,4.556192663162955e-06,0,0
10627,long-suffering,2,3.6729057091646343e-06,2,4.556192663162955e-06,0,0
10628,remembering,2,3.6729057091646343e-06,2,4.556192663162955e-06,0,0
10634,10pme,2,3.6729057091646343e-06,2,4.556192663162955e-06,0,0
10642,755,2,3.6729057091646343e-06,2,4.556192663162955e-06,0,0
10650,qassem,2,3.6729057091646343e-06,2,4.556192663162955e-06,0,0
10657,debater,2,3.6729057091646343e-06,2,4.556192663162955e-06,0,0
10660,nobodys,2,3.6729057091646343e-06,2,4.556192663162955e-06,0,0
10658,cheap,2,3.6729057091646343e-06,2,4.556192663162955e-06,0,0
10665,crushed,2,3.6729057091646343e-06,2,4.556192663162955e-06,0,0
10666,unthinkably,2,3.6729057091646343e-06,2,4.556192663162955e-06,0,0
10672,selfish,2,3.6729057091646343e-06,2,4.556192663162955e-06,0,0
10677,@cnns,2,3.6729057091646343e-06,2,4.556192663162955e-06,0,0
10685,villains,2,3.6729057091646343e-06,2,4.556192663162955e-06,0,0
10693,stations,2,3.6729057091646343e-06,2,4.556192663162955e-06,0,0
10704,routes,2,3.6729057091646343e-06,2,4.556192663162955e-06,0,0
10700,@govstitt,2,3.6729057091646343e-06,2,4.556192663162955e-06,0,0
10710,illnesses,2,3.6729057091646343e-06,2,4.556192663162955e-06,0,0
10709,empathy,2,3.6729057091646343e-06,2,4.556192663162955e-06,0,0
10715,uplifted,2,3.6729057091646343e-06,2,4.556192663162955e-06,0,0
10736,trash,2,3.6729057091646343e-06,2,4.556192663162955e-06,0,0
10739,@norahodonnell,2,3.6729057091646343e-06,2,4.556192663162955e-06,0,0
10744,lineup,2,3.6729057091646343e-06,2,4.556192663162955e-06,0,0
10745,252,2,3.6729057091646343e-06,2,4.556192663162955e-06,0,0
10753,complimentary,2,3.6729057091646343e-06,2,4.556192663162955e-06,0,0
10757,pension,2,3.6729057091646343e-06,2,4.556192663162955e-06,0,0
10755,disgust,2,3.6729057091646343e-06,2,4.556192663162955e-06,0,0
10767,scenario,2,3.6729057091646343e-06,2,4.556192663162955e-06,0,0
10781,rescheduling,2,3.6729057091646343e-06,2,4.556192663162955e-06,0,0
10788,medium,2,3.6729057091646343e-06,2,4.556192663162955e-06,0,0
10798,riders,2,3.6729057091646343e-06,2,4.556192663162955e-06,0,0
10803,wp,2,3.6729057091646343e-06,2,4.556192663162955e-06,0,0
10815,imprisoned,2,3.6729057091646343e-06,2,4.556192663162955e-06,0,0
10834,hinson,2,3.6729057091646343e-06,2,4.556192663162955e-06,0,0
10831,@hinsonashley,2,3.6729057091646343e-06,2,4.556192663162955e-06,0,0
10833,farmersa,2,3.6729057091646343e-06,2,4.556192663162955e-06,0,0
10830,#ia01,2,3.6729057091646343e-06,2,4.556192663162955e-06,0,0
10842,goodstein,2,3.6729057091646343e-06,2,4.556192663162955e-06,0,0
10854,curbing,2,3.6729057091646343e-06,2,4.556192663162955e-06,0,0
10860,unleashes,2,3.6729057091646343e-06,2,4.556192663162955e-06,0,0
10862,automobiles,2,3.6729057091646343e-06,2,4.556192663162955e-06,0,0
10868,unprotected,2,3.6729057091646343e-06,2,4.556192663162955e-06,0,0
10876,equipped,2,3.6729057091646343e-06,2,4.556192663162955e-06,0,0
10898,1016,2,3.6729057091646343e-06,2,4.556192663162955e-06,0,0
10899,400pme,2,3.6729057091646343e-06,2,4.556192663162955e-06,0,0
10903,smucker,2,3.6729057091646343e-06,2,4.556192663162955e-06,0,0
10901,@lloydsmuckerpa,2,3.6729057091646343e-06,2,4.556192663162955e-06,0,0
10906,mockery,2,3.6729057091646343e-06,2,4.556192663162955e-06,0,0
10907,keane,2,3.6729057091646343e-06,2,4.556192663162955e-06,0,0
10908,recieve,2,3.6729057091646343e-06,2,4.556192663162955e-06,0,0
10924,grandstanding,2,3.6729057091646343e-06,2,4.556192663162955e-06,0,0
10929,civilized,2,3.6729057091646343e-06,2,4.556192663162955e-06,0,0
10937,39b,2,3.6729057091646343e-06,2,4.556192663162955e-06,0,0
10945,periods,2,3.6729057091646343e-06,2,4.556192663162955e-06,0,0
10950,clicking,2,3.6729057091646343e-06,2,4.556192663162955e-06,0,0
10958,stigma,2,3.6729057091646343e-06,2,4.556192663162955e-06,0,0
10956,attached,2,3.6729057091646343e-06,2,4.556192663162955e-06,0,0
10955,195-0,2,3.6729057091646343e-06,2,4.556192663162955e-06,0,0
10969,smoother,2,3.6729057091646343e-06,2,4.556192663162955e-06,0,0
10974,messner,2,3.6729057091646343e-06,2,4.556192663162955e-06,0,0
10975,910,2,3.6729057091646343e-06,2,4.556192663162955e-06,0,0
10992,ايران,2,3.6729057091646343e-06,2,4.556192663162955e-06,0,0
11000,خود,2,3.6729057091646343e-06,2,4.556192663162955e-06,0,0
11008,متحده,2,3.6729057091646343e-06,2,4.556192663162955e-06,0,0
11007,كنيد,2,3.6729057091646343e-06,2,4.556192663162955e-06,0,0
11016,weber,2,3.6729057091646343e-06,2,4.556192663162955e-06,0,0
11025,serbia,2,3.6729057091646343e-06,2,4.556192663162955e-06,0,0
11029,atkinson,2,3.6729057091646343e-06,2,4.556192663162955e-06,0,0
11038,#covidー19,2,3.6729057091646343e-06,2,4.556192663162955e-06,0,0
11047,lasted,2,3.6729057091646343e-06,2,4.556192663162955e-06,0,0
11055,fish,2,3.6729057091646343e-06,2,4.556192663162955e-06,0,0
11058,pockets,2,3.6729057091646343e-06,2,4.556192663162955e-06,0,0
11072,puppets,2,3.6729057091646343e-06,2,4.556192663162955e-06,0,0
11073,elimination,2,3.6729057091646343e-06,2,4.556192663162955e-06,0,0
11081,outright,2,3.6729057091646343e-06,2,4.556192663162955e-06,0,0
11085,mikes,2,3.6729057091646343e-06,2,4.556192663162955e-06,0,0
11094,cassidy,2,3.6729057091646343e-06,2,4.556192663162955e-06,0,0
11096,cargo,2,3.6729057091646343e-06,2,4.556192663162955e-06,0,0
11101,complainers,2,3.6729057091646343e-06,2,4.556192663162955e-06,0,0
11105,protested,2,3.6729057091646343e-06,2,4.556192663162955e-06,0,0
11107,d-nj,2,3.6729057091646343e-06,2,4.556192663162955e-06,0,0
11108,fracturing,2,3.6729057091646343e-06,2,4.556192663162955e-06,0,0
11110,cordial,2,3.6729057091646343e-06,2,4.556192663162955e-06,0,0
11120,chriss,2,3.6729057091646343e-06,2,4.556192663162955e-06,0,0
11123,katrina,2,3.6729057091646343e-06,2,4.556192663162955e-06,0,0
11124,pam,2,3.6729057091646343e-06,2,4.556192663162955e-06,0,0
11122,bondi,2,3.6729057091646343e-06,2,4.556192663162955e-06,0,0
11126,cubs,2,3.6729057091646343e-06,2,4.556192663162955e-06,0,0
11131,farms,2,3.6729057091646343e-06,2,4.556192663162955e-06,0,0
11135,pulse,2,3.6729057091646343e-06,2,4.556192663162955e-06,0,0
11138,manning,2,3.6729057091646343e-06,2,4.556192663162955e-06,0,0
11145,mud,2,3.6729057091646343e-06,2,4.556192663162955e-06,0,0
11151,idly,2,3.6729057091646343e-06,2,4.556192663162955e-06,0,0
11155,yovanovitch,2,3.6729057091646343e-06,2,4.556192663162955e-06,0,0
11156,28000,2,3.6729057091646343e-06,2,4.556192663162955e-06,0,0
11158,schitt,2,3.6729057091646343e-06,2,4.556192663162955e-06,0,0
11173,تحریم,2,3.6729057091646343e-06,2,4.556192663162955e-06,0,0
11193,ها,2,3.6729057091646343e-06,2,4.556192663162955e-06,0,0
11186,مذاکره,2,3.6729057091646343e-06,2,4.556192663162955e-06,0,0
11165,اما,2,3.6729057091646343e-06,2,4.556192663162955e-06,0,0
11204,dedicate,2,3.6729057091646343e-06,2,4.556192663162955e-06,0,0
11210,website,2,3.6729057091646343e-06,2,4.556192663162955e-06,0,0
11221,@mikeparson,2,3.6729057091646343e-06,2,4.556192663162955e-06,0,0
11220,#mogov,2,3.6729057091646343e-06,2,4.556192663162955e-06,0,0
11222,#mn07,2,3.6729057091646343e-06,2,4.556192663162955e-06,0,0
11228,puzzle,2,3.6729057091646343e-06,2,4.556192663162955e-06,0,0
11230,inspected,2,3.6729057091646343e-06,2,4.556192663162955e-06,0,0
11233,deletion,2,3.6729057091646343e-06,2,4.556192663162955e-06,0,0
11249,prediction,2,3.6729057091646343e-06,2,4.556192663162955e-06,0,0
11254,presided,2,3.6729057091646343e-06,2,4.556192663162955e-06,0,0
11262,outpacing,2,3.6729057091646343e-06,2,4.556192663162955e-06,0,0
11269,rebroadcast,2,3.6729057091646343e-06,2,4.556192663162955e-06,0,0
11273,represenatives,2,3.6729057091646343e-06,2,4.556192663162955e-06,0,0
11274,lifelong,2,3.6729057091646343e-06,2,4.556192663162955e-06,0,0
11282,abbott,2,3.6729057091646343e-06,2,4.556192663162955e-06,0,0
11285,messed,2,3.6729057091646343e-06,2,4.556192663162955e-06,0,0
11292,nullify,2,3.6729057091646343e-06,2,4.556192663162955e-06,0,0
11309,sleazebags,2,3.6729057091646343e-06,2,4.556192663162955e-06,0,0
11311,confused,2,3.6729057091646343e-06,2,4.556192663162955e-06,0,0
11315,denigrate,2,3.6729057091646343e-06,2,4.556192663162955e-06,0,0
11319,#bebest,2,3.6729057091646343e-06,2,4.556192663162955e-06,0,0
11321,floridaand,2,3.6729057091646343e-06,2,4.556192663162955e-06,0,0
11337,physicians,2,3.6729057091646343e-06,2,4.556192663162955e-06,0,0
11340,gonzales,2,3.6729057091646343e-06,2,4.556192663162955e-06,0,0
11347,187,2,3.6729057091646343e-06,2,4.556192663162955e-06,0,0
11348,shattering,2,3.6729057091646343e-06,2,4.556192663162955e-06,0,0
11354,jenkins,2,3.6729057091646343e-06,2,4.556192663162955e-06,0,0
11373,@congressmanjvd,2,3.6729057091646343e-06,2,4.556192663162955e-06,0,0
11374,@scottrtipton,2,3.6729057091646343e-06,2,4.556192663162955e-06,0,0
11377,evangelicals,2,3.6729057091646343e-06,2,4.556192663162955e-06,0,0
11380,arranged,2,3.6729057091646343e-06,2,4.556192663162955e-06,0,0
11385,738,2,3.6729057091646343e-06,2,4.556192663162955e-06,0,0
11386,cadillac,2,3.6729057091646343e-06,2,4.556192663162955e-06,0,0
11391,progressive,2,3.6729057091646343e-06,2,4.556192663162955e-06,0,0
11394,nothings,2,3.6729057091646343e-06,2,4.556192663162955e-06,0,0
11400,@danaperino,2,3.6729057091646343e-06,2,4.556192663162955e-06,0,0
11404,@davos,2,3.6729057091646343e-06,2,4.556192663162955e-06,0,0
11411,sheer,2,3.6729057091646343e-06,2,4.556192663162955e-06,0,0
11424,surveilled,2,3.6729057091646343e-06,2,4.556192663162955e-06,0,0
11426,railroad,2,3.6729057091646343e-06,2,4.556192663162955e-06,0,0
11427,ol,2,3.6729057091646343e-06,2,4.556192663162955e-06,0,0
11430,misquoted,2,3.6729057091646343e-06,2,4.556192663162955e-06,0,0
11462,indicate,2,3.6729057091646343e-06,2,4.556192663162955e-06,0,0
11465,marjorie,2,3.6729057091646343e-06,2,4.556192663162955e-06,0,0
11470,dive,2,3.6729057091646343e-06,2,4.556192663162955e-06,0,0
11473,lengthy,2,3.6729057091646343e-06,2,4.556192663162955e-06,0,0
11476,9-0,2,3.6729057091646343e-06,2,4.556192663162955e-06,0,0
11518,meadows,2,3.6729057091646343e-06,2,4.556192663162955e-06,0,0
11519,dover,2,3.6729057091646343e-06,2,4.556192663162955e-06,0,0
11523,lacks,2,3.6729057091646343e-06,2,4.556192663162955e-06,0,0
11533,benghazi,2,3.6729057091646343e-06,2,4.556192663162955e-06,0,0
11537,beijing,2,3.6729057091646343e-06,2,4.556192663162955e-06,0,0
11545,#ppploan,2,3.6729057091646343e-06,2,4.556192663162955e-06,0,0
11546,attkisson,2,3.6729057091646343e-06,2,4.556192663162955e-06,0,0
11557,hoped,2,3.6729057091646343e-06,2,4.556192663162955e-06,0,0
11569,investigator,2,3.6729057091646343e-06,2,4.556192663162955e-06,0,0
11576,peters,2,3.6729057091646343e-06,2,4.556192663162955e-06,0,0
11582,@repandybiggsaz,2,3.6729057091646343e-06,2,4.556192663162955e-06,0,0
11586,upended,2,3.6729057091646343e-06,2,4.556192663162955e-06,0,0
11596,popping,2,3.6729057091646343e-06,2,4.556192663162955e-06,0,0
11601,devaluing,2,3.6729057091646343e-06,2,4.556192663162955e-06,0,0
11606,presiding,2,3.6729057091646343e-06,2,4.556192663162955e-06,0,0
11618,treasurer,2,3.6729057091646343e-06,2,4.556192663162955e-06,0,0
11620,sword,2,3.6729057091646343e-06,2,4.556192663162955e-06,0,0
11627,resounding,2,3.6729057091646343e-06,2,4.556192663162955e-06,0,0
11635,#trumprally,2,3.6729057091646343e-06,2,4.556192663162955e-06,0,0
11638,spared,2,3.6729057091646343e-06,2,4.556192663162955e-06,0,0
11643,@tomemmer,2,3.6729057091646343e-06,2,4.556192663162955e-06,0,0
11647,northeastern,2,3.6729057091646343e-06,2,4.556192663162955e-06,0,0
11644,#mn08,2,3.6729057091646343e-06,2,4.556192663162955e-06,0,0
11648,caribbean,2,3.6729057091646343e-06,2,4.556192663162955e-06,0,0
11659,grad,2,3.6729057091646343e-06,2,4.556192663162955e-06,0,0
11663,125,2,3.6729057091646343e-06,2,4.556192663162955e-06,0,0
11665,#schoolchoice,2,3.6729057091646343e-06,2,4.556192663162955e-06,0,0
11668,unlock,2,3.6729057091646343e-06,2,4.556192663162955e-06,0,0
11681,distributors,2,3.6729057091646343e-06,2,4.556192663162955e-06,0,0
11688,#mn01,2,3.6729057091646343e-06,2,4.556192663162955e-06,0,0
11697,installs,2,3.6729057091646343e-06,2,4.556192663162955e-06,0,0
11699,bats,2,3.6729057091646343e-06,2,4.556192663162955e-06,0,0
11703,@lyndabennettnc,2,3.6729057091646343e-06,2,4.556192663162955e-06,0,0
11705,safeguard,2,3.6729057091646343e-06,2,4.556192663162955e-06,0,0
11711,relaxing,2,3.6729057091646343e-06,2,4.556192663162955e-06,0,0
11709,gruesome,2,3.6729057091646343e-06,2,4.556192663162955e-06,0,0
11717,gayle,2,3.6729057091646343e-06,2,4.556192663162955e-06,0,0
11718,#mnsen,2,3.6729057091646343e-06,2,4.556192663162955e-06,0,0
11719,@lewisformn,2,3.6729057091646343e-06,2,4.556192663162955e-06,0,0
11720,amendment…,2,3.6729057091646343e-06,2,4.556192663162955e-06,0,0
11725,madeleine,2,3.6729057091646343e-06,2,4.556192663162955e-06,0,0
11726,westerhout,2,3.6729057091646343e-06,2,4.556192663162955e-06,0,0
11727,278m,2,3.6729057091646343e-06,2,4.556192663162955e-06,0,0
11740,texans,2,3.6729057091646343e-06,2,4.556192663162955e-06,0,0
11743,capone,2,3.6729057091646343e-06,2,4.556192663162955e-06,0,0
11750,nashua,2,3.6729057091646343e-06,2,4.556192663162955e-06,0,0
11759,645,2,3.6729057091646343e-06,2,4.556192663162955e-06,0,0
11763,creature,2,3.6729057091646343e-06,2,4.556192663162955e-06,0,0
11783,passengers,2,3.6729057091646343e-06,2,4.556192663162955e-06,0,0
11787,supervision,2,3.6729057091646343e-06,2,4.556192663162955e-06,0,0
11789,teamwork,2,3.6729057091646343e-06,2,4.556192663162955e-06,0,0
11803,tunnel,2,3.6729057091646343e-06,2,4.556192663162955e-06,0,0
11813,buttigieg,2,3.6729057091646343e-06,2,4.556192663162955e-06,0,0
11815,candace,2,3.6729057091646343e-06,2,4.556192663162955e-06,0,0
11823,incumbent,2,3.6729057091646343e-06,2,4.556192663162955e-06,0,0
11852,stir,2,3.6729057091646343e-06,2,4.556192663162955e-06,0,0
11863,chop,2,3.6729057091646343e-06,2,4.556192663162955e-06,0,0
11867,coordinate,2,3.6729057091646343e-06,2,4.556192663162955e-06,0,0
11870,xenophobic,2,3.6729057091646343e-06,2,4.556192663162955e-06,0,0
11872,drooling,2,3.6729057091646343e-06,2,4.556192663162955e-06,0,0
11875,published,2,3.6729057091646343e-06,2,4.556192663162955e-06,0,0
11879,compilation,2,3.6729057091646343e-06,2,4.556192663162955e-06,0,0
11880,puppy,2,3.6729057091646343e-06,2,4.556192663162955e-06,0,0
11881,bounty,2,3.6729057091646343e-06,2,4.556192663162955e-06,0,0
11882,tale,2,3.6729057091646343e-06,2,4.556192663162955e-06,0,0
11885,@jentezen,2,3.6729057091646343e-06,2,4.556192663162955e-06,0,0
11902,@claudiatenney,2,3.6729057091646343e-06,2,4.556192663162955e-06,0,0
11903,impression,2,3.6729057091646343e-06,2,4.556192663162955e-06,0,0
11926,announcements,2,3.6729057091646343e-06,2,4.556192663162955e-06,0,0
11931,chorus,2,3.6729057091646343e-06,2,4.556192663162955e-06,0,0
11952,misses,2,3.6729057091646343e-06,2,4.556192663162955e-06,0,0
11956,blm,2,3.6729057091646343e-06,2,4.556192663162955e-06,0,0
11955,blanket,2,3.6729057091646343e-06,2,4.556192663162955e-06,0,0
11959,fry,2,3.6729057091646343e-06,2,4.556192663162955e-06,0,0
11958,em,2,3.6729057091646343e-06,2,4.556192663162955e-06,0,0
11960,neutralized,2,3.6729057091646343e-06,2,4.556192663162955e-06,0,0
11961,symbol,2,3.6729057091646343e-06,2,4.556192663162955e-06,0,0
11964,precise,2,3.6729057091646343e-06,2,4.556192663162955e-06,0,0
11969,exceeds,2,3.6729057091646343e-06,2,4.556192663162955e-06,0,0
11976,vividly,2,3.6729057091646343e-06,2,4.556192663162955e-06,0,0
11980,25m,2,3.6729057091646343e-06,2,4.556192663162955e-06,0,0
11997,elevated,2,3.6729057091646343e-06,2,4.556192663162955e-06,0,0
12001,yorkers,2,3.6729057091646343e-06,2,4.556192663162955e-06,0,0
12012,tent,2,3.6729057091646343e-06,2,4.556192663162955e-06,0,0
12015,tubes,2,3.6729057091646343e-06,2,4.556192663162955e-06,0,0
12024,facilitate,2,3.6729057091646343e-06,2,4.556192663162955e-06,0,0
12029,broadband,2,3.6729057091646343e-06,2,4.556192663162955e-06,0,0
12036,container,2,3.6729057091646343e-06,2,4.556192663162955e-06,0,0
12042,gardner,2,3.6729057091646343e-06,2,4.556192663162955e-06,0,0
12043,@pulitzerprizes,2,3.6729057091646343e-06,2,4.556192663162955e-06,0,0
12045,pulitzers,2,3.6729057091646343e-06,2,4.556192663162955e-06,0,0
12046,endangered,2,3.6729057091646343e-06,2,4.556192663162955e-06,0,0
12066,unwarranted,2,3.6729057091646343e-06,2,4.556192663162955e-06,0,0
12065,tarnished,2,3.6729057091646343e-06,2,4.556192663162955e-06,0,0
12070,churchill,2,3.6729057091646343e-06,2,4.556192663162955e-06,0,0
12088,obamasleepy,2,3.6729057091646343e-06,2,4.556192663162955e-06,0,0
12120,identify,2,3.6729057091646343e-06,2,4.556192663162955e-06,0,0
12144,widen,2,3.6729057091646343e-06,2,4.556192663162955e-06,0,0
12142,ky,2,3.6729057091646343e-06,2,4.556192663162955e-06,0,0
12146,wthe,2,3.6729057091646343e-06,2,4.556192663162955e-06,0,0
12148,jodey,2,3.6729057091646343e-06,2,4.556192663162955e-06,0,0
12159,@tommcclintock,2,3.6729057091646343e-06,2,4.556192663162955e-06,0,0
12160,930,2,3.6729057091646343e-06,2,4.556192663162955e-06,0,0
12168,louie,2,3.6729057091646343e-06,2,4.556192663162955e-06,0,0
12183,untold,2,3.6729057091646343e-06,2,4.556192663162955e-06,0,0
12182,talkers,2,3.6729057091646343e-06,2,4.556192663162955e-06,0,0
12191,socialized,2,3.6729057091646343e-06,2,4.556192663162955e-06,0,0
12199,platforms,2,3.6729057091646343e-06,2,4.556192663162955e-06,0,0
12200,regulate,2,3.6729057091646343e-06,2,4.556192663162955e-06,0,0
12205,withheld,2,3.6729057091646343e-06,2,4.556192663162955e-06,0,0
12210,rivals,2,3.6729057091646343e-06,2,4.556192663162955e-06,0,0
12217,mediate,2,3.6729057091646343e-06,2,4.556192663162955e-06,0,0
12238,eli,2,3.6729057091646343e-06,2,4.556192663162955e-06,0,0
12245,@stevenmnuchin1,2,3.6729057091646343e-06,2,4.556192663162955e-06,0,0
12244,3400,2,3.6729057091646343e-06,2,4.556192663162955e-06,0,0
12247,niece,2,3.6729057091646343e-06,2,4.556192663162955e-06,0,0
12256,unrelenting,2,3.6729057091646343e-06,2,4.556192663162955e-06,0,0
12257,marshall,2,3.6729057091646343e-06,2,4.556192663162955e-06,0,0
12263,stall,2,3.6729057091646343e-06,2,4.556192663162955e-06,0,0
12267,@karlrove,2,3.6729057091646343e-06,2,4.556192663162955e-06,0,0
12270,9000,2,3.6729057091646343e-06,2,4.556192663162955e-06,0,0
12278,slight,2,3.6729057091646343e-06,2,4.556192663162955e-06,0,0
12284,@danforrest,2,3.6729057091646343e-06,2,4.556192663162955e-06,0,0
12300,seemed,2,3.6729057091646343e-06,2,4.556192663162955e-06,0,0
12293,emerges,2,3.6729057091646343e-06,2,4.556192663162955e-06,0,0
12305,bynum,2,3.6729057091646343e-06,2,4.556192663162955e-06,0,0
12306,curfew,2,3.6729057091646343e-06,2,4.556192663162955e-06,0,0
12317,@arifleischer,2,3.6729057091646343e-06,2,4.556192663162955e-06,0,0
12326,@scotttaylorva,2,3.6729057091646343e-06,2,4.556192663162955e-06,0,0
12325,#va02,2,3.6729057091646343e-06,2,4.556192663162955e-06,0,0
12329,@kellyannepolls,2,3.6729057091646343e-06,2,4.556192663162955e-06,0,0
12333,expedite,2,3.6729057091646343e-06,2,4.556192663162955e-06,0,0
12342,@spacex,2,3.6729057091646343e-06,2,4.556192663162955e-06,0,0
12345,underserved,2,3.6729057091646343e-06,2,4.556192663162955e-06,0,0
12348,contain,2,3.6729057091646343e-06,2,4.556192663162955e-06,0,0
12357,demolition,2,3.6729057091646343e-06,2,4.556192663162955e-06,0,0
12360,trounced,2,3.6729057091646343e-06,2,4.556192663162955e-06,0,0
12364,felony,2,3.6729057091646343e-06,2,4.556192663162955e-06,0,0
12365,confusion,2,3.6729057091646343e-06,2,4.556192663162955e-06,0,0
12387,@corygardner,2,3.6729057091646343e-06,2,4.556192663162955e-06,0,0
12391,bullock,2,3.6729057091646343e-06,2,4.556192663162955e-06,0,0
12393,#nypd,2,3.6729057091646343e-06,2,4.556192663162955e-06,0,0
12394,bailed,2,3.6729057091646343e-06,2,4.556192663162955e-06,0,0
12397,unexpected,2,3.6729057091646343e-06,2,4.556192663162955e-06,0,0
12403,rebuked,2,3.6729057091646343e-06,2,4.556192663162955e-06,0,0
12406,itbut,2,3.6729057091646343e-06,2,4.556192663162955e-06,0,0
12411,venues,2,3.6729057091646343e-06,2,4.556192663162955e-06,0,0
12421,wesley,2,3.6729057091646343e-06,2,4.556192663162955e-06,0,0
12424,behave,2,3.6729057091646343e-06,2,4.556192663162955e-06,0,0
12441,hagan,2,3.6729057091646343e-06,2,4.556192663162955e-06,0,0
12450,assassination,2,3.6729057091646343e-06,2,4.556192663162955e-06,0,0
12455,huber,2,3.6729057091646343e-06,2,4.556192663162955e-06,0,0
12459,promptly,2,3.6729057091646343e-06,2,4.556192663162955e-06,0,0
12461,251,2,3.6729057091646343e-06,2,4.556192663162955e-06,0,0
12462,additions,2,3.6729057091646343e-06,2,4.556192663162955e-06,0,0
12463,bounceback,2,3.6729057091646343e-06,2,4.556192663162955e-06,0,0
12467,@ajitpaifcc,2,3.6729057091646343e-06,2,4.556192663162955e-06,0,0
12468,delaware,2,3.6729057091646343e-06,2,4.556192663162955e-06,0,0
12477,dawn,2,3.6729057091646343e-06,2,4.556192663162955e-06,0,0
12489,fondest,2,3.6729057091646343e-06,2,4.556192663162955e-06,0,0
12497,sympathy,2,3.6729057091646343e-06,2,4.556192663162955e-06,0,0
12499,@governorkayivey,2,3.6729057091646343e-06,2,4.556192663162955e-06,0,0
12502,caller,2,3.6729057091646343e-06,2,4.556192663162955e-06,0,0
12504,marches,2,3.6729057091646343e-06,2,4.556192663162955e-06,0,0
12522,usually,2,3.6729057091646343e-06,2,4.556192663162955e-06,0,0
12526,riot,2,3.6729057091646343e-06,2,4.556192663162955e-06,0,0
12545,@markwaynemullin,2,3.6729057091646343e-06,2,4.556192663162955e-06,0,0
12547,fawning,2,3.6729057091646343e-06,2,4.556192663162955e-06,0,0
12552,cole,2,3.6729057091646343e-06,2,4.556192663162955e-06,0,0
12561,populated,2,3.6729057091646343e-06,2,4.556192663162955e-06,0,0
12572,inhofe,2,3.6729057091646343e-06,2,4.556192663162955e-06,0,0
12588,labs,2,3.6729057091646343e-06,2,4.556192663162955e-06,0,0
12606,tds,2,3.6729057091646343e-06,2,4.556192663162955e-06,0,0
12608,hal,2,3.6729057091646343e-06,2,4.556192663162955e-06,0,0
12609,rogers,2,3.6729057091646343e-06,2,4.556192663162955e-06,0,0
12613,prosperityor,2,3.6729057091646343e-06,2,4.556192663162955e-06,0,0
12628,sequester,2,3.6729057091646343e-06,2,4.556192663162955e-06,0,0
12627,oversaw,2,3.6729057091646343e-06,2,4.556192663162955e-06,0,0
12630,criticizing,2,3.6729057091646343e-06,2,4.556192663162955e-06,0,0
12639,mack,2,3.6729057091646343e-06,2,4.556192663162955e-06,0,0
12638,@lelandvittert,2,3.6729057091646343e-06,2,4.556192663162955e-06,0,0
12652,defame,2,3.6729057091646343e-06,2,4.556192663162955e-06,0,0
12654,adrian,2,3.6729057091646343e-06,2,4.556192663162955e-06,0,0
12660,powmia,2,3.6729057091646343e-06,2,4.556192663162955e-06,0,0
12682,lafayette,2,3.6729057091646343e-06,2,4.556192663162955e-06,0,0
12683,preservation,2,3.6729057091646343e-06,2,4.556192663162955e-06,0,0
12687,resident,2,3.6729057091646343e-06,2,4.556192663162955e-06,0,0
12691,beret,2,3.6729057091646343e-06,2,4.556192663162955e-06,0,0
12706,seized,2,3.6729057091646343e-06,2,4.556192663162955e-06,0,0
12704,pardoning,2,3.6729057091646343e-06,2,4.556192663162955e-06,0,0
12712,fold,2,3.6729057091646343e-06,2,4.556192663162955e-06,0,0
12737,backfired,2,3.6729057091646343e-06,2,4.556192663162955e-06,0,0
12742,rebuke,2,3.6729057091646343e-06,2,4.556192663162955e-06,0,0
12745,sullivan,2,3.6729057091646343e-06,2,4.556192663162955e-06,0,0
12744,pro-jobs,2,3.6729057091646343e-06,2,4.556192663162955e-06,0,0
12746,@buddycarter,2,3.6729057091646343e-06,2,4.556192663162955e-06,0,0
12749,@denver4va,2,3.6729057091646343e-06,2,4.556192663162955e-06,0,0
12751,@grangercampaign,2,3.6729057091646343e-06,2,4.556192663162955e-06,0,0
12756,bolivia,2,3.6729057091646343e-06,2,4.556192663162955e-06,0,0
12758,provoke,2,3.6729057091646343e-06,2,4.556192663162955e-06,0,0
12760,offenses,2,3.6729057091646343e-06,2,4.556192663162955e-06,0,0
12766,conspire,2,3.6729057091646343e-06,2,4.556192663162955e-06,0,0
12771,towering,2,3.6729057091646343e-06,2,4.556192663162955e-06,0,0
12769,intellect,2,3.6729057091646343e-06,2,4.556192663162955e-06,0,0
12770,sterling,2,3.6729057091646343e-06,2,4.556192663162955e-06,0,0
12776,pharmaceutical,2,3.6729057091646343e-06,2,4.556192663162955e-06,0,0
12781,zoom,2,3.6729057091646343e-06,2,4.556192663162955e-06,0,0
12783,scams,2,3.6729057091646343e-06,2,4.556192663162955e-06,0,0
12793,intimidated,2,3.6729057091646343e-06,2,4.556192663162955e-06,0,0
12795,whining,2,3.6729057091646343e-06,2,4.556192663162955e-06,0,0
12799,bader,2,3.6729057091646343e-06,2,4.556192663162955e-06,0,0
12800,ginsburg,2,3.6729057091646343e-06,2,4.556192663162955e-06,0,0
12803,himand,2,3.6729057091646343e-06,2,4.556192663162955e-06,0,0
12805,unpardonable,2,3.6729057091646343e-06,2,4.556192663162955e-06,0,0
12804,sins,2,3.6729057091646343e-06,2,4.556192663162955e-06,0,0
12807,apoplectic,2,3.6729057091646343e-06,2,4.556192663162955e-06,0,0
12810,cheatin,2,3.6729057091646343e-06,2,4.556192663162955e-06,0,0
12831,ashame,2,3.6729057091646343e-06,2,4.556192663162955e-06,0,0
12839,philanthropist,2,3.6729057091646343e-06,2,4.556192663162955e-06,0,0
12837,distracted,2,3.6729057091646343e-06,2,4.556192663162955e-06,0,0
12835,appeared,2,3.6729057091646343e-06,2,4.556192663162955e-06,0,0
12834,also@dcexaminer,2,3.6729057091646343e-06,2,4.556192663162955e-06,0,0
12840,quietly,2,3.6729057091646343e-06,2,4.556192663162955e-06,0,0
12841,naturally,2,3.6729057091646343e-06,2,4.556192663162955e-06,0,0
12849,collection,2,3.6729057091646343e-06,2,4.556192663162955e-06,0,0
12854,instincts,2,3.6729057091646343e-06,2,4.556192663162955e-06,0,0
12860,manipulating,2,3.6729057091646343e-06,2,4.556192663162955e-06,0,0
12859,brazen,2,3.6729057091646343e-06,2,4.556192663162955e-06,0,0
12861,employ,2,3.6729057091646343e-06,2,4.556192663162955e-06,0,0
12873,ballgame,2,3.6729057091646343e-06,2,4.556192663162955e-06,0,0
12881,lous,2,3.6729057091646343e-06,2,4.556192663162955e-06,0,0
12884,roving,2,3.6729057091646343e-06,2,4.556192663162955e-06,0,0
12883,indiscriminately,2,3.6729057091646343e-06,2,4.556192663162955e-06,0,0
12890,estimate,2,3.6729057091646343e-06,2,4.556192663162955e-06,0,0
12893,bounds,2,3.6729057091646343e-06,2,4.556192663162955e-06,0,0
12910,@donaldjtrumpjr,2,3.6729057091646343e-06,2,4.556192663162955e-06,0,0
12911,depreciation,2,3.6729057091646343e-06,2,4.556192663162955e-06,0,0
12917,tesla,2,3.6729057091646343e-06,2,4.556192663162955e-06,0,0
12918,carly,2,3.6729057091646343e-06,2,4.556192663162955e-06,0,0
12919,fiorina,2,3.6729057091646343e-06,2,4.556192663162955e-06,0,0
12929,stumbling,2,3.6729057091646343e-06,2,4.556192663162955e-06,0,0
12941,spell,2,3.6729057091646343e-06,2,4.556192663162955e-06,0,0
12950,mixing,2,3.6729057091646343e-06,2,4.556192663162955e-06,0,0
12952,co-chair,2,3.6729057091646343e-06,2,4.556192663162955e-06,0,0
12954,engaging,2,3.6729057091646343e-06,2,4.556192663162955e-06,0,0
12955,fatality,2,3.6729057091646343e-06,2,4.556192663162955e-06,0,0
12957,vengeance,2,3.6729057091646343e-06,2,4.556192663162955e-06,0,0
12966,russia-trump,2,3.6729057091646343e-06,2,4.556192663162955e-06,0,0
12973,شود,2,3.6729057091646343e-06,2,4.556192663162955e-06,0,0
12987,ramifications,2,3.6729057091646343e-06,2,4.556192663162955e-06,0,0
12988,appalled,2,3.6729057091646343e-06,2,4.556192663162955e-06,0,0
13004,chera,2,3.6729057091646343e-06,2,4.556192663162955e-06,0,0
13003,charitable,2,3.6729057091646343e-06,2,4.556192663162955e-06,0,0
13008,ink,2,3.6729057091646343e-06,2,4.556192663162955e-06,0,0
13012,daniels,2,3.6729057091646343e-06,2,4.556192663162955e-06,0,0
13019,@politico,2,3.6729057091646343e-06,2,4.556192663162955e-06,0,0
13026,memorials,2,3.6729057091646343e-06,2,4.556192663162955e-06,0,0
13025,combatting,2,3.6729057091646343e-06,2,4.556192663162955e-06,0,0
13035,majestic,2,3.6729057091646343e-06,2,4.556192663162955e-06,0,0
13051,looted,2,3.6729057091646343e-06,2,4.556192663162955e-06,0,0
13057,huma,2,3.6729057091646343e-06,2,4.556192663162955e-06,0,0
13053,abedin,2,3.6729057091646343e-06,2,4.556192663162955e-06,0,0
13078,insist,2,3.6729057091646343e-06,2,4.556192663162955e-06,0,0
13077,injury,2,3.6729057091646343e-06,2,4.556192663162955e-06,0,0
13082,@secshulkin,2,3.6729057091646343e-06,2,4.556192663162955e-06,0,0
13092,oclock,2,3.6729057091646343e-06,2,4.556192663162955e-06,0,0
13093,asman,2,3.6729057091646343e-06,2,4.556192663162955e-06,0,0
13101,jesus,2,3.6729057091646343e-06,2,4.556192663162955e-06,0,0
13105,saints,2,3.6729057091646343e-06,2,4.556192663162955e-06,0,0
13110,methods,2,3.6729057091646343e-06,2,4.556192663162955e-06,0,0
13142,mutiny,2,3.6729057091646343e-06,2,4.556192663162955e-06,0,0
13147,flames,2,3.6729057091646343e-06,2,4.556192663162955e-06,0,0
13156,mere,2,3.6729057091646343e-06,2,4.556192663162955e-06,0,0
13158,toast,2,3.6729057091646343e-06,2,4.556192663162955e-06,0,0
13168,99th,2,3.6729057091646343e-06,2,4.556192663162955e-06,0,0
13175,20000000,2,3.6729057091646343e-06,2,4.556192663162955e-06,0,0
13176,#lawenforcementappreciationday,2,3.6729057091646343e-06,2,4.556192663162955e-06,0,0
13180,redesignates,2,3.6729057091646343e-06,2,4.556192663162955e-06,0,0
13192,disproportionate,2,3.6729057091646343e-06,2,4.556192663162955e-06,0,0
13196,targets,2,3.6729057091646343e-06,2,4.556192663162955e-06,0,0
13199,dismantled,2,3.6729057091646343e-06,2,4.556192663162955e-06,0,0
13202,plotting,2,3.6729057091646343e-06,2,4.556192663162955e-06,0,0
13212,steinbrenner,2,3.6729057091646343e-06,2,4.556192663162955e-06,0,0
13213,indias,2,3.6729057091646343e-06,2,4.556192663162955e-06,0,0
13218,45000000,2,3.6729057091646343e-06,2,4.556192663162955e-06,0,0
13227,sleepyeyes,2,3.6729057091646343e-06,2,4.556192663162955e-06,0,0
13228,execs,2,3.6729057091646343e-06,2,4.556192663162955e-06,0,0
13235,deliveries,2,3.6729057091646343e-06,2,4.556192663162955e-06,0,0
13247,affirming,2,3.6729057091646343e-06,2,4.556192663162955e-06,0,0
13251,ate,2,3.6729057091646343e-06,2,4.556192663162955e-06,0,0
13253,chinatown,2,3.6729057091646343e-06,2,4.556192663162955e-06,0,0
13255,nh,2,3.6729057091646343e-06,2,4.556192663162955e-06,0,0
13258,kobe,2,3.6729057091646343e-06,2,4.556192663162955e-06,0,0
13261,vandalize,2,3.6729057091646343e-06,2,4.556192663162955e-06,0,0
13268,firsthand,2,3.6729057091646343e-06,2,4.556192663162955e-06,0,0
13269,baptist,2,3.6729057091646343e-06,2,4.556192663162955e-06,0,0
13273,sympathizers,2,3.6729057091646343e-06,2,4.556192663162955e-06,0,0
13278,globally,2,3.6729057091646343e-06,2,4.556192663162955e-06,0,0
13279,hoover,2,3.6729057091646343e-06,2,4.556192663162955e-06,0,0
13300,harmful,2,3.6729057091646343e-06,2,4.556192663162955e-06,0,0
13303,sex,2,3.6729057091646343e-06,2,4.556192663162955e-06,0,0
13301,ideologies,2,3.6729057091646343e-06,2,4.556192663162955e-06,0,0
13306,tires,2,3.6729057091646343e-06,2,4.556192663162955e-06,0,0
13307,pleading,2,3.6729057091646343e-06,2,4.556192663162955e-06,0,0
13315,tropical,2,3.6729057091646343e-06,2,4.556192663162955e-06,0,0
13313,portsmouth,2,3.6729057091646343e-06,2,4.556192663162955e-06,0,0
13317,standby,2,3.6729057091646343e-06,2,4.556192663162955e-06,0,0
13319,domination,2,3.6729057091646343e-06,2,4.556192663162955e-06,0,0
13334,untalented,2,3.6729057091646343e-06,2,4.556192663162955e-06,0,0
13332,muslim,2,3.6729057091646343e-06,2,4.556192663162955e-06,0,0
13345,russ,2,3.6729057091646343e-06,2,4.556192663162955e-06,0,0
13346,@goyafoods,2,3.6729057091646343e-06,2,4.556192663162955e-06,0,0
13355,dusty,2,3.6729057091646343e-06,2,4.556192663162955e-06,0,0
13359,vessel,2,3.6729057091646343e-06,2,4.556192663162955e-06,0,0
13358,transform,2,3.6729057091646343e-06,2,4.556192663162955e-06,0,0
13389,restart,2,3.6729057091646343e-06,2,4.556192663162955e-06,0,0
13406,surrounded,2,3.6729057091646343e-06,2,4.556192663162955e-06,0,0
13403,chess,2,3.6729057091646343e-06,2,4.556192663162955e-06,0,0
13405,scattered,2,3.6729057091646343e-06,2,4.556192663162955e-06,0,0
13409,hoodlums,2,3.6729057091646343e-06,2,4.556192663162955e-06,0,0
13422,operatives,2,3.6729057091646343e-06,2,4.556192663162955e-06,0,0
13430,tha,2,3.6729057091646343e-06,2,4.556192663162955e-06,0,0
13432,@ncgovernor,2,3.6729057091646343e-06,2,4.556192663162955e-06,0,0
13441,wilmington,2,3.6729057091646343e-06,2,4.556192663162955e-06,0,0
13451,tracey,2,3.6729057091646343e-06,2,4.556192663162955e-06,0,0
13468,हैं,2,3.6729057091646343e-06,2,4.556192663162955e-06,0,0
13461,में,2,3.6729057091646343e-06,2,4.556192663162955e-06,0,0
13466,ही,2,3.6729057091646343e-06,2,4.556192663162955e-06,0,0
13495,मैं,2,3.6729057091646343e-06,2,4.556192663162955e-06,0,0
13492,प्रेम,2,3.6729057091646343e-06,2,4.556192663162955e-06,0,0
13481,करता,2,3.6729057091646343e-06,2,4.556192663162955e-06,0,0
13506,है,2,3.6729057091646343e-06,2,4.556192663162955e-06,0,0
13500,लोगों,2,3.6729057091646343e-06,2,4.556192663162955e-06,0,0
13507,#co03,2,3.6729057091646343e-06,2,4.556192663162955e-06,0,0
13513,diana,2,3.6729057091646343e-06,2,4.556192663162955e-06,0,0
13517,fitzgerald,2,3.6729057091646343e-06,2,4.556192663162955e-06,0,0
13521,अपने,2,3.6729057091646343e-06,2,4.556192663162955e-06,0,0
13540,perform,2,3.6729057091646343e-06,2,4.556192663162955e-06,0,0
13542,constitutions,2,3.6729057091646343e-06,2,4.556192663162955e-06,0,0
13545,अपनी,2,3.6729057091646343e-06,2,4.556192663162955e-06,0,0
13563,depravity,2,3.6729057091646343e-06,2,4.556192663162955e-06,0,0
13568,ill-equipped,2,3.6729057091646343e-06,2,4.556192663162955e-06,0,0
13573,remedy,2,3.6729057091646343e-06,2,4.556192663162955e-06,0,0
13579,commonly,2,3.6729057091646343e-06,2,4.556192663162955e-06,0,0
13580,items,2,3.6729057091646343e-06,2,4.556192663162955e-06,0,0
13584,criticizes,2,3.6729057091646343e-06,2,4.556192663162955e-06,0,0
13588,explosive,2,3.6729057091646343e-06,2,4.556192663162955e-06,0,0
13593,tricky,2,3.6729057091646343e-06,2,4.556192663162955e-06,0,0
13600,relevant,2,3.6729057091646343e-06,2,4.556192663162955e-06,0,0
13604,undercover,2,3.6729057091646343e-06,2,4.556192663162955e-06,0,0
13605,cutting-edge,2,3.6729057091646343e-06,2,4.556192663162955e-06,0,0
13628,240,2,3.6729057091646343e-06,2,4.556192663162955e-06,0,0
13649,1030am,2,3.6729057091646343e-06,2,4.556192663162955e-06,0,0
13652,@danawhite,2,3.6729057091646343e-06,2,4.556192663162955e-06,0,0
13662,@realktmcfarland,2,3.6729057091646343e-06,2,4.556192663162955e-06,0,0
13663,jefferson,2,3.6729057091646343e-06,2,4.556192663162955e-06,0,0
13668,@afacademy,2,3.6729057091646343e-06,2,4.556192663162955e-06,0,0
13671,airplane,2,3.6729057091646343e-06,2,4.556192663162955e-06,0,0
13672,grabs,2,3.6729057091646343e-06,2,4.556192663162955e-06,0,0
13673,shakes,2,3.6729057091646343e-06,2,4.556192663162955e-06,0,0
13675,touches,2,3.6729057091646343e-06,2,4.556192663162955e-06,0,0
13677,gianni,2,3.6729057091646343e-06,2,4.556192663162955e-06,0,0
13682,spelled,2,3.6729057091646343e-06,2,4.556192663162955e-06,0,0
13686,steroids,2,3.6729057091646343e-06,2,4.556192663162955e-06,0,0
13688,overstated,2,3.6729057091646343e-06,2,4.556192663162955e-06,0,0
13694,faker,2,3.6729057091646343e-06,2,4.556192663162955e-06,0,0
13696,recuse,2,3.6729057091646343e-06,2,4.556192663162955e-06,0,0
13697,lovingly,2,3.6729057091646343e-06,2,4.556192663162955e-06,0,0
13717,inherently,2,3.6729057091646343e-06,2,4.556192663162955e-06,0,0
13725,carson,2,3.6729057091646343e-06,2,4.556192663162955e-06,0,0
13727,reign,2,3.6729057091646343e-06,2,4.556192663162955e-06,0,0
13735,barry,2,3.6729057091646343e-06,2,4.556192663162955e-06,0,0
13752,84,2,3.6729057091646343e-06,2,4.556192663162955e-06,0,0
13757,advantages,2,3.6729057091646343e-06,2,4.556192663162955e-06,0,0
13762,@predsednikrs,2,3.6729057091646343e-06,2,4.556192663162955e-06,0,0
13764,vucic,2,3.6729057091646343e-06,2,4.556192663162955e-06,0,0
13778,doctored,2,3.6729057091646343e-06,2,4.556192663162955e-06,0,0
13786,circle,2,3.6729057091646343e-06,2,4.556192663162955e-06,0,0
13789,lightweights,2,3.6729057091646343e-06,2,4.556192663162955e-06,0,0
13787,coons,2,3.6729057091646343e-06,2,4.556192663162955e-06,0,0
13795,adversary,2,3.6729057091646343e-06,2,4.556192663162955e-06,0,0
13801,pro-worker,2,3.6729057091646343e-06,2,4.556192663162955e-06,0,0
13805,chang,2,3.6729057091646343e-06,2,4.556192663162955e-06,0,0
13808,goldberg,2,3.6729057091646343e-06,2,4.556192663162955e-06,0,0
13813,risch,2,3.6729057091646343e-06,2,4.556192663162955e-06,0,0
13816,slaughtered,2,3.6729057091646343e-06,2,4.556192663162955e-06,0,0
13825,comrades,2,3.6729057091646343e-06,2,4.556192663162955e-06,0,0
13833,smearing,2,3.6729057091646343e-06,2,4.556192663162955e-06,0,0
13841,understatement,2,3.6729057091646343e-06,2,4.556192663162955e-06,0,0
13848,reviewed,2,3.6729057091646343e-06,2,4.556192663162955e-06,0,0
13847,pact,2,3.6729057091646343e-06,2,4.556192663162955e-06,0,0
13849,purge,2,3.6729057091646343e-06,2,4.556192663162955e-06,0,0
13852,88,2,3.6729057091646343e-06,2,4.556192663162955e-06,0,0
13856,slimeball,2,3.6729057091646343e-06,2,4.556192663162955e-06,0,0
13858,@repthomasmassie,2,3.6729057091646343e-06,2,4.556192663162955e-06,0,0
13864,byron,2,3.6729057091646343e-06,2,4.556192663162955e-06,0,0
13869,execution,2,3.6729057091646343e-06,2,4.556192663162955e-06,0,0
13870,@ford,2,3.6729057091646343e-06,2,4.556192663162955e-06,0,0
13882,سه,2,3.6729057091646343e-06,2,4.556192663162955e-06,0,0
13889,نفر,2,3.6729057091646343e-06,2,4.556192663162955e-06,0,0
13875,اعدام,2,3.6729057091646343e-06,2,4.556192663162955e-06,0,0
13893,purchased,2,3.6729057091646343e-06,2,4.556192663162955e-06,0,0
13925,enterprise,2,3.6729057091646343e-06,2,4.556192663162955e-06,0,0
13930,170,2,3.6729057091646343e-06,2,4.556192663162955e-06,0,0
13935,bennett,2,3.6729057091646343e-06,2,4.556192663162955e-06,0,0
13937,airspace,2,3.6729057091646343e-06,2,4.556192663162955e-06,0,0
13941,everwe,2,3.6729057091646343e-06,2,4.556192663162955e-06,0,0
13943,appreciative,2,3.6729057091646343e-06,2,4.556192663162955e-06,0,0
13947,gretchen,2,3.6729057091646343e-06,2,4.556192663162955e-06,0,0
13951,roadmap,2,3.6729057091646343e-06,2,4.556192663162955e-06,0,0
13991,mongering,2,3.6729057091646343e-06,2,4.556192663162955e-06,0,0
14001,davidson,2,3.6729057091646343e-06,2,4.556192663162955e-06,0,0
14010,split,2,3.6729057091646343e-06,2,4.556192663162955e-06,0,0
14018,contribute,2,3.6729057091646343e-06,2,4.556192663162955e-06,0,0
14029,sammys,2,3.6729057091646343e-06,2,4.556192663162955e-06,0,0
14035,@comcast,2,3.6729057091646343e-06,2,4.556192663162955e-06,0,0
14045,equador,2,3.6729057091646343e-06,2,4.556192663162955e-06,0,0
14052,evers,2,3.6729057091646343e-06,2,4.556192663162955e-06,0,0
14053,bukele,2,3.6729057091646343e-06,2,4.556192663162955e-06,0,0
14063,@kayleighmcenany,2,3.6729057091646343e-06,2,4.556192663162955e-06,0,0
14066,presides,2,3.6729057091646343e-06,2,4.556192663162955e-06,0,0
14072,weakly,2,3.6729057091646343e-06,2,4.556192663162955e-06,0,0
14076,wolves,2,3.6729057091646343e-06,2,4.556192663162955e-06,0,0
14077,socially,2,3.6729057091646343e-06,2,4.556192663162955e-06,0,0
14078,sarcastic,2,3.6729057091646343e-06,2,4.556192663162955e-06,0,0
14081,modern-day,2,3.6729057091646343e-06,2,4.556192663162955e-06,0,0
14084,@djohnsonpga,2,3.6729057091646343e-06,2,4.556192663162955e-06,0,0
14110,ethiopia,2,3.6729057091646343e-06,2,4.556192663162955e-06,0,0
14116,fearless,2,3.6729057091646343e-06,2,4.556192663162955e-06,0,0
14119,birx,2,3.6729057091646343e-06,2,4.556192663162955e-06,0,0
14128,@stpatsnyc,2,3.6729057091646343e-06,2,4.556192663162955e-06,0,0
14138,diet,2,3.6729057091646343e-06,2,4.556192663162955e-06,0,0
14137,coke,2,3.6729057091646343e-06,2,4.556192663162955e-06,0,0
14136,bedroom,2,3.6729057091646343e-06,2,4.556192663162955e-06,0,0
14143,ideally,2,3.6729057091646343e-06,2,4.556192663162955e-06,0,0
14147,suggestion,2,3.6729057091646343e-06,2,4.556192663162955e-06,0,0
14148,brees,2,3.6729057091646343e-06,2,4.556192663162955e-06,0,0
14152,org,2,3.6729057091646343e-06,2,4.556192663162955e-06,0,0
14153,1972,2,3.6729057091646343e-06,2,4.556192663162955e-06,0,0
14159,qualities,2,3.6729057091646343e-06,2,4.556192663162955e-06,0,0
14162,utter,2,3.6729057091646343e-06,2,4.556192663162955e-06,0,0
14171,hickenlooper,2,3.6729057091646343e-06,2,4.556192663162955e-06,0,0
14176,pulls,2,3.6729057091646343e-06,2,4.556192663162955e-06,0,0
14178,ridge,2,3.6729057091646343e-06,2,4.556192663162955e-06,0,0
14181,computers,2,3.6729057091646343e-06,2,4.556192663162955e-06,0,0
14184,ryun,2,3.6729057091646343e-06,2,4.556192663162955e-06,0,0
14191,466,2,3.6729057091646343e-06,2,4.556192663162955e-06,0,0
14197,registrations,2,3.6729057091646343e-06,2,4.556192663162955e-06,0,0
14195,bounces,2,3.6729057091646343e-06,2,4.556192663162955e-06,0,0
14204,suggestions,2,3.6729057091646343e-06,2,4.556192663162955e-06,0,0
14206,clarified,2,3.6729057091646343e-06,2,4.556192663162955e-06,0,0
14210,diamond,2,3.6729057091646343e-06,2,4.556192663162955e-06,0,0
14211,silk,2,3.6729057091646343e-06,2,4.556192663162955e-06,0,0
14223,softballs,2,3.6729057091646343e-06,2,4.556192663162955e-06,0,0
14228,withdrawing,2,3.6729057091646343e-06,2,4.556192663162955e-06,0,0
14240,landfall,2,3.6729057091646343e-06,2,4.556192663162955e-06,0,0
14243,colonel,2,3.6729057091646343e-06,2,4.556192663162955e-06,0,0
14254,@carolmillerwv,2,3.6729057091646343e-06,2,4.556192663162955e-06,0,0
14274,intimating,2,3.6729057091646343e-06,2,4.556192663162955e-06,0,0
14280,airline,2,3.6729057091646343e-06,2,4.556192663162955e-06,0,0
14283,@kevinomccarthy,2,3.6729057091646343e-06,2,4.556192663162955e-06,0,0
14285,@speakerpelosi,2,3.6729057091646343e-06,2,4.556192663162955e-06,0,0
14288,½,2,3.6729057091646343e-06,2,4.556192663162955e-06,0,0
14290,idiot,2,3.6729057091646343e-06,2,4.556192663162955e-06,0,0
14291,analyze,2,3.6729057091646343e-06,2,4.556192663162955e-06,0,0
14295,cancelling,2,3.6729057091646343e-06,2,4.556192663162955e-06,0,0
14301,roberto,2,3.6729057091646343e-06,2,4.556192663162955e-06,0,0
14316,lastly,2,3.6729057091646343e-06,2,4.556192663162955e-06,0,0
14325,melanie,2,3.6729057091646343e-06,2,4.556192663162955e-06,0,0
14329,@lizmacdonaldfox,2,3.6729057091646343e-06,2,4.556192663162955e-06,0,0
14333,@seanhannitys,2,3.6729057091646343e-06,2,4.556192663162955e-06,0,0
14334,segment,2,3.6729057091646343e-06,2,4.556192663162955e-06,0,0
14335,roles,2,3.6729057091646343e-06,2,4.556192663162955e-06,0,0
14342,described,2,3.6729057091646343e-06,2,4.556192663162955e-06,0,0
14346,scorn,2,3.6729057091646343e-06,2,4.556192663162955e-06,0,0
14357,weinstein,2,3.6729057091646343e-06,2,4.556192663162955e-06,0,0
14363,unequivocal,2,3.6729057091646343e-06,2,4.556192663162955e-06,0,0
14364,noonan,2,3.6729057091646343e-06,2,4.556192663162955e-06,0,0
14367,harriss,2,3.6729057091646343e-06,2,4.556192663162955e-06,0,0
14372,yoo,2,3.6729057091646343e-06,2,4.556192663162955e-06,0,0
14386,mcmorris,2,3.6729057091646343e-06,2,4.556192663162955e-06,0,0
14387,rodgers,2,3.6729057091646343e-06,2,4.556192663162955e-06,0,0
14390,newhouse,2,3.6729057091646343e-06,2,4.556192663162955e-06,0,0
14393,blaine,2,3.6729057091646343e-06,2,4.556192663162955e-06,0,0
14402,crafts,2,3.6729057091646343e-06,2,4.556192663162955e-06,0,0
14401,@dalecraftsme,2,3.6729057091646343e-06,2,4.556192663162955e-06,0,0
14408,self-help,2,3.6729057091646343e-06,2,4.556192663162955e-06,0,0
14423,enhancements,2,3.6729057091646343e-06,2,4.556192663162955e-06,0,0
14448,burned,2,3.6729057091646343e-06,2,4.556192663162955e-06,0,0
14453,litigation,2,3.6729057091646343e-06,2,4.556192663162955e-06,0,0
14452,@gopchairwoman,2,3.6729057091646343e-06,2,4.556192663162955e-06,0,0
14455,samantha,2,3.6729057091646343e-06,2,4.556192663162955e-06,0,0
14469,atrocities,2,3.6729057091646343e-06,2,4.556192663162955e-06,0,0
14480,colombia,2,3.6729057091646343e-06,2,4.556192663162955e-06,0,0
14502,discord,2,3.6729057091646343e-06,2,4.556192663162955e-06,0,0
14508,projections,2,3.6729057091646343e-06,2,4.556192663162955e-06,0,0
14510,unqualified,2,3.6729057091646343e-06,2,4.556192663162955e-06,0,0
14515,satisfaction,2,3.6729057091646343e-06,2,4.556192663162955e-06,0,0
14526,spike,2,3.6729057091646343e-06,2,4.556192663162955e-06,0,0
14535,pre,2,3.6729057091646343e-06,2,4.556192663162955e-06,0,0
14540,#fraudnewscnn,2,3.6729057091646343e-06,2,4.556192663162955e-06,0,0
14542,#inauguration2017,2,3.6729057091646343e-06,2,4.556192663162955e-06,0,0
14564,apologizing,2,3.6729057091646343e-06,2,4.556192663162955e-06,0,0
14572,wintour,2,3.6729057091646343e-06,2,4.556192663162955e-06,0,0
14563,amb,2,3.6729057091646343e-06,2,4.556192663162955e-06,0,0
14574,17500,2,3.6729057091646343e-06,2,4.556192663162955e-06,0,0
14573,1221,2,3.6729057091646343e-06,2,4.556192663162955e-06,0,0
14575,1900,2,3.6729057091646343e-06,2,4.556192663162955e-06,0,0
14577,@jamiejmcintyre,2,3.6729057091646343e-06,2,4.556192663162955e-06,0,0
14583,pile,2,3.6729057091646343e-06,2,4.556192663162955e-06,0,0
14585,cutreform,2,3.6729057091646343e-06,2,4.556192663162955e-06,0,0
14615,travelled,2,3.6729057091646343e-06,2,4.556192663162955e-06,0,0
14616,coordinating,2,3.6729057091646343e-06,2,4.556192663162955e-06,0,0
14617,dupont,2,3.6729057091646343e-06,2,4.556192663162955e-06,0,0
14621,wa,2,3.6729057091646343e-06,2,4.556192663162955e-06,0,0
14618,crumble,2,3.6729057091646343e-06,2,4.556192663162955e-06,0,0
14628,tire,2,3.6729057091646343e-06,2,4.556192663162955e-06,0,0
14629,backbone,2,3.6729057091646343e-06,2,4.556192663162955e-06,0,0
14634,quantico,2,3.6729057091646343e-06,2,4.556192663162955e-06,0,0
14639,185000,2,3.6729057091646343e-06,2,4.556192663162955e-06,0,0
14645,pioneers,2,3.6729057091646343e-06,2,4.556192663162955e-06,0,0
14646,ever-growing,2,3.6729057091646343e-06,2,4.556192663162955e-06,0,0
14648,restrictions,2,3.6729057091646343e-06,2,4.556192663162955e-06,0,0
14660,kirsten,2,3.6729057091646343e-06,2,4.556192663162955e-06,0,0
14659,gillibrand,2,3.6729057091646343e-06,2,4.556192663162955e-06,0,0
14661,ring,2,3.6729057091646343e-06,2,4.556192663162955e-06,0,0
14672,@daveweigel,2,3.6729057091646343e-06,2,4.556192663162955e-06,0,0
14683,rafters,2,3.6729057091646343e-06,2,4.556192663162955e-06,0,0
14685,17-year,2,3.6729057091646343e-06,2,4.556192663162955e-06,0,0
14690,wells,2,3.6729057091646343e-06,2,4.556192663162955e-06,0,0
14687,fargo,2,3.6729057091646343e-06,2,4.556192663162955e-06,0,0
14689,pursued,2,3.6729057091646343e-06,2,4.556192663162955e-06,0,0
14693,battlefields,2,3.6729057091646343e-06,2,4.556192663162955e-06,0,0
14698,surviving,2,3.6729057091646343e-06,2,4.556192663162955e-06,0,0
14701,pauses,2,3.6729057091646343e-06,2,4.556192663162955e-06,0,0
14709,designations,2,3.6729057091646343e-06,2,4.556192663162955e-06,0,0
14716,tatters,2,3.6729057091646343e-06,2,4.556192663162955e-06,0,0
14721,recording,2,3.6729057091646343e-06,2,4.556192663162955e-06,0,0
14726,pled,2,3.6729057091646343e-06,2,4.556192663162955e-06,0,0
14727,@senorrinhatch,2,3.6729057091646343e-06,2,4.556192663162955e-06,0,0
14737,steinle,2,3.6729057091646343e-06,2,4.556192663162955e-06,0,0
14739,boycott,2,3.6729057091646343e-06,2,4.556192663162955e-06,0,0
14755,comm,2,3.6729057091646343e-06,2,4.556192663162955e-06,0,0
14760,seeks,2,3.6729057091646343e-06,2,4.556192663162955e-06,0,0
14764,glowing,2,3.6729057091646343e-06,2,4.556192663162955e-06,0,0
14765,hard-earned,2,3.6729057091646343e-06,2,4.556192663162955e-06,0,0
14767,@jbanafw,2,3.6729057091646343e-06,2,4.556192663162955e-06,0,0
14774,provocative,2,3.6729057091646343e-06,2,4.556192663162955e-06,0,0
14776,practitioners,2,3.6729057091646343e-06,2,4.556192663162955e-06,0,0
14777,terminating,2,3.6729057091646343e-06,2,4.556192663162955e-06,0,0
14778,unsolved,2,3.6729057091646343e-06,2,4.556192663162955e-06,0,0
14779,cfpb,2,3.6729057091646343e-06,2,4.556192663162955e-06,0,0
14784,notching,2,3.6729057091646343e-06,2,4.556192663162955e-06,0,0
14790,simpler,2,3.6729057091646343e-06,2,4.556192663162955e-06,0,0
14797,locally,2,3.6729057091646343e-06,2,4.556192663162955e-06,0,0
14802,militarily,2,3.6729057091646343e-06,2,4.556192663162955e-06,0,0
14808,recep,2,3.6729057091646343e-06,2,4.556192663162955e-06,0,0
14809,tayyip,2,3.6729057091646343e-06,2,4.556192663162955e-06,0,0
14813,quarters,2,3.6729057091646343e-06,2,4.556192663162955e-06,0,0
14827,analysts,2,3.6729057091646343e-06,2,4.556192663162955e-06,0,0
14835,pressed,2,3.6729057091646343e-06,2,4.556192663162955e-06,0,0
14838,flakey,2,3.6729057091646343e-06,2,4.556192663162955e-06,0,0
14837,anemic,2,3.6729057091646343e-06,2,4.556192663162955e-06,0,0
14855,winding,2,3.6729057091646343e-06,2,4.556192663162955e-06,0,0
14856,ucla,2,3.6729057091646343e-06,2,4.556192663162955e-06,0,0
14861,sutherland,2,3.6729057091646343e-06,2,4.556192663162955e-06,0,0
14869,azar,2,3.6729057091646343e-06,2,4.556192663162955e-06,0,0
14870,mtgs,2,3.6729057091646343e-06,2,4.556192663162955e-06,0,0
14871,#aseansummit,2,3.6729057091646343e-06,2,4.556192663162955e-06,0,0
14880,chemistry,2,3.6729057091646343e-06,2,4.556192663162955e-06,0,0
14896,renewed,2,3.6729057091646343e-06,2,4.556192663162955e-06,0,0
14895,indo-pacific,2,3.6729057091646343e-06,2,4.556192663162955e-06,0,0
14899,unlocked,2,3.6729057091646343e-06,2,4.556192663162955e-06,0,0
14905,greet,2,3.6729057091646343e-06,2,4.556192663162955e-06,0,0
14907,sadness,2,3.6729057091646343e-06,2,4.556192663162955e-06,0,0
14916,📸,2,3.6729057091646343e-06,2,4.556192663162955e-06,0,0
14919,delegations,2,3.6729057091646343e-06,2,4.556192663162955e-06,0,0
14925,unforgettable,2,3.6729057091646343e-06,2,4.556192663162955e-06,0,0
14927,reunited,2,3.6729057091646343e-06,2,4.556192663162955e-06,0,0
14936,participated,2,3.6729057091646343e-06,2,4.556192663162955e-06,0,0
14937,rx,2,3.6729057091646343e-06,2,4.556192663162955e-06,0,0
14933,collected,2,3.6729057091646343e-06,2,4.556192663162955e-06,0,0
14939,@edwgillespie,2,3.6729057091646343e-06,2,4.556192663162955e-06,0,0
14944,rok,2,3.6729057091646343e-06,2,4.556192663162955e-06,0,0
14945,🇺🇸🇰🇷,2,3.6729057091646343e-06,2,4.556192663162955e-06,0,0
14949,yokota,2,3.6729057091646343e-06,2,4.556192663162955e-06,0,0
14948,@usforcesjapan,2,3.6729057091646343e-06,2,4.556192663162955e-06,0,0
14952,tokyo,2,3.6729057091646343e-06,2,4.556192663162955e-06,0,0
14959,militaryveterans,2,3.6729057091646343e-06,2,4.556192663162955e-06,0,0
14972,billionyr,2,3.6729057091646343e-06,2,4.556192663162955e-06,0,0
14983,@astros,2,3.6729057091646343e-06,2,4.556192663162955e-06,0,0
14982,#houstonstrong,2,3.6729057091646343e-06,2,4.556192663162955e-06,0,0
14987,@garyplayer,2,3.6729057091646343e-06,2,4.556192663162955e-06,0,0
14989,macri,2,3.6729057091646343e-06,2,4.556192663162955e-06,0,0
14990,#nycstrong,2,3.6729057091646343e-06,2,4.556192663162955e-06,0,0
14994,craziness,2,3.6729057091646343e-06,2,4.556192663162955e-06,0,0
15016,guilt,2,3.6729057091646343e-06,2,4.556192663162955e-06,0,0
15019,broadway,2,3.6729057091646343e-06,2,4.556192663162955e-06,0,0
15023,#opioidepidemic,2,3.6729057091646343e-06,2,4.556192663162955e-06,0,0
15026,#flashbackfriday,2,3.6729057091646343e-06,2,4.556192663162955e-06,0,0
15033,@flgovscott,2,3.6729057091646343e-06,2,4.556192663162955e-06,0,0
15038,#opioidcrisis,2,3.6729057091646343e-06,2,4.556192663162955e-06,0,0
15041,#s,2,3.6729057091646343e-06,2,4.556192663162955e-06,0,0
15047,tx,2,3.6729057091646343e-06,2,4.556192663162955e-06,0,0
15048,elevation,2,3.6729057091646343e-06,2,4.556192663162955e-06,0,0
15050,priebus,2,3.6729057091646343e-06,2,4.556192663162955e-06,0,0
15051,reince,2,3.6729057091646343e-06,2,4.556192663162955e-06,0,0
15075,@antonioguterres,2,3.6729057091646343e-06,2,4.556192663162955e-06,0,0
15079,getter,2,3.6729057091646343e-06,2,4.556192663162955e-06,0,0
15084,#prstrong,2,3.6729057091646343e-06,2,4.556192663162955e-06,0,0
15087,inventing,2,3.6729057091646343e-06,2,4.556192663162955e-06,0,0
15092,milestones,2,3.6729057091646343e-06,2,4.556192663162955e-06,0,0
15105,lamar,2,3.6729057091646343e-06,2,4.556192663162955e-06,0,0
15108,drafted,2,3.6729057091646343e-06,2,4.556192663162955e-06,0,0
15109,exonerating,2,3.6729057091646343e-06,2,4.556192663162955e-06,0,0
15112,revive,2,3.6729057091646343e-06,2,4.556192663162955e-06,0,0
15113,prototypes,2,3.6729057091646343e-06,2,4.556192663162955e-06,0,0
15115,alexis,2,3.6729057091646343e-06,2,4.556192663162955e-06,0,0
15117,tsipras,2,3.6729057091646343e-06,2,4.556192663162955e-06,0,0
15116,greece,2,3.6729057091646343e-06,2,4.556192663162955e-06,0,0
15152,darkest,2,3.6729057091646343e-06,2,4.556192663162955e-06,0,0
15159,ot,2,3.6729057091646343e-06,2,4.556192663162955e-06,0,0
15160,arsenal,2,3.6729057091646343e-06,2,4.556192663162955e-06,0,0
15162,goodell,2,3.6729057091646343e-06,2,4.556192663162955e-06,0,0
15166,mediathe,2,3.6729057091646343e-06,2,4.556192663162955e-06,0,0
15171,espn,2,3.6729057091646343e-06,2,4.556192663162955e-06,0,0
15177,#columbusday,2,3.6729057091646343e-06,2,4.556192663162955e-06,0,0
15180,#puertorico,2,3.6729057091646343e-06,2,4.556192663162955e-06,0,0
15183,kneeled,2,3.6729057091646343e-06,2,4.556192663162955e-06,0,0
15204,#usvi,2,3.6729057091646343e-06,2,4.556192663162955e-06,0,0
15211,respecting,2,3.6729057091646343e-06,2,4.556192663162955e-06,0,0
15209,#standforouranthem🇺🇸,2,3.6729057091646343e-06,2,4.556192663162955e-06,0,0
15212,analyzing,2,3.6729057091646343e-06,2,4.556192663162955e-06,0,0
15215,louder,2,3.6729057091646343e-06,2,4.556192663162955e-06,0,0
15219,kenneth,2,3.6729057091646343e-06,2,4.556192663162955e-06,0,0
15223,rossello,2,3.6729057091646343e-06,2,4.556192663162955e-06,0,0
15227,record-high,2,3.6729057091646343e-06,2,4.556192663162955e-06,0,0
15231,revised,2,3.6729057091646343e-06,2,4.556192663162955e-06,0,0
15233,locals,2,3.6729057091646343e-06,2,4.556192663162955e-06,0,0
15238,@wapo,2,3.6729057091646343e-06,2,4.556192663162955e-06,0,0
15243,jamaica,2,3.6729057091646343e-06,2,4.556192663162955e-06,0,0
15269,condone,2,3.6729057091646343e-06,2,4.556192663162955e-06,0,0
15291,poroshenko,2,3.6729057091646343e-06,2,4.556192663162955e-06,0,0
15294,ghani,2,3.6729057091646343e-06,2,4.556192663162955e-06,0,0
15292,#usaatunga,2,3.6729057091646343e-06,2,4.556192663162955e-06,0,0
15313,freedoms,2,3.6729057091646343e-06,2,4.556192663162955e-06,0,0
15317,schuette,2,3.6729057091646343e-06,2,4.556192663162955e-06,0,0
15318,huntsville,2,3.6729057091646343e-06,2,4.556192663162955e-06,0,0
15340,fences,2,3.6729057091646343e-06,2,4.556192663162955e-06,0,0
15356,fascinating,2,3.6729057091646343e-06,2,4.556192663162955e-06,0,0
15362,closures,2,3.6729057091646343e-06,2,4.556192663162955e-06,0,0
15366,americans🇺🇸,2,3.6729057091646343e-06,2,4.556192663162955e-06,0,0
15378,kuwait,2,3.6729057091646343e-06,2,4.556192663162955e-06,0,0
15385,@senjohnhoeven,2,3.6729057091646343e-06,2,4.556192663162955e-06,0,0
15383,@repkevincramer,2,3.6729057091646343e-06,2,4.556192663162955e-06,0,0
15395,ds,2,3.6729057091646343e-06,2,4.556192663162955e-06,0,0
15397,#cajunnavy,2,3.6729057091646343e-06,2,4.556192663162955e-06,0,0
15419,rainfall,2,3.6729057091646343e-06,2,4.556192663162955e-06,0,0
15431,doings,2,3.6729057091646343e-06,2,4.556192663162955e-06,0,0
15432,mph,2,3.6729057091646343e-06,2,4.556192663162955e-06,0,0
15451,#alconv2017,2,3.6729057091646343e-06,2,4.556192663162955e-06,0,0
15455,modernization,2,3.6729057091646343e-06,2,4.556192663162955e-06,0,0
15464,#ussjohnsmccain,2,3.6729057091646343e-06,2,4.556192663162955e-06,0,0
15466,bigotry,2,3.6729057091646343e-06,2,4.556192663162955e-06,0,0
15467,heel,2,3.6729057091646343e-06,2,4.556192663162955e-06,0,0
15470,#uswomensopen🇺🇸,2,3.6729057091646343e-06,2,4.556192663162955e-06,0,0
15486,ward,2,3.6729057091646343e-06,2,4.556192663162955e-06,0,0
15488,heyer,2,3.6729057091646343e-06,2,4.556192663162955e-06,0,0
15499,congratulation,2,3.6729057091646343e-06,2,4.556192663162955e-06,0,0
15507,merck,2,3.6729057091646343e-06,2,4.556192663162955e-06,0,0
15518,#godblesstheusa🇺🇸,2,3.6729057091646343e-06,2,4.556192663162955e-06,0,0
15525,reluctant,2,3.6729057091646343e-06,2,4.556192663162955e-06,0,0
15529,conquests,2,3.6729057091646343e-06,2,4.556192663162955e-06,0,0
15531,ushistory,2,3.6729057091646343e-06,2,4.556192663162955e-06,0,0
15530,defrauded,2,3.6729057091646343e-06,2,4.556192663162955e-06,0,0
15533,jobsborder,2,3.6729057091646343e-06,2,4.556192663162955e-06,0,0
15551,wone,2,3.6729057091646343e-06,2,4.556192663162955e-06,0,0
15552,huntington,2,3.6729057091646343e-06,2,4.556192663162955e-06,0,0
15568,kates,2,3.6729057091646343e-06,2,4.556192663162955e-06,0,0
15572,enforce,2,3.6729057091646343e-06,2,4.556192663162955e-06,0,0
15586,transgender,2,3.6729057091646343e-06,2,4.556192663162955e-06,0,0
15587,advised,2,3.6729057091646343e-06,2,4.556192663162955e-06,0,0
15589,youngstown,2,3.6729057091646343e-06,2,4.556192663162955e-06,0,0
15601,kushner,2,3.6729057091646343e-06,2,4.556192663162955e-06,0,0
15598,barron,2,3.6729057091646343e-06,2,4.556192663162955e-06,0,0
15612,@secretaryperry,2,3.6729057091646343e-06,2,4.556192663162955e-06,0,0
15611,@secpricemd,2,3.6729057091646343e-06,2,4.556192663162955e-06,0,0
15615,sleazy,2,3.6729057091646343e-06,2,4.556192663162955e-06,0,0
15624,godspeed,2,3.6729057091646343e-06,2,4.556192663162955e-06,0,0
15630,constructed,2,3.6729057091646343e-06,2,4.556192663162955e-06,0,0
15629,#ussgeraldrford,2,3.6729057091646343e-06,2,4.556192663162955e-06,0,0
15631,commissioning,2,3.6729057091646343e-06,2,4.556192663162955e-06,0,0
15636,carrier,2,3.6729057091646343e-06,2,4.556192663162955e-06,0,0
15641,#ussarizona,2,3.6729057091646343e-06,2,4.556192663162955e-06,0,0
15643,qtr,2,3.6729057091646343e-06,2,4.556192663162955e-06,0,0
15652,dies,2,3.6729057091646343e-06,2,4.556192663162955e-06,0,0
15663,delete,2,3.6729057091646343e-06,2,4.556192663162955e-06,0,0
15668,@emmanuelmacronthank,2,3.6729057091646343e-06,2,4.556192663162955e-06,0,0
15667,#bastilleday,2,3.6729057091646343e-06,2,4.556192663162955e-06,0,0
15669,tournament,2,3.6729057091646343e-06,2,4.556192663162955e-06,0,0
15671,🇺🇸🇫🇷,2,3.6729057091646343e-06,2,4.556192663162955e-06,0,0
15684,rdy,2,3.6729057091646343e-06,2,4.556192663162955e-06,0,0
15685,wwi,2,3.6729057091646343e-06,2,4.556192663162955e-06,0,0
15687,functioning,2,3.6729057091646343e-06,2,4.556192663162955e-06,0,0
15702,shinzō,2,3.6729057091646343e-06,2,4.556192663162955e-06,0,0
15706,evils,2,3.6729057091646343e-06,2,4.556192663162955e-06,0,0
15705,#potusinpoland,2,3.6729057091646343e-06,2,4.556192663162955e-06,0,0
15714,#happyindependenceday,2,3.6729057091646343e-06,2,4.556192663162955e-06,0,0
15731,encouraged,2,3.6729057091646343e-06,2,4.556192663162955e-06,0,0
15733,@morningjoe,2,3.6729057091646343e-06,2,4.556192663162955e-06,0,0
15737,proportions,2,3.6729057091646343e-06,2,4.556192663162955e-06,0,0
15738,cusp,2,3.6729057091646343e-06,2,4.556192663162955e-06,0,0
15742,#nosanctuaryforcriminalsact,2,3.6729057091646343e-06,2,4.556192663162955e-06,0,0
15755,retract,2,3.6729057091646343e-06,2,4.556192663162955e-06,0,0
15758,colluding,2,3.6729057091646343e-06,2,4.556192663162955e-06,0,0
15769,recordings,2,3.6729057091646343e-06,2,4.556192663162955e-06,0,0
15770,electronic,2,3.6729057091646343e-06,2,4.556192663162955e-06,0,0
15773,jeh,2,3.6729057091646343e-06,2,4.556192663162955e-06,0,0
15779,norman,2,3.6729057091646343e-06,2,4.556192663162955e-06,0,0
15788,#votekarenhandel,2,3.6729057091646343e-06,2,4.556192663162955e-06,0,0
15793,sekulow,2,3.6729057091646343e-06,2,4.556192663162955e-06,0,0
15794,os,2,3.6729057091646343e-06,2,4.556192663162955e-06,0,0
15797,distraction,2,3.6729057091646343e-06,2,4.556192663162955e-06,0,0
15805,@govwalker,2,3.6729057091646343e-06,2,4.556192663162955e-06,0,0
15818,@clemsonfb,2,3.6729057091646343e-06,2,4.556192663162955e-06,0,0
15829,@faithandfreedom,2,3.6729057091646343e-06,2,4.556192663162955e-06,0,0
15837,#dday,2,3.6729057091646343e-06,2,4.556192663162955e-06,0,0
15839,pointing,2,3.6729057091646343e-06,2,4.556192663162955e-06,0,0
15847,sadiq,2,3.6729057091646343e-06,2,4.556192663162955e-06,0,0
15845,alarmed,2,3.6729057091646343e-06,2,4.556192663162955e-06,0,0
15848,watered,2,3.6729057091646343e-06,2,4.556192663162955e-06,0,0
15855,long-standing,2,3.6729057091646343e-06,2,4.556192663162955e-06,0,0
15856,covfefe,2,3.6729057091646343e-06,2,4.556192663162955e-06,0,0
15865,@commercegov,2,3.6729057091646343e-06,2,4.556192663162955e-06,0,0
15864,232,2,3.6729057091646343e-06,2,4.556192663162955e-06,0,0
15876,engage,2,3.6729057091646343e-06,2,4.556192663162955e-06,0,0
15879,#nato,2,3.6729057091646343e-06,2,4.556192663162955e-06,0,0
15883,vatican,2,3.6729057091646343e-06,2,4.556192663162955e-06,0,0
15888,#riyadhsummit,2,3.6729057091646343e-06,2,4.556192663162955e-06,0,0
15892,#weeklyaddress🇺🇸➡️,2,3.6729057091646343e-06,2,4.556192663162955e-06,0,0
15904,surged,2,3.6729057091646343e-06,2,4.556192663162955e-06,0,0
15919,lavrov,2,3.6729057091646343e-06,2,4.556192663162955e-06,0,0
15931,indignant,2,3.6729057091646343e-06,2,4.556192663162955e-06,0,0
15956,@betsydevosed,2,3.6729057091646343e-06,2,4.556192663162955e-06,0,0
15958,deeds,2,3.6729057091646343e-06,2,4.556192663162955e-06,0,0
15966,@facethenation,2,3.6729057091646343e-06,2,4.556192663162955e-06,0,0
15968,@secretaryross,2,3.6729057091646343e-06,2,4.556192663162955e-06,0,0
15969,@mauriciomacri,2,3.6729057091646343e-06,2,4.556192663162955e-06,0,0
15979,@interior,2,3.6729057091646343e-06,2,4.556192663162955e-06,0,0
15987,#congratspeggy,2,3.6729057091646343e-06,2,4.556192663162955e-06,0,0
15990,#buildthewall,2,3.6729057091646343e-06,2,4.556192663162955e-06,0,0
15991,poisoning,2,3.6729057091646343e-06,2,4.556192663162955e-06,0,0
15997,belichick,2,3.6729057091646343e-06,2,4.556192663162955e-06,0,0
16000,burdens,2,3.6729057091646343e-06,2,4.556192663162955e-06,0,0
16026,unverifiable,2,3.6729057091646343e-06,2,4.556192663162955e-06,0,0
16027,estes,2,3.6729057091646343e-06,2,4.556192663162955e-06,0,0
16029,secretaries,2,3.6729057091646343e-06,2,4.556192663162955e-06,0,0
16032,sisi,2,3.6729057091646343e-06,2,4.556192663162955e-06,0,0
16038,#nabtu2017,2,3.6729057091646343e-06,2,4.556192663162955e-06,0,0
16047,#confirmgorsuch,2,3.6729057091646343e-06,2,4.556192663162955e-06,0,0
16055,@raullabrador,2,3.6729057091646343e-06,2,4.556192663162955e-06,0,0
16063,@glfop,2,3.6729057091646343e-06,2,4.556192663162955e-06,0,0
16077,kurt,2,3.6729057091646343e-06,2,4.556192663162955e-06,0,0
16076,cochran,2,3.6729057091646343e-06,2,4.556192663162955e-06,0,0
16092,🇺🇸🇮🇪,2,3.6729057091646343e-06,2,4.556192663162955e-06,0,0
16096,outcry,2,3.6729057091646343e-06,2,4.556192663162955e-06,0,0
16109,gitmo,2,3.6729057091646343e-06,2,4.556192663162955e-06,0,0
16112,sweeping,2,3.6729057091646343e-06,2,4.556192663162955e-06,0,0
16119,tapping,2,3.6729057091646343e-06,2,4.556192663162955e-06,0,0
16136,perez,2,3.6729057091646343e-06,2,4.556192663162955e-06,0,0
16137,vows,2,3.6729057091646343e-06,2,4.556192663162955e-06,0,0
16141,edges,2,3.6729057091646343e-06,2,4.556192663162955e-06,0,0
16150,spotlight,2,3.6729057091646343e-06,2,4.556192663162955e-06,0,0
16168,hj,2,3.6729057091646343e-06,2,4.556192663162955e-06,0,0
16187,f-35,2,3.6729057091646343e-06,2,4.556192663162955e-06,0,0
16196,bother,2,3.6729057091646343e-06,2,4.556192663162955e-06,0,0
16197,cite,2,3.6729057091646343e-06,2,4.556192663162955e-06,0,0
16202,bogged,2,3.6729057091646343e-06,2,4.556192663162955e-06,0,0
16217,accumulation,2,3.6729057091646343e-06,2,4.556192663162955e-06,0,0
16219,#superbowl,2,3.6729057091646343e-06,2,4.556192663162955e-06,0,0
16220,peril,2,3.6729057091646343e-06,2,4.556192663162955e-06,0,0
16227,tourists,2,3.6729057091646343e-06,2,4.556192663162955e-06,0,0
16237,delaying,2,3.6729057091646343e-06,2,4.556192663162955e-06,0,0
16242,@thebrodyfile,2,3.6729057091646343e-06,2,4.556192663162955e-06,0,0
16241,@cbnnews,2,3.6729057091646343e-06,2,4.556192663162955e-06,0,0
16246,aptitude,2,3.6729057091646343e-06,2,4.556192663162955e-06,0,0
16256,traitor,2,3.6729057091646343e-06,2,4.556192663162955e-06,0,0
16258,@abc2020,2,3.6729057091646343e-06,2,4.556192663162955e-06,0,0
16268,#inaugurationday,2,3.6729057091646343e-06,2,4.556192663162955e-06,0,0
16270,transferring,2,3.6729057091646343e-06,2,4.556192663162955e-06,0,0
16280,string,2,3.6729057091646343e-06,2,4.556192663162955e-06,0,0
16307,llbean,2,3.6729057091646343e-06,2,4.556192663162955e-06,0,0
16309,fictitious,2,3.6729057091646343e-06,2,4.556192663162955e-06,0,0
16318,groveling,2,3.6729057091646343e-06,2,4.556192663162955e-06,0,0
16328,@meetthepress,2,3.6729057091646343e-06,2,4.556192663162955e-06,0,0
16327,@chucktodd,2,3.6729057091646343e-06,2,4.556192663162955e-06,0,0
16338,chairs,2,3.6729057091646343e-06,2,4.556192663162955e-06,0,0
16345,examination,2,3.6729057091646343e-06,2,4.556192663162955e-06,0,0
16355,weight,2,3.6729057091646343e-06,2,4.556192663162955e-06,0,0
16357,#hannity,2,3.6729057091646343e-06,2,4.556192663162955e-06,0,0
16363,weakening,2,3.6729057091646343e-06,2,4.556192663162955e-06,0,0
16380,remnants,2,3.6729057091646343e-06,2,4.556192663162955e-06,0,0
16393,pre-nafta,2,3.6729057091646343e-06,2,4.556192663162955e-06,0,0
16407,putt,2,3.6729057091646343e-06,2,4.556192663162955e-06,0,0
16410,mcgurk,2,3.6729057091646343e-06,2,4.556192663162955e-06,0,0
16417,drones,2,3.6729057091646343e-06,2,4.556192663162955e-06,0,0
16416,bells,2,3.6729057091646343e-06,2,4.556192663162955e-06,0,0
16418,whistles,2,3.6729057091646343e-06,2,4.556192663162955e-06,0,0
16425,pullout,2,3.6729057091646343e-06,2,4.556192663162955e-06,0,0
16434,residence,2,3.6729057091646343e-06,2,4.556192663162955e-06,0,0
16437,countering,2,3.6729057091646343e-06,2,4.556192663162955e-06,0,0
16439,#firststepact,2,3.6729057091646343e-06,2,4.556192663162955e-06,0,0
16443,tata,2,3.6729057091646343e-06,2,4.556192663162955e-06,0,0
16444,withdrawal,2,3.6729057091646343e-06,2,4.556192663162955e-06,0,0
16449,jims,2,3.6729057091646343e-06,2,4.556192663162955e-06,0,0
16452,begrudgingly,2,3.6729057091646343e-06,2,4.556192663162955e-06,0,0
16454,slats,2,3.6729057091646343e-06,2,4.556192663162955e-06,0,0
16465,isikoff,2,3.6729057091646343e-06,2,4.556192663162955e-06,0,0
16470,steeles,2,3.6729057091646343e-06,2,4.556192663162955e-06,0,0
16478,misstatements,2,3.6729057091646343e-06,2,4.556192663162955e-06,0,0
16480,defenses,2,3.6729057091646343e-06,2,4.556192663162955e-06,0,0
16486,seperation,2,3.6729057091646343e-06,2,4.556192663162955e-06,0,0
16488,generel,2,3.6729057091646343e-06,2,4.556192663162955e-06,0,0
16489,golsteyn,2,3.6729057091646343e-06,2,4.556192663162955e-06,0,0
16507,overrode,2,3.6729057091646343e-06,2,4.556192663162955e-06,0,0
16508,smallest,2,3.6729057091646343e-06,2,4.556192663162955e-06,0,0
16509,did-including,2,3.6729057091646343e-06,2,4.556192663162955e-06,0,0
16510,anti-usa,2,3.6729057091646343e-06,2,4.556192663162955e-06,0,0
16515,swecker,2,3.6729057091646343e-06,2,4.556192663162955e-06,0,0
16518,anton,2,3.6729057091646343e-06,2,4.556192663162955e-06,0,0
16520,acknowledging,2,3.6729057091646343e-06,2,4.556192663162955e-06,0,0
16532,army-navy,2,3.6729057091646343e-06,2,4.556192663162955e-06,0,0
16533,woke,2,3.6729057091646343e-06,2,4.556192663162955e-06,0,0
16537,illusion,2,3.6729057091646343e-06,2,4.556192663162955e-06,0,0
16539,milley,2,3.6729057091646343e-06,2,4.556192663162955e-06,0,0
16541,father-in-law,2,3.6729057091646343e-06,2,4.556192663162955e-06,0,0
16546,haley,2,3.6729057091646343e-06,2,4.556192663162955e-06,0,0
16551,molly,2,3.6729057091646343e-06,2,4.556192663162955e-06,0,0
16555,scathing,2,3.6729057091646343e-06,2,4.556192663162955e-06,0,0
16561,obtain,2,3.6729057091646343e-06,2,4.556192663162955e-06,0,0
16565,plea,2,3.6729057091646343e-06,2,4.556192663162955e-06,0,0
16568,collision,2,3.6729057091646343e-06,2,4.556192663162955e-06,0,0
16571,restricted,2,3.6729057091646343e-06,2,4.556192663162955e-06,0,0
16577,changer,2,3.6729057091646343e-06,2,4.556192663162955e-06,0,0
16586,wilbur,2,3.6729057091646343e-06,2,4.556192663162955e-06,0,0
16591,@lopezobrador,2,3.6729057091646343e-06,2,4.556192663162955e-06,0,0
16603,partisans,2,3.6729057091646343e-06,2,4.556192663162955e-06,0,0
16612,arthur,2,3.6729057091646343e-06,2,4.556192663162955e-06,0,0
16619,sebastian,2,3.6729057091646343e-06,2,4.556192663162955e-06,0,0
16618,gorka,2,3.6729057091646343e-06,2,4.556192663162955e-06,0,0
16625,snipes,2,3.6729057091646343e-06,2,4.556192663162955e-06,0,0
16627,@gm,2,3.6729057091646343e-06,2,4.556192663162955e-06,0,0
16632,mumbai,2,3.6729057091646343e-06,2,4.556192663162955e-06,0,0
16639,waving,2,3.6729057091646343e-06,2,4.556192663162955e-06,0,0
16640,cruel,2,3.6729057091646343e-06,2,4.556192663162955e-06,0,0
16643,strengthened,2,3.6729057091646343e-06,2,4.556192663162955e-06,0,0
16646,remedied,2,3.6729057091646343e-06,2,4.556192663162955e-06,0,0
16654,activism,2,3.6729057091646343e-06,2,4.556192663162955e-06,0,0
16661,blast,2,3.6729057091646343e-06,2,4.556192663162955e-06,0,0
16669,sanity,2,3.6729057091646343e-06,2,4.556192663162955e-06,0,0
16681,ill-prepared,2,3.6729057091646343e-06,2,4.556192663162955e-06,0,0
16693,ironic,2,3.6729057091646343e-06,2,4.556192663162955e-06,0,0
16698,barracks,2,3.6729057091646343e-06,2,4.556192663162955e-06,0,0
16703,45-year,2,3.6729057091646343e-06,2,4.556192663162955e-06,0,0
16704,festival,2,3.6729057091646343e-06,2,4.556192663162955e-06,0,0
16706,buddhists,2,3.6729057091646343e-06,2,4.556192663162955e-06,0,0
16709,sikhs,2,3.6729057091646343e-06,2,4.556192663162955e-06,0,0
16708,jains,2,3.6729057091646343e-06,2,4.556192663162955e-06,0,0
16707,diya,2,3.6729057091646343e-06,2,4.556192663162955e-06,0,0
16711,visibility,2,3.6729057091646343e-06,2,4.556192663162955e-06,0,0
16710,reported-fake,2,3.6729057091646343e-06,2,4.556192663162955e-06,0,0
16712,cemetary,2,3.6729057091646343e-06,2,4.556192663162955e-06,0,0
16716,wines,2,3.6729057091646343e-06,2,4.556192663162955e-06,0,0
16718,antitrust,2,3.6729057091646343e-06,2,4.556192663162955e-06,0,0
16723,headaches,2,3.6729057091646343e-06,2,4.556192663162955e-06,0,0
16733,170000,2,3.6729057091646343e-06,2,4.556192663162955e-06,0,0
16742,leo,2,3.6729057091646343e-06,2,4.556192663162955e-06,0,0
16755,capitalist,2,3.6729057091646343e-06,2,4.556192663162955e-06,0,0
16759,waltz,2,3.6729057091646343e-06,2,4.556192663162955e-06,0,0
16762,cape,2,3.6729057091646343e-06,2,4.556192663162955e-06,0,0
16765,faithful,2,3.6729057091646343e-06,2,4.556192663162955e-06,0,0
16767,coliseum,2,3.6729057091646343e-06,2,4.556192663162955e-06,0,0
16769,@braun4indiana,2,3.6729057091646343e-06,2,4.556192663162955e-06,0,0
16779,tallahassee,2,3.6729057091646343e-06,2,4.556192663162955e-06,0,0
16782,rohrabacher,2,3.6729057091646343e-06,2,4.556192663162955e-06,0,0
16785,blackburn,2,3.6729057091646343e-06,2,4.556192663162955e-06,0,0
16789,@scottforflorida,2,3.6729057091646343e-06,2,4.556192663162955e-06,0,0
16790,okeechobee,2,3.6729057091646343e-06,2,4.556192663162955e-06,0,0
16791,donnelly,2,3.6729057091646343e-06,2,4.556192663162955e-06,0,0
16794,sinema,2,3.6729057091646343e-06,2,4.556192663162955e-06,0,0
16797,timber,2,3.6729057091646343e-06,2,4.556192663162955e-06,0,0
16801,@deanheller,2,3.6729057091646343e-06,2,4.556192663162955e-06,0,0
16806,@cbp,2,3.6729057091646343e-06,2,4.556192663162955e-06,0,0
16807,#magarally🇺🇸,2,3.6729057091646343e-06,2,4.556192663162955e-06,0,0
16811,affects,2,3.6729057091646343e-06,2,4.556192663162955e-06,0,0
16824,opposite-disgraceful,2,3.6729057091646343e-06,2,4.556192663162955e-06,0,0
16832,@erikpaulsen,2,3.6729057091646343e-06,2,4.556192663162955e-06,0,0
16834,@davebratva7th,2,3.6729057091646343e-06,2,4.556192663162955e-06,0,0
16847,hostility,2,3.6729057091646343e-06,2,4.556192663162955e-06,0,0
16852,innings,2,3.6729057091646343e-06,2,4.556192663162955e-06,0,0
16855,shellacked,2,3.6729057091646343e-06,2,4.556192663162955e-06,0,0
16877,devices,2,3.6729057091646343e-06,2,4.556192663162955e-06,0,0
16887,1800,2,3.6729057091646343e-06,2,4.556192663162955e-06,0,0
16897,cellphone,2,3.6729057091646343e-06,2,4.556192663162955e-06,0,0
16901,@scottwalker,2,3.6729057091646343e-06,2,4.556192663162955e-06,0,0
16900,@leahvukmir,2,3.6729057091646343e-06,2,4.556192663162955e-06,0,0
16912,erik,2,3.6729057091646343e-06,2,4.556192663162955e-06,0,0
16916,wrecking,2,3.6729057091646343e-06,2,4.556192663162955e-06,0,0
16920,shock,2,3.6729057091646343e-06,2,4.556192663162955e-06,0,0
16922,alerted,2,3.6729057091646343e-06,2,4.556192663162955e-06,0,0
16929,cramer,2,3.6729057091646343e-06,2,4.556192663162955e-06,0,0
16931,heidi,2,3.6729057091646343e-06,2,4.556192663162955e-06,0,0
16935,heller,2,3.6729057091646343e-06,2,4.556192663162955e-06,0,0
16947,consulate,2,3.6729057091646343e-06,2,4.556192663162955e-06,0,0
16951,missoula,2,3.6729057091646343e-06,2,4.556192663162955e-06,0,0
16952,leftists,2,3.6729057091646343e-06,2,4.556192663162955e-06,0,0
16956,behaved,2,3.6729057091646343e-06,2,4.556192663162955e-06,0,0
16960,neal,2,3.6729057091646343e-06,2,4.556192663162955e-06,0,0
16969,hammered,2,3.6729057091646343e-06,2,4.556192663162955e-06,0,0
16973,headway,2,3.6729057091646343e-06,2,4.556192663162955e-06,0,0
16985,throws,2,3.6729057091646343e-06,2,4.556192663162955e-06,0,0
16989,minors,2,3.6729057091646343e-06,2,4.556192663162955e-06,0,0
16991,cherokee,2,3.6729057091646343e-06,2,4.556192663162955e-06,0,0
16993,dna,2,3.6729057091646343e-06,2,4.556192663162955e-06,0,0
16998,correction,2,3.6729057091646343e-06,2,4.556192663162955e-06,0,0
17015,panhandle,2,3.6729057091646343e-06,2,4.556192663162955e-06,0,0
17018,lined,2,3.6729057091646343e-06,2,4.556192663162955e-06,0,0
17026,pan,2,3.6729057091646343e-06,2,4.556192663162955e-06,0,0
17027,screamers,2,3.6729057091646343e-06,2,4.556192663162955e-06,0,0
17031,deserted,2,3.6729057091646343e-06,2,4.556192663162955e-06,0,0
17051,3-5,2,3.6729057091646343e-06,2,4.556192663162955e-06,0,0
17060,harsh,2,3.6729057091646343e-06,2,4.556192663162955e-06,0,0
17071,deficiencies,2,3.6729057091646343e-06,2,4.556192663162955e-06,0,0
17082,73rd,2,3.6729057091646343e-06,2,4.556192663162955e-06,0,0
17086,secretary-general,2,3.6729057091646343e-06,2,4.556192663162955e-06,0,0
17087,kiss,2,3.6729057091646343e-06,2,4.556192663162955e-06,0,0
17091,array,2,3.6729057091646343e-06,2,4.556192663162955e-06,0,0
17097,jae-in,2,3.6729057091646343e-06,2,4.556192663162955e-06,0,0
17108,master,2,3.6729057091646343e-06,2,4.556192663162955e-06,0,0
17114,lacking,2,3.6729057091646343e-06,2,4.556192663162955e-06,0,0
17120,andrzej,2,3.6729057091646343e-06,2,4.556192663162955e-06,0,0
17121,duda,2,3.6729057091646343e-06,2,4.556192663162955e-06,0,0
17123,biological,2,3.6729057091646343e-06,2,4.556192663162955e-06,0,0
17130,pharmacy,2,3.6729057091646343e-06,2,4.556192663162955e-06,0,0
17128,gag,2,3.6729057091646343e-06,2,4.556192663162955e-06,0,0
17127,clauses,2,3.6729057091646343e-06,2,4.556192663162955e-06,0,0
17126,#americanpatientsfirst,2,3.6729057091646343e-06,2,4.556192663162955e-06,0,0
17133,texted,2,3.6729057091646343e-06,2,4.556192663162955e-06,0,0
17150,jurisdictions,2,3.6729057091646343e-06,2,4.556192663162955e-06,0,0
17159,supplied,2,3.6729057091646343e-06,2,4.556192663162955e-06,0,0
17163,dimon,2,3.6729057091646343e-06,2,4.556192663162955e-06,0,0
17164,smarts,2,3.6729057091646343e-06,2,4.556192663162955e-06,0,0
17166,r-nc,2,3.6729057091646343e-06,2,4.556192663162955e-06,0,0
17168,inaccessible,2,3.6729057091646343e-06,2,4.556192663162955e-06,0,0
17180,@saracarterdc,2,3.6729057091646343e-06,2,4.556192663162955e-06,0,0
17183,@secnielsen,2,3.6729057091646343e-06,2,4.556192663162955e-06,0,0
17184,accordingly,2,3.6729057091646343e-06,2,4.556192663162955e-06,0,0
17194,grain,2,3.6729057091646343e-06,2,4.556192663162955e-06,0,0
17197,barrage,2,3.6729057091646343e-06,2,4.556192663162955e-06,0,0
17201,greetings,2,3.6729057091646343e-06,2,4.556192663162955e-06,0,0
17208,abruptly,2,3.6729057091646343e-06,2,4.556192663162955e-06,0,0
17210,indicators,2,3.6729057091646343e-06,2,4.556192663162955e-06,0,0
17213,@diamondandsilk,2,3.6729057091646343e-06,2,4.556192663162955e-06,0,0
17223,deporting,2,3.6729057091646343e-06,2,4.556192663162955e-06,0,0
17227,nike,2,3.6729057091646343e-06,2,4.556192663162955e-06,0,0
17233,gutless,2,3.6729057091646343e-06,2,4.556192663162955e-06,0,0
17237,steil,2,3.6729057091646343e-06,2,4.556192663162955e-06,0,0
17241,snap,2,3.6729057091646343e-06,2,4.556192663162955e-06,0,0
17247,southerner,2,3.6729057091646343e-06,2,4.556192663162955e-06,0,0
17245,divide,2,3.6729057091646343e-06,2,4.556192663162955e-06,0,0
17248,exceptionally,2,3.6729057091646343e-06,2,4.556192663162955e-06,0,0
17256,@nhcatlantic,2,3.6729057091646343e-06,2,4.556192663162955e-06,0,0
17262,bashar,2,3.6729057091646343e-06,2,4.556192663162955e-06,0,0
17261,al-assad,2,3.6729057091646343e-06,2,4.556192663162955e-06,0,0
17264,recklessly,2,3.6729057091646343e-06,2,4.556192663162955e-06,0,0
17266,loyalists,2,3.6729057091646343e-06,2,4.556192663162955e-06,0,0
17280,abusing,2,3.6729057091646343e-06,2,4.556192663162955e-06,0,0
17304,suck,2,3.6729057091646343e-06,2,4.556192663162955e-06,0,0
17311,bond,2,3.6729057091646343e-06,2,4.556192663162955e-06,0,0
17328,2026,2,3.6729057091646343e-06,2,4.556192663162955e-06,0,0
17331,suppressing,2,3.6729057091646343e-06,2,4.556192663162955e-06,0,0
17330,situation-will,2,3.6729057091646343e-06,2,4.556192663162955e-06,0,0
17332,viewingreporting,2,3.6729057091646343e-06,2,4.556192663162955e-06,0,0
17344,underneath,2,3.6729057091646343e-06,2,4.556192663162955e-06,0,0
17351,secrecy,2,3.6729057091646343e-06,2,4.556192663162955e-06,0,0
17362,influenced,2,3.6729057091646343e-06,2,4.556192663162955e-06,0,0
17361,considerations,2,3.6729057091646343e-06,2,4.556192663162955e-06,0,0
17363,@drudgereport,2,3.6729057091646343e-06,2,4.556192663162955e-06,0,0
17367,seizures,2,3.6729057091646343e-06,2,4.556192663162955e-06,0,0
17365,expropriations,2,3.6729057091646343e-06,2,4.556192663162955e-06,0,0
17366,seizing,2,3.6729057091646343e-06,2,4.556192663162955e-06,0,0
17372,dov,2,3.6729057091646343e-06,2,4.556192663162955e-06,0,0
17373,hikind,2,3.6729057091646343e-06,2,4.556192663162955e-06,0,0
17374,civic,2,3.6729057091646343e-06,2,4.556192663162955e-06,0,0
17376,reiterate,2,3.6729057091646343e-06,2,4.556192663162955e-06,0,0
17377,yorker,2,3.6729057091646343e-06,2,4.556192663162955e-06,0,0
17380,gubernatorial,2,3.6729057091646343e-06,2,4.556192663162955e-06,0,0
17385,mudd,2,3.6729057091646343e-06,2,4.556192663162955e-06,0,0
17391,heroin,2,3.6729057091646343e-06,2,4.556192663162955e-06,0,0
17398,implying,2,3.6729057091646343e-06,2,4.556192663162955e-06,0,0
17401,secrets,2,3.6729057091646343e-06,2,4.556192663162955e-06,0,0
17403,blank,2,3.6729057091646343e-06,2,4.556192663162955e-06,0,0
17412,actress,2,3.6729057091646343e-06,2,4.556192663162955e-06,0,0
17416,military-,2,3.6729057091646343e-06,2,4.556192663162955e-06,0,0
17418,chocked,2,3.6729057091646343e-06,2,4.556192663162955e-06,0,0
17422,constitutes,2,3.6729057091646343e-06,2,4.556192663162955e-06,0,0
17425,steer,2,3.6729057091646343e-06,2,4.556192663162955e-06,0,0
17426,bragging,2,3.6729057091646343e-06,2,4.556192663162955e-06,0,0
17430,oligarch,2,3.6729057091646343e-06,2,4.556192663162955e-06,0,0
17437,correcting,2,3.6729057091646343e-06,2,4.556192663162955e-06,0,0
17436,assistant,2,3.6729057091646343e-06,2,4.556192663162955e-06,0,0
17440,demoted,2,3.6729057091646343e-06,2,4.556192663162955e-06,0,0
17442,proceeds,2,3.6729057091646343e-06,2,4.556192663162955e-06,0,0
17443,kobach,2,3.6729057091646343e-06,2,4.556192663162955e-06,0,0
17445,haywire,2,3.6729057091646343e-06,2,4.556192663162955e-06,0,0
17449,forwardthis,2,3.6729057091646343e-06,2,4.556192663162955e-06,0,0
17455,dossierthe,2,3.6729057091646343e-06,2,4.556192663162955e-06,0,0
17457,@markburnetttv,2,3.6729057091646343e-06,2,4.556192663162955e-06,0,0
17458,attributed,2,3.6729057091646343e-06,2,4.556192663162955e-06,0,0
17463,majors,2,3.6729057091646343e-06,2,4.556192663162955e-06,0,0
17467,@johnkasich,2,3.6729057091646343e-06,2,4.556192663162955e-06,0,0
17477,stellar,2,3.6729057091646343e-06,2,4.556192663162955e-06,0,0
17479,autoworkers,2,3.6729057091646343e-06,2,4.556192663162955e-06,0,0
17492,biting,2,3.6729057091646343e-06,2,4.556192663162955e-06,0,0
17495,magnified,2,3.6729057091646343e-06,2,4.556192663162955e-06,0,0
17496,utilized,2,3.6729057091646343e-06,2,4.556192663162955e-06,0,0
17499,compromising,2,3.6729057091646343e-06,2,4.556192663162955e-06,0,0
17502,distrust,2,3.6729057091646343e-06,2,4.556192663162955e-06,0,0
17510,lebron,2,3.6729057091646343e-06,2,4.556192663162955e-06,0,0
17515,spacex,2,3.6729057091646343e-06,2,4.556192663162955e-06,0,0
17530,proactively,2,3.6729057091646343e-06,2,4.556192663162955e-06,0,0
17538,@senjohnbarrasso,2,3.6729057091646343e-06,2,4.556192663162955e-06,0,0
17539,kustoff,2,3.6729057091646343e-06,2,4.556192663162955e-06,0,0
17545,wilkie,2,3.6729057091646343e-06,2,4.556192663162955e-06,0,0
17555,asians,2,3.6729057091646343e-06,2,4.556192663162955e-06,0,0
17560,alene,2,3.6729057091646343e-06,2,4.556192663162955e-06,0,0
17567,emotional,2,3.6729057091646343e-06,2,4.556192663162955e-06,0,0
17571,@ussteel,2,3.6729057091646343e-06,2,4.556192663162955e-06,0,0
17574,@junckereu,2,3.6729057091646343e-06,2,4.556192663162955e-06,0,0
17576,dissension,2,3.6729057091646343e-06,2,4.556192663162955e-06,0,0
17605,surveil,2,3.6729057091646343e-06,2,4.556192663162955e-06,0,0
17606,screams,2,3.6729057091646343e-06,2,4.556192663162955e-06,0,0
17618,confrontation,2,3.6729057091646343e-06,2,4.556192663162955e-06,0,0
17624,roby,2,3.6729057091646343e-06,2,4.556192663162955e-06,0,0
17628,exclusively,2,3.6729057091646343e-06,2,4.556192663162955e-06,0,0
17631,🇺🇸🇬🇧,2,3.6729057091646343e-06,2,4.556192663162955e-06,0,0
17670,endured,2,3.6729057091646343e-06,2,4.556192663162955e-06,0,0
17672,242,2,3.6729057091646343e-06,2,4.556192663162955e-06,0,0
17674,greenbrier,2,3.6729057091646343e-06,2,4.556192663162955e-06,0,0
17678,priding,2,3.6729057091646343e-06,2,4.556192663162955e-06,0,0
17676,capitalized,2,3.6729057091646343e-06,2,4.556192663162955e-06,0,0
17682,2500,2,3.6729057091646343e-06,2,4.556192663162955e-06,0,0
17686,infestation,2,3.6729057091646343e-06,2,4.556192663162955e-06,0,0
17688,raving,2,3.6729057091646343e-06,2,4.556192663162955e-06,0,0
17699,newsroom,2,3.6729057091646343e-06,2,4.556192663162955e-06,0,0
17700,collusionand,2,3.6729057091646343e-06,2,4.556192663162955e-06,0,0
17702,reportand,2,3.6729057091646343e-06,2,4.556192663162955e-06,0,0
17707,kremer,2,3.6729057091646343e-06,2,4.556192663162955e-06,0,0
17710,servants,2,3.6729057091646343e-06,2,4.556192663162955e-06,0,0
17715,marcelo,2,3.6729057091646343e-06,2,4.556192663162955e-06,0,0
17731,rightful,2,3.6729057091646343e-06,2,4.556192663162955e-06,0,0
17735,surrendered,2,3.6729057091646343e-06,2,4.556192663162955e-06,0,0
17743,extraordinarily,2,3.6729057091646343e-06,2,4.556192663162955e-06,0,0
17749,huckabee,2,3.6729057091646343e-06,2,4.556192663162955e-06,0,0
17752,clay,2,3.6729057091646343e-06,2,4.556192663162955e-06,0,0
17757,whimpering,2,3.6729057091646343e-06,2,4.556192663162955e-06,0,0
17759,reciprocity,2,3.6729057091646343e-06,2,4.556192663162955e-06,0,0
17775,pathetically,2,3.6729057091646343e-06,2,4.556192663162955e-06,0,0
17783,swiftly,2,3.6729057091646343e-06,2,4.556192663162955e-06,0,0
17807,trey,2,3.6729057091646343e-06,2,4.556192663162955e-06,0,0
17809,bezos,2,3.6729057091646343e-06,2,4.556192663162955e-06,0,0
17818,breakup,2,3.6729057091646343e-06,2,4.556192663162955e-06,0,0
17822,dynasty,2,3.6729057091646343e-06,2,4.556192663162955e-06,0,0
17823,punchy,2,3.6729057091646343e-06,2,4.556192663162955e-06,0,0
17830,tarkanian,2,3.6729057091646343e-06,2,4.556192663162955e-06,0,0
17836,assuming,2,3.6729057091646343e-06,2,4.556192663162955e-06,0,0
17839,niro,2,3.6729057091646343e-06,2,4.556192663162955e-06,0,0
17838,boxers,2,3.6729057091646343e-06,2,4.556192663162955e-06,0,0
17840,punch-drunk,2,3.6729057091646343e-06,2,4.556192663162955e-06,0,0
17851,stoped,2,3.6729057091646343e-06,2,4.556192663162955e-06,0,0
17865,one-time,2,3.6729057091646343e-06,2,4.556192663162955e-06,0,0
17867,serviceman,2,3.6729057091646343e-06,2,4.556192663162955e-06,0,0
17870,capitals,2,3.6729057091646343e-06,2,4.556192663162955e-06,0,0
17873,non-monetary,2,3.6729057091646343e-06,2,4.556192663162955e-06,0,0
17897,nixon,2,3.6729057091646343e-06,2,4.556192663162955e-06,0,0
17900,counter-intelligence,2,3.6729057091646343e-06,2,4.556192663162955e-06,0,0
17910,@martintruexjr,2,3.6729057091646343e-06,2,4.556192663162955e-06,0,0
17918,eagles,2,3.6729057091646343e-06,2,4.556192663162955e-06,0,0
17921,offensesconstitution,2,3.6729057091646343e-06,2,4.556192663162955e-06,0,0
17922,thisstormtrooper,2,3.6729057091646343e-06,2,4.556192663162955e-06,0,0
17923,tolerated,2,3.6729057091646343e-06,2,4.556192663162955e-06,0,0
17935,informants,2,3.6729057091646343e-06,2,4.556192663162955e-06,0,0
17936,iger,2,3.6729057091646343e-06,2,4.556192663162955e-06,0,0
17938,infiltrating,2,3.6729057091646343e-06,2,4.556192663162955e-06,0,0
17939,recusal,2,3.6729057091646343e-06,2,4.556192663162955e-06,0,0
17940,unforced,2,3.6729057091646343e-06,2,4.556192663162955e-06,0,0
17941,@repdandonovan,2,3.6729057091646343e-06,2,4.556192663162955e-06,0,0
17946,experimental,2,3.6729057091646343e-06,2,4.556192663162955e-06,0,0
17964,gentle,2,3.6729057091646343e-06,2,4.556192663162955e-06,0,0
17970,drawn,2,3.6729057091646343e-06,2,4.556192663162955e-06,0,0
17974,@arlingtonnatl,2,3.6729057091646343e-06,2,4.556192663162955e-06,0,0
17979,arrangements,2,3.6729057091646343e-06,2,4.556192663162955e-06,0,0
17986,#spygate,2,3.6729057091646343e-06,2,4.556192663162955e-06,0,0
17987,reinstated,2,3.6729057091646343e-06,2,4.556192663162955e-06,0,0
17995,@navalacademy,2,3.6729057091646343e-06,2,4.556192663162955e-06,0,0
18000,expenditure,2,3.6729057091646343e-06,2,4.556192663162955e-06,0,0
18009,bethpage,2,3.6729057091646343e-06,2,4.556192663162955e-06,0,0
18011,ranks,2,3.6729057091646343e-06,2,4.556192663162955e-06,0,0
18013,enabled,2,3.6729057091646343e-06,2,4.556192663162955e-06,0,0
18018,structure,2,3.6729057091646343e-06,2,4.556192663162955e-06,0,0
18022,@asahutchinson,2,3.6729057091646343e-06,2,4.556192663162955e-06,0,0
18042,liu,2,3.6729057091646343e-06,2,4.556192663162955e-06,0,0
18047,historyand,2,3.6729057091646343e-06,2,4.556192663162955e-06,0,0
18055,deb,2,3.6729057091646343e-06,2,4.556192663162955e-06,0,0
18056,fischer,2,3.6729057091646343e-06,2,4.556192663162955e-06,0,0
18058,procedure,2,3.6729057091646343e-06,2,4.556192663162955e-06,0,0
18061,exaggeration,2,3.6729057091646343e-06,2,4.556192663162955e-06,0,0
18062,traitors,2,3.6729057091646343e-06,2,4.556192663162955e-06,0,0
18063,reflective,2,3.6729057091646343e-06,2,4.556192663162955e-06,0,0
18067,gesture,2,3.6729057091646343e-06,2,4.556192663162955e-06,0,0
18070,awol,2,3.6729057091646343e-06,2,4.556192663162955e-06,0,0
18074,thinkers,2,3.6729057091646343e-06,2,4.556192663162955e-06,0,0
18080,pounds,2,3.6729057091646343e-06,2,4.556192663162955e-06,0,0
18093,@andypuzder,2,3.6729057091646343e-06,2,4.556192663162955e-06,0,0
18095,timeless,2,3.6729057091646343e-06,2,4.556192663162955e-06,0,0
18097,clifford,2,3.6729057091646343e-06,2,4.556192663162955e-06,0,0
18112,analyst,2,3.6729057091646343e-06,2,4.556192663162955e-06,0,0
18125,freshman,2,3.6729057091646343e-06,2,4.556192663162955e-06,0,0
18129,seth,2,3.6729057091646343e-06,2,4.556192663162955e-06,0,0
18133,unreal,2,3.6729057091646343e-06,2,4.556192663162955e-06,0,0
18136,admire,2,3.6729057091646343e-06,2,4.556192663162955e-06,0,0
18142,brigitte,2,3.6729057091646343e-06,2,4.556192663162955e-06,0,0
18143,perfection,2,3.6729057091646343e-06,2,4.556192663162955e-06,0,0
18147,@jimrenacci,2,3.6729057091646343e-06,2,4.556192663162955e-06,0,0
18150,@debbielesko,2,3.6729057091646343e-06,2,4.556192663162955e-06,0,0
18164,drunkdrugged,2,3.6729057091646343e-06,2,4.556192663162955e-06,0,0
18163,accountlawyer,2,3.6729057091646343e-06,2,4.556192663162955e-06,0,0
18165,flunkie,2,3.6729057091646343e-06,2,4.556192663162955e-06,0,0
18186,deploy,2,3.6729057091646343e-06,2,4.556192663162955e-06,0,0
18190,nonexistent,2,3.6729057091646343e-06,2,4.556192663162955e-06,0,0
18194,profitable,2,3.6729057091646343e-06,2,4.556192663162955e-06,0,0
18208,#taxcuts,2,3.6729057091646343e-06,2,4.556192663162955e-06,0,0
18211,cobb,2,3.6729057091646343e-06,2,4.556192663162955e-06,0,0
18216,atrocity,2,3.6729057091646343e-06,2,4.556192663162955e-06,0,0
18222,kills,2,3.6729057091646343e-06,2,4.556192663162955e-06,0,0
18224,schoen,2,3.6729057091646343e-06,2,4.556192663162955e-06,0,0
18230,barriersalso,2,3.6729057091646343e-06,2,4.556192663162955e-06,0,0
18237,novel,2,3.6729057091646343e-06,2,4.556192663162955e-06,0,0
18239,@wattersworld,2,3.6729057091646343e-06,2,4.556192663162955e-06,0,0
18246,amazons,2,3.6729057091646343e-06,2,4.556192663162955e-06,0,0
18247,defiant,2,3.6729057091646343e-06,2,4.556192663162955e-06,0,0
18253,bruno,2,3.6729057091646343e-06,2,4.556192663162955e-06,0,0
18264,po,2,3.6729057091646343e-06,2,4.556192663162955e-06,0,0
18270,egg,2,3.6729057091646343e-06,2,4.556192663162955e-06,0,0
18280,lobbying,2,3.6729057091646343e-06,2,4.556192663162955e-06,0,0
18293,stevens,2,3.6729057091646343e-06,2,4.556192663162955e-06,0,0
18297,greek,2,3.6729057091646343e-06,2,4.556192663162955e-06,0,0
18308,insufficient,2,3.6729057091646343e-06,2,4.556192663162955e-06,0,0
18306,contacts,2,3.6729057091646343e-06,2,4.556192663162955e-06,0,0
18315,schlapp,2,3.6729057091646343e-06,2,4.556192663162955e-06,0,0
18316,probable,2,3.6729057091646343e-06,2,4.556192663162955e-06,0,0
18330,varadkar,2,3.6729057091646343e-06,2,4.556192663162955e-06,0,0
18340,miramar,2,3.6729057091646343e-06,2,4.556192663162955e-06,0,0
18342,importation,2,3.6729057091646343e-06,2,4.556192663162955e-06,0,0
18351,@saccone4pa18,2,3.6729057091646343e-06,2,4.556192663162955e-06,0,0
18356,diplomatically,2,3.6729057091646343e-06,2,4.556192663162955e-06,0,0
18363,adjusting,2,3.6729057091646343e-06,2,4.556192663162955e-06,0,0
18365,6000000,2,3.6729057091646343e-06,2,4.556192663162955e-06,0,0
18374,alec,2,3.6729057091646343e-06,2,4.556192663162955e-06,0,0
18375,baldwin,2,3.6729057091646343e-06,2,4.556192663162955e-06,0,0
18379,mediocre,2,3.6729057091646343e-06,2,4.556192663162955e-06,0,0
18378,impersonation,2,3.6729057091646343e-06,2,4.556192663162955e-06,0,0
18380,snl,2,3.6729057091646343e-06,2,4.556192663162955e-06,0,0
18377,hammond,2,3.6729057091646343e-06,2,4.556192663162955e-06,0,0
18376,funnier,2,3.6729057091646343e-06,2,4.556192663162955e-06,0,0
18388,revival,2,3.6729057091646343e-06,2,4.556192663162955e-06,0,0
18437,accusation,2,3.6729057091646343e-06,2,4.556192663162955e-06,0,0
18439,kissed,2,3.6729057091646343e-06,2,4.556192663162955e-06,0,0
18443,reversing,2,3.6729057091646343e-06,2,4.556192663162955e-06,0,0
18445,successor,2,3.6729057091646343e-06,2,4.556192663162955e-06,0,0
18446,insecure,2,3.6729057091646343e-06,2,4.556192663162955e-06,0,0
18447,oprah,2,3.6729057091646343e-06,2,4.556192663162955e-06,0,0
18448,insight,2,3.6729057091646343e-06,2,4.556192663162955e-06,0,0
18452,meddle,2,3.6729057091646343e-06,2,4.556192663162955e-06,0,0
18454,basics,2,3.6729057091646343e-06,2,4.556192663162955e-06,0,0
18478,@westervillepd,2,3.6729057091646343e-06,2,4.556192663162955e-06,0,0
18487,vindicated,2,3.6729057091646343e-06,2,4.556192663162955e-06,0,0
18486,victimized,2,3.6729057091646343e-06,2,4.556192663162955e-06,0,0
18489,whereupon,2,3.6729057091646343e-06,2,4.556192663162955e-06,0,0
18488,re-do,2,3.6729057091646343e-06,2,4.556192663162955e-06,0,0
18494,#nationalprayerbreakfast,2,3.6729057091646343e-06,2,4.556192663162955e-06,0,0
18497,declares,2,3.6729057091646343e-06,2,4.556192663162955e-06,0,0
18507,edwin,2,3.6729057091646343e-06,2,4.556192663162955e-06,0,0
18506,@colts,2,3.6729057091646343e-06,2,4.556192663162955e-06,0,0
18515,vindicates,2,3.6729057091646343e-06,2,4.556192663162955e-06,0,0
18526,politicized,2,3.6729057091646343e-06,2,4.556192663162955e-06,0,0
18530,kabul,2,3.6729057091646343e-06,2,4.556192663162955e-06,0,0
18533,increasingly,2,3.6729057091646343e-06,2,4.556192663162955e-06,0,0
18560,@jennaellisrives,2,3.6729057091646343e-06,2,4.556192663162955e-06,0,0
18571,peanuts,2,3.6729057091646343e-06,2,4.556192663162955e-06,0,0
18574,rivers,2,3.6729057091646343e-06,2,4.556192663162955e-06,0,0
18583,durbin,2,3.6729057091646343e-06,2,4.556192663162955e-06,0,0
18584,misrepresented,2,3.6729057091646343e-06,2,4.556192663162955e-06,0,0
18591,haitians,2,3.6729057091646343e-06,2,4.556192663162955e-06,0,0
18596,trumppence,2,3.6729057091646343e-06,2,4.556192663162955e-06,0,0
18615,decaying,2,3.6729057091646343e-06,2,4.556192663162955e-06,0,0
18617,wounding,2,3.6729057091646343e-06,2,4.556192663162955e-06,0,0
18621,coupled,2,3.6729057091646343e-06,2,4.556192663162955e-06,0,0
18625,@jonvoight,2,3.6729057091646343e-06,2,4.556192663162955e-06,0,0
18632,ploy,2,3.6729057091646343e-06,2,4.556192663162955e-06,0,0
18654,outreach,2,3.6729057091646343e-06,2,4.556192663162955e-06,0,0
18657,malpractice,2,3.6729057091646343e-06,2,4.556192663162955e-06,0,0
18663,lessand,2,3.6729057091646343e-06,2,4.556192663162955e-06,0,0
18677,@navyfb,2,3.6729057091646343e-06,2,4.556192663162955e-06,0,0
18683,trampled,2,3.6729057091646343e-06,2,4.556192663162955e-06,0,0
18682,irreparable,2,3.6729057091646343e-06,2,4.556192663162955e-06,0,0
18687,meister,2,3.6729057091646343e-06,2,4.556192663162955e-06,0,0
18689,appears,2,3.6729057091646343e-06,2,4.556192663162955e-06,0,0
18695,greta,2,3.6729057091646343e-06,2,4.556192663162955e-06,0,0
18702,hershey,2,3.6729057091646343e-06,2,4.556192663162955e-06,0,0
18708,@danhenninger,2,3.6729057091646343e-06,2,4.556192663162955e-06,0,0
18712,@repswalwell,2,3.6729057091646343e-06,2,4.556192663162955e-06,0,0
18724,loaning,2,3.6729057091646343e-06,2,4.556192663162955e-06,0,0
18730,lance,2,3.6729057091646343e-06,2,4.556192663162955e-06,0,0
18731,decisively,2,3.6729057091646343e-06,2,4.556192663162955e-06,0,0
18741,composite,2,3.6729057091646343e-06,2,4.556192663162955e-06,0,0
18749,2024,2,3.6729057091646343e-06,2,4.556192663162955e-06,0,0
18759,rips,2,3.6729057091646343e-06,2,4.556192663162955e-06,0,0
18764,trident,2,3.6729057091646343e-06,2,4.556192663162955e-06,0,0
18766,peacefully,2,3.6729057091646343e-06,2,4.556192663162955e-06,0,0
18769,gallaghers,2,3.6729057091646343e-06,2,4.556192663162955e-06,0,0
18771,reseached,2,3.6729057091646343e-06,2,4.556192663162955e-06,0,0
18779,appease,2,3.6729057091646343e-06,2,4.556192663162955e-06,0,0
18796,conflicting,2,3.6729057091646343e-06,2,4.556192663162955e-06,0,0
18795,ambiguous,2,3.6729057091646343e-06,2,4.556192663162955e-06,0,0
18806,swalwell,2,3.6729057091646343e-06,2,4.556192663162955e-06,0,0
18808,theyd,2,3.6729057091646343e-06,2,4.556192663162955e-06,0,0
18811,@repmiketurner,2,3.6729057091646343e-06,2,4.556192663162955e-06,0,0
18820,#geauxvote,2,3.6729057091646343e-06,2,4.556192663162955e-06,0,0
18821,#lagov,2,3.6729057091646343e-06,2,4.556192663162955e-06,0,0
18845,showtrial,2,3.6729057091646343e-06,2,4.556192663162955e-06,0,0
18852,@seanspicer,2,3.6729057091646343e-06,2,4.556192663162955e-06,0,0
18871,donalds,2,3.6729057091646343e-06,2,4.556192663162955e-06,0,0
18885,clearing,2,3.6729057091646343e-06,2,4.556192663162955e-06,0,0
18909,sidewalks,2,3.6729057091646343e-06,2,4.556192663162955e-06,0,0
18908,resigning,2,3.6729057091646343e-06,2,4.556192663162955e-06,0,0
18912,lexington,2,3.6729057091646343e-06,2,4.556192663162955e-06,0,0
18913,@nationals,2,3.6729057091646343e-06,2,4.556192663162955e-06,0,0
18914,matts,2,3.6729057091646343e-06,2,4.556192663162955e-06,0,0
18921,geary,2,3.6729057091646343e-06,2,4.556192663162955e-06,0,0
18922,higgins,2,3.6729057091646343e-06,2,4.556192663162955e-06,0,0
18935,kag,2,3.6729057091646343e-06,2,4.556192663162955e-06,0,0
18936,burns,2,3.6729057091646343e-06,2,4.556192663162955e-06,0,0
18944,howie,2,3.6729057091646343e-06,2,4.556192663162955e-06,0,0
18945,wonerful,2,3.6729057091646343e-06,2,4.556192663162955e-06,0,0
18946,upstate,2,3.6729057091646343e-06,2,4.556192663162955e-06,0,0
18954,rocks,2,3.6729057091646343e-06,2,4.556192663162955e-06,0,0
18964,@greggutfeldshow,2,3.6729057091646343e-06,2,4.556192663162955e-06,0,0
18973,recreation,2,3.6729057091646343e-06,2,4.556192663162955e-06,0,0
18979,@toyota,2,3.6729057091646343e-06,2,4.556192663162955e-06,0,0
18983,sandman,2,3.6729057091646343e-06,2,4.556192663162955e-06,0,0
18989,abu,2,3.6729057091646343e-06,2,4.556192663162955e-06,0,0
18991,bakr,2,3.6729057091646343e-06,2,4.556192663162955e-06,0,0
18994,jj,2,3.6729057091646343e-06,2,4.556192663162955e-06,0,0
18996,@steph93065,2,3.6729057091646343e-06,2,4.556192663162955e-06,0,0
19004,pro-crooked,2,3.6729057091646343e-06,2,4.556192663162955e-06,0,0
19006,disposing,2,3.6729057091646343e-06,2,4.556192663162955e-06,0,0
19007,expired,2,3.6729057091646343e-06,2,4.556192663162955e-06,0,0
19008,medications,2,3.6729057091646343e-06,2,4.556192663162955e-06,0,0
19005,10am-2pm,2,3.6729057091646343e-06,2,4.556192663162955e-06,0,0
19017,tulsi,2,3.6729057091646343e-06,2,4.556192663162955e-06,0,0
19015,gabbard,2,3.6729057091646343e-06,2,4.556192663162955e-06,0,0
19021,suspends,2,3.6729057091646343e-06,2,4.556192663162955e-06,0,0
19043,#shaleinsight2019,2,3.6729057091646343e-06,2,4.556192663162955e-06,0,0
19049,kurdish,2,3.6729057091646343e-06,2,4.556192663162955e-06,0,0
19055,ukrainians,2,3.6729057091646343e-06,2,4.556192663162955e-06,0,0
19056,185,2,3.6729057091646343e-06,2,4.556192663162955e-06,0,0
19060,censure,2,3.6729057091646343e-06,2,4.556192663162955e-06,0,0
19064,democratfake,2,3.6729057091646343e-06,2,4.556192663162955e-06,0,0
19065,permissible,2,3.6729057091646343e-06,2,4.556192663162955e-06,0,0
19069,skirmishes,2,3.6729057091646343e-06,2,4.556192663162955e-06,0,0
19068,resettled,2,3.6729057091646343e-06,2,4.556192663162955e-06,0,0
19073,withhold,2,3.6729057091646343e-06,2,4.556192663162955e-06,0,0
19083,@jasonchaffetz,2,3.6729057091646343e-06,2,4.556192663162955e-06,0,0
19091,bureaucrats,2,3.6729057091646343e-06,2,4.556192663162955e-06,0,0
19095,permits,2,3.6729057091646343e-06,2,4.556192663162955e-06,0,0
19093,#trumprallydallas,2,3.6729057091646343e-06,2,4.556192663162955e-06,0,0
19107,fabricating,2,3.6729057091646343e-06,2,4.556192663162955e-06,0,0
19111,smuggling,2,3.6729057091646343e-06,2,4.556192663162955e-06,0,0
19119,@stlouisblues,2,3.6729057091646343e-06,2,4.556192663162955e-06,0,0
19136,europeans,2,3.6729057091646343e-06,2,4.556192663162955e-06,0,0
19140,anguilla,2,3.6729057091646343e-06,2,4.556192663162955e-06,0,0
19153,quicksand,2,3.6729057091646343e-06,2,4.556192663162955e-06,0,0
19157,@debfisher,2,3.6729057091646343e-06,2,4.556192663162955e-06,0,0
19159,mathew,2,3.6729057091646343e-06,2,4.556192663162955e-06,0,0
19160,aides,2,3.6729057091646343e-06,2,4.556192663162955e-06,0,0
19161,@docabraham,2,3.6729057091646343e-06,2,4.556192663162955e-06,0,0
19167,electing,2,3.6729057091646343e-06,2,4.556192663162955e-06,0,0
19166,@lagop,2,3.6729057091646343e-06,2,4.556192663162955e-06,0,0
19168,mcaleenan,2,3.6729057091646343e-06,2,4.556192663162955e-06,0,0
19170,mix,2,3.6729057091646343e-06,2,4.556192663162955e-06,0,0
19173,oecd,2,3.6729057091646343e-06,2,4.556192663162955e-06,0,0
19185,policing,2,3.6729057091646343e-06,2,4.556192663162955e-06,0,0
19196,crystal,2,3.6729057091646343e-06,2,4.556192663162955e-06,0,0
19207,capture,2,3.6729057091646343e-06,2,4.556192663162955e-06,0,0
19215,contradicts,2,3.6729057091646343e-06,2,4.556192663162955e-06,0,0
19230,gate,2,3.6729057091646343e-06,2,4.556192663162955e-06,0,0
19237,schweizer,2,3.6729057091646343e-06,2,4.556192663162955e-06,0,0
19242,ass,2,3.6729057091646343e-06,2,4.556192663162955e-06,0,0
19243,pertained,2,3.6729057091646343e-06,2,4.556192663162955e-06,0,0
19254,unsubstantiated,2,3.6729057091646343e-06,2,4.556192663162955e-06,0,0
19250,dagger,2,3.6729057091646343e-06,2,4.556192663162955e-06,0,0
19251,fairytale,2,3.6729057091646343e-06,2,4.556192663162955e-06,0,0
19261,simultaneously,2,3.6729057091646343e-06,2,4.556192663162955e-06,0,0
19263,holes,2,3.6729057091646343e-06,2,4.556192663162955e-06,0,0
19267,moat,2,3.6729057091646343e-06,2,4.556192663162955e-06,0,0
19275,bullshit,2,3.6729057091646343e-06,2,4.556192663162955e-06,0,0
19276,brains,2,3.6729057091646343e-06,2,4.556192663162955e-06,0,0
19278,alligators,2,3.6729057091646343e-06,2,4.556192663162955e-06,0,0
19279,electrified,2,3.6729057091646343e-06,2,4.556192663162955e-06,0,0
19280,spikes,2,3.6729057091646343e-06,2,4.556192663162955e-06,0,0
19302,suppliers,2,3.6729057091646343e-06,2,4.556192663162955e-06,0,0
19321,@rjccw,2,3.6729057091646343e-06,2,4.556192663162955e-06,0,0
19323,tore,2,3.6729057091646343e-06,2,4.556192663162955e-06,0,0
19322,shreds,2,3.6729057091646343e-06,2,4.556192663162955e-06,0,0
19336,namely,2,3.6729057091646343e-06,2,4.556192663162955e-06,0,0
19337,boldly,2,3.6729057091646343e-06,2,4.556192663162955e-06,0,0
19362,@mediabuzzfnc,2,3.6729057091646343e-06,2,4.556192663162955e-06,0,0
19363,collecting,2,3.6729057091646343e-06,2,4.556192663162955e-06,0,0
19365,oligarchs,2,3.6729057091646343e-06,2,4.556192663162955e-06,0,0
19379,dicey,2,3.6729057091646343e-06,2,4.556192663162955e-06,0,0
19397,@starcenter,2,3.6729057091646343e-06,2,4.556192663162955e-06,0,0
19399,virtue,2,3.6729057091646343e-06,2,4.556192663162955e-06,0,0
19401,netflix,2,3.6729057091646343e-06,2,4.556192663162955e-06,0,0
19405,incident,2,3.6729057091646343e-06,2,4.556192663162955e-06,0,0
19410,tankers,2,3.6729057091646343e-06,2,4.556192663162955e-06,0,0
19425,recrimination,2,3.6729057091646343e-06,2,4.556192663162955e-06,0,0
19442,respective,2,3.6729057091646343e-06,2,4.556192663162955e-06,0,0
19451,03,2,3.6729057091646343e-06,2,4.556192663162955e-06,0,0
19455,parson,2,3.6729057091646343e-06,2,4.556192663162955e-06,0,0
19461,mcas,2,3.6729057091646343e-06,2,4.556192663162955e-06,0,0
19460,cherry,2,3.6729057091646343e-06,2,4.556192663162955e-06,0,0
19464,doonbeg,2,3.6729057091646343e-06,2,4.556192663162955e-06,0,0
19467,investor,2,3.6729057091646343e-06,2,4.556192663162955e-06,0,0
19481,deceiving,2,3.6729057091646343e-06,2,4.556192663162955e-06,0,0
19491,bahamian,2,3.6729057091646343e-06,2,4.556192663162955e-06,0,0
19501,dose,2,3.6729057091646343e-06,2,4.556192663162955e-06,0,0
19527,ducking,2,3.6729057091646343e-06,2,4.556192663162955e-06,0,0
19528,zell,2,3.6729057091646343e-06,2,4.556192663162955e-06,0,0
19532,tillis,2,3.6729057091646343e-06,2,4.556192663162955e-06,0,0
19541,brazilian,2,3.6729057091646343e-06,2,4.556192663162955e-06,0,0
19542,counter-intuitive,2,3.6729057091646343e-06,2,4.556192663162955e-06,0,0
19543,stems,2,3.6729057091646343e-06,2,4.556192663162955e-06,0,0
19544,scenarios,2,3.6729057091646343e-06,2,4.556192663162955e-06,0,0
19551,columnist,2,3.6729057091646343e-06,2,4.556192663162955e-06,0,0
19562,importers,2,3.6729057091646343e-06,2,4.556192663162955e-06,0,0
19563,riley,2,3.6729057091646343e-06,2,4.556192663162955e-06,0,0
19565,confidentiality,2,3.6729057091646343e-06,2,4.556192663162955e-06,0,0
19574,@nws,2,3.6729057091646343e-06,2,4.556192663162955e-06,0,0
19596,odonnell,2,3.6729057091646343e-06,2,4.556192663162955e-06,0,0
19609,axios,2,3.6729057091646343e-06,2,4.556192663162955e-06,0,0
19614,giuseppe,2,3.6729057091646343e-06,2,4.556192663162955e-06,0,0
19620,hôtel,2,3.6729057091646343e-06,2,4.556192663162955e-06,0,0
19619,du,2,3.6729057091646343e-06,2,4.556192663162955e-06,0,0
19621,palais,2,3.6729057091646343e-06,2,4.556192663162955e-06,0,0
19626,@emanuelmacrone,2,3.6729057091646343e-06,2,4.556192663162955e-06,0,0
19628,vetoed,2,3.6729057091646343e-06,2,4.556192663162955e-06,0,0
19634,messiah,2,3.6729057091646343e-06,2,4.556192663162955e-06,0,0
19649,dearly,2,3.6729057091646343e-06,2,4.556192663162955e-06,0,0
19668,greenland,2,3.6729057091646343e-06,2,4.556192663162955e-06,0,0
19671,@laraleatrump,2,3.6729057091646343e-06,2,4.556192663162955e-06,0,0
19673,tlaibs,2,3.6729057091646343e-06,2,4.556192663162955e-06,0,0
19672,anti-semite,2,3.6729057091646343e-06,2,4.556192663162955e-06,0,0
19683,wheedled,2,3.6729057091646343e-06,2,4.556192663162955e-06,0,0
19682,incompetence-made,2,3.6729057091646343e-06,2,4.556192663162955e-06,0,0
19706,maxed,2,3.6729057091646343e-06,2,4.556192663162955e-06,0,0
19707,cortez,2,3.6729057091646343e-06,2,4.556192663162955e-06,0,0
19725,mccarthys,2,3.6729057091646343e-06,2,4.556192663162955e-06,0,0
19727,humanely,2,3.6729057091646343e-06,2,4.556192663162955e-06,0,0
19743,schilling,2,3.6729057091646343e-06,2,4.556192663162955e-06,0,0
19744,explosion,2,3.6729057091646343e-06,2,4.556192663162955e-06,0,0
19746,@arthurschwartz,2,3.6729057091646343e-06,2,4.556192663162955e-06,0,0
19752,@erinburnett,2,3.6729057091646343e-06,2,4.556192663162955e-06,0,0
19771,coats,2,3.6729057091646343e-06,2,4.556192663162955e-06,0,0
19776,amazed,2,3.6729057091646343e-06,2,4.556192663162955e-06,0,0
19791,boosted,2,3.6729057091646343e-06,2,4.556192663162955e-06,0,0
19792,cernekee,2,3.6729057091646343e-06,2,4.556192663162955e-06,0,0
19797,wounds,2,3.6729057091646343e-06,2,4.556192663162955e-06,0,0
19799,unbiased,2,3.6729057091646343e-06,2,4.556192663162955e-06,0,0
19809,miserable,2,3.6729057091646343e-06,2,4.556192663162955e-06,0,0
19814,re-negotiate,2,3.6729057091646343e-06,2,4.556192663162955e-06,0,0
19822,spencer,2,3.6729057091646343e-06,2,4.556192663162955e-06,0,0
19821,rescind,2,3.6729057091646343e-06,2,4.556192663162955e-06,0,0
19835,jamestown,2,3.6729057091646343e-06,2,4.556192663162955e-06,0,0
19862,@thomashomanice,2,3.6729057091646343e-06,2,4.556192663162955e-06,0,0
19869,impeded,2,3.6729057091646343e-06,2,4.556192663162955e-06,0,0
19891,conservatism,2,3.6729057091646343e-06,2,4.556192663162955e-06,0,0
19894,#freerocky,2,3.6729057091646343e-06,2,4.556192663162955e-06,0,0
19896,stefan,2,3.6729057091646343e-06,2,4.556192663162955e-06,0,0
19895,löfven,2,3.6729057091646343e-06,2,4.556192663162955e-06,0,0
19897,troublemakers,2,3.6729057091646343e-06,2,4.556192663162955e-06,0,0
19899,medias,2,3.6729057091646343e-06,2,4.556192663162955e-06,0,0
19905,@tpusa,2,3.6729057091646343e-06,2,4.556192663162955e-06,0,0
19909,morgenthau,2,3.6729057091646343e-06,2,4.556192663162955e-06,0,0
19915,reams,2,3.6729057091646343e-06,2,4.556192663162955e-06,0,0
19928,columns,2,3.6729057091646343e-06,2,4.556192663162955e-06,0,0
19930,friedman,2,3.6729057091646343e-06,2,4.556192663162955e-06,0,0
19931,unofficially,2,3.6729057091646343e-06,2,4.556192663162955e-06,0,0
19934,gene,2,3.6729057091646343e-06,2,4.556192663162955e-06,0,0
19937,@specialolympics,2,3.6729057091646343e-06,2,4.556192663162955e-06,0,0
19949,robbing,2,3.6729057091646343e-06,2,4.556192663162955e-06,0,0
19955,consuming,2,3.6729057091646343e-06,2,4.556192663162955e-06,0,0
19966,wedded,2,3.6729057091646343e-06,2,4.556192663162955e-06,0,0
19973,concentration,2,3.6729057091646343e-06,2,4.556192663162955e-06,0,0
19980,mouths,2,3.6729057091646343e-06,2,4.556192663162955e-06,0,0
19992,duck,2,3.6729057091646343e-06,2,4.556192663162955e-06,0,0
19997,aerospace,2,3.6729057091646343e-06,2,4.556192663162955e-06,0,0
20007,lessen,2,3.6729057091646343e-06,2,4.556192663162955e-06,0,0
20008,relocate,2,3.6729057091646343e-06,2,4.556192663162955e-06,0,0
20017,banking,2,3.6729057091646343e-06,2,4.556192663162955e-06,0,0
20028,escalator,2,3.6729057091646343e-06,2,4.556192663162955e-06,0,0
20029,sikorsky,2,3.6729057091646343e-06,2,4.556192663162955e-06,0,0
20032,emoluments,2,3.6729057091646343e-06,2,4.556192663162955e-06,0,0
20033,bites,2,3.6729057091646343e-06,2,4.556192663162955e-06,0,0
20049,marillyn,2,3.6729057091646343e-06,2,4.556192663162955e-06,0,0
20047,hewson,2,3.6729057091646343e-06,2,4.556192663162955e-06,0,0
20052,kidney,2,3.6729057091646343e-06,2,4.556192663162955e-06,0,0
20058,strained,2,3.6729057091646343e-06,2,4.556192663162955e-06,0,0
20059,participation,2,3.6729057091646343e-06,2,4.556192663162955e-06,0,0
20067,eastman,2,3.6729057091646343e-06,2,4.556192663162955e-06,0,0
20079,600pm,2,3.6729057091646343e-06,2,4.556192663162955e-06,0,0
20080,celebrations,2,3.6729057091646343e-06,2,4.556192663162955e-06,0,0
20096,shelton,2,3.6729057091646343e-06,2,4.556192663162955e-06,0,0
20095,reconstruction,2,3.6729057091646343e-06,2,4.556192663162955e-06,0,0
20100,grucci,2,3.6729057091646343e-06,2,4.556192663162955e-06,0,0
20103,overs,2,3.6729057091646343e-06,2,4.556192663162955e-06,0,0
20117,congratulated,2,3.6729057091646343e-06,2,4.556192663162955e-06,0,0
20119,toasted,2,3.6729057091646343e-06,2,4.556192663162955e-06,0,0
20118,dmz,2,3.6729057091646343e-06,2,4.556192663162955e-06,0,0
20121,#g20osakasummit,2,3.6729057091646343e-06,2,4.556192663162955e-06,0,0
20129,@parscale,2,3.6729057091646343e-06,2,4.556192663162955e-06,0,0
20135,draghi,2,3.6729057091646343e-06,2,4.556192663162955e-06,0,0
20139,osaka,2,3.6729057091646343e-06,2,4.556192663162955e-06,0,0
20138,japan🇺🇸🇯🇵,2,3.6729057091646343e-06,2,4.556192663162955e-06,0,0
20143,fing,2,3.6729057091646343e-06,2,4.556192663162955e-06,0,0
20151,bellavia,2,3.6729057091646343e-06,2,4.556192663162955e-06,0,0
20158,4s,2,3.6729057091646343e-06,2,4.556192663162955e-06,0,0
20159,5s,2,3.6729057091646343e-06,2,4.556192663162955e-06,0,0
20160,billionmonth,2,3.6729057091646343e-06,2,4.556192663162955e-06,0,0
20165,unmanned,2,3.6729057091646343e-06,2,4.556192663162955e-06,0,0
20175,#trump2020🇺🇸,2,3.6729057091646343e-06,2,4.556192663162955e-06,0,0
20188,ocasio-cortez,2,3.6729057091646343e-06,2,4.556192663162955e-06,0,0
20194,hegseth,2,3.6729057091646343e-06,2,4.556192663162955e-06,0,0
20199,dissect,2,3.6729057091646343e-06,2,4.556192663162955e-06,0,0
20205,@markwarner,2,3.6729057091646343e-06,2,4.556192663162955e-06,0,0
20213,ayatollah,2,3.6729057091646343e-06,2,4.556192663162955e-06,0,0
20214,khamenei,2,3.6729057091646343e-06,2,4.556192663162955e-06,0,0
20224,shafted,2,3.6729057091646343e-06,2,4.556192663162955e-06,0,0
20233,74000,2,3.6729057091646343e-06,2,4.556192663162955e-06,0,0
20241,nadlers,2,3.6729057091646343e-06,2,4.556192663162955e-06,0,0
20248,@teampenske,2,3.6729057091646343e-06,2,4.556192663162955e-06,0,0
20249,anticipate,2,3.6729057091646343e-06,2,4.556192663162955e-06,0,0
20262,famer,2,3.6729057091646343e-06,2,4.556192663162955e-06,0,0
20282,#usstatevisit🇺🇸🇬🇧,2,3.6729057091646343e-06,2,4.556192663162955e-06,0,0
20298,invaded,2,3.6729057091646343e-06,2,4.556192663162955e-06,0,0
20304,lords,2,3.6729057091646343e-06,2,4.556192663162955e-06,0,0
20308,emmet,2,3.6729057091646343e-06,2,4.556192663162955e-06,0,0
20321,thad,2,3.6729057091646343e-06,2,4.556192663162955e-06,0,0
20322,hoaxand,2,3.6729057091646343e-06,2,4.556192663162955e-06,0,0
20330,formation,2,3.6729057091646343e-06,2,4.556192663162955e-06,0,0
20343,smiled,2,3.6729057091646343e-06,2,4.556192663162955e-06,0,0
20344,swampman,2,3.6729057091646343e-06,2,4.556192663162955e-06,0,0
20345,@jacknicklaus,2,3.6729057091646343e-06,2,4.556192663162955e-06,0,0
20348,smollett,2,3.6729057091646343e-06,2,4.556192663162955e-06,0,0
20371,temper,2,3.6729057091646343e-06,2,4.556192663162955e-06,0,0
20370,tantrum,2,3.6729057091646343e-06,2,4.556192663162955e-06,0,0
20380,worthless,2,3.6729057091646343e-06,2,4.556192663162955e-06,0,0
20382,suspected,2,3.6729057091646343e-06,2,4.556192663162955e-06,0,0
20389,corporation,2,3.6729057091646343e-06,2,4.556192663162955e-06,0,0
20391,repression,2,3.6729057091646343e-06,2,4.556192663162955e-06,0,0
20395,redos,2,3.6729057091646343e-06,2,4.556192663162955e-06,0,0
20418,peck,2,3.6729057091646343e-06,2,4.556192663162955e-06,0,0
20426,retaliate-will,2,3.6729057091646343e-06,2,4.556192663162955e-06,0,0
20428,@redsox,2,3.6729057091646343e-06,2,4.556192663162955e-06,0,0
20462,portman,2,3.6729057091646343e-06,2,4.556192663162955e-06,0,0
20471,developers,2,3.6729057091646343e-06,2,4.556192663162955e-06,0,0
20485,tumble,2,3.6729057091646343e-06,2,4.556192663162955e-06,0,0
20484,correctness,2,3.6729057091646343e-06,2,4.556192663162955e-06,0,0
20496,managing,2,3.6729057091646343e-06,2,4.556192663162955e-06,0,0
20506,inaccuratemueller,2,3.6729057091646343e-06,2,4.556192663162955e-06,0,0
20509,1998,2,3.6729057091646343e-06,2,4.556192663162955e-06,0,0
20517,pissed,2,3.6729057091646343e-06,2,4.556192663162955e-06,0,0
20525,firemans,2,3.6729057091646343e-06,2,4.556192663162955e-06,0,0
20548,sucking,2,3.6729057091646343e-06,2,4.556192663162955e-06,0,0
20549,@joeylogano,2,3.6729057091646343e-06,2,4.556192663162955e-06,0,0
20570,weirdo,2,3.6729057091646343e-06,2,4.556192663162955e-06,0,0
20572,negotiator,2,3.6729057091646343e-06,2,4.556192663162955e-06,0,0
20575,respectfully,2,3.6729057091646343e-06,2,4.556192663162955e-06,0,0
20577,#rxsummit2019,2,3.6729057091646343e-06,2,4.556192663162955e-06,0,0
20582,comprehend,2,3.6729057091646343e-06,2,4.556192663162955e-06,0,0
20584,diversionary,2,3.6729057091646343e-06,2,4.556192663162955e-06,0,0
20587,resch,2,3.6729057091646343e-06,2,4.556192663162955e-06,0,0
20586,cdt,2,3.6729057091646343e-06,2,4.556192663162955e-06,0,0
20595,obsessed,2,3.6729057091646343e-06,2,4.556192663162955e-06,0,0
20604,138,2,3.6729057091646343e-06,2,4.556192663162955e-06,0,0
20610,barrs,2,3.6729057091646343e-06,2,4.556192663162955e-06,0,0
20617,pre-trump,2,3.6729057091646343e-06,2,4.556192663162955e-06,0,0
20627,737,2,3.6729057091646343e-06,2,4.556192663162955e-06,0,0
20653,ballabon,2,3.6729057091646343e-06,2,4.556192663162955e-06,0,0
20652,b2,2,3.6729057091646343e-06,2,4.556192663162955e-06,0,0
20660,uganda,2,3.6729057091646343e-06,2,4.556192663162955e-06,0,0
20659,tourist,2,3.6729057091646343e-06,2,4.556192663162955e-06,0,0
20673,conclusions,2,3.6729057091646343e-06,2,4.556192663162955e-06,0,0
20675,calexico,2,3.6729057091646343e-06,2,4.556192663162955e-06,0,0
20700,unusable,2,3.6729057091646343e-06,2,4.556192663162955e-06,0,0
20715,legit,2,3.6729057091646343e-06,2,4.556192663162955e-06,0,0
20746,2005,2,3.6729057091646343e-06,2,4.556192663162955e-06,0,0
20773,jexodus,2,3.6729057091646343e-06,2,4.556192663162955e-06,0,0
20797,constitutionality,2,3.6729057091646343e-06,2,4.556192663162955e-06,0,0
20803,contradicted,2,3.6729057091646343e-06,2,4.556192663162955e-06,0,0
20824,subjected,2,3.6729057091646343e-06,2,4.556192663162955e-06,0,0
20825,widest,2,3.6729057091646343e-06,2,4.556192663162955e-06,0,0
20821,expeditionevery,2,3.6729057091646343e-06,2,4.556192663162955e-06,0,0
20822,lifeall,2,3.6729057091646343e-06,2,4.556192663162955e-06,0,0
20830,drills,2,3.6729057091646343e-06,2,4.556192663162955e-06,0,0
20844,perjury,2,3.6729057091646343e-06,2,4.556192663162955e-06,0,0
20859,dannys,2,3.6729057091646343e-06,2,4.556192663162955e-06,0,0
20881,checker,2,3.6729057091646343e-06,2,4.556192663162955e-06,0,0
20929,irrationally,2,3.6729057091646343e-06,2,4.556192663162955e-06,0,0
20957,passive,2,3.6729057091646343e-06,2,4.556192663162955e-06,0,0
20970,deroy,2,3.6729057091646343e-06,2,4.556192663162955e-06,0,0
20972,murdock,2,3.6729057091646343e-06,2,4.556192663162955e-06,0,0
20981,11000000,2,3.6729057091646343e-06,2,4.556192663162955e-06,0,0
21039,eaters,2,3.6729057091646343e-06,2,4.556192663162955e-06,0,0
21053,bighorn,2,3.6729057091646343e-06,2,4.556192663162955e-06,0,0
21054,garb,2,3.6729057091646343e-06,2,4.556192663162955e-06,0,0
21078,bye-bye,2,3.6729057091646343e-06,2,4.556192663162955e-06,0,0
21093,abramson,2,3.6729057091646343e-06,2,4.556192663162955e-06,0,0
31,clutch,1,1.8364528545823171e-06,0,0,1,9.472836640932127e-06
46,yearkeep,1,1.8364528545823171e-06,0,0,1,9.472836640932127e-06
75,upits,1,1.8364528545823171e-06,0,0,1,9.472836640932127e-06
76,2016and,1,1.8364528545823171e-06,0,0,1,9.472836640932127e-06
92,yoursbig,1,1.8364528545823171e-06,0,0,1,9.472836640932127e-06
97,glaciers,1,1.8364528545823171e-06,0,0,1,9.472836640932127e-06
100,polar,1,1.8364528545823171e-06,0,0,1,9.472836640932127e-06
95,bearssee,1,1.8364528545823171e-06,0,0,1,9.472836640932127e-06
146,youthe,1,1.8364528545823171e-06,0,0,1,9.472836640932127e-06
152,seven-day,1,1.8364528545823171e-06,0,0,1,9.472836640932127e-06
156,lend,1,1.8364528545823171e-06,0,0,1,9.472836640932127e-06
155,handchip,1,1.8364528545823171e-06,0,0,1,9.472836640932127e-06
164,whale,1,1.8364528545823171e-06,0,0,1,9.472836640932127e-06
159,arctic,1,1.8364528545823171e-06,0,0,1,9.472836640932127e-06
204,#sandyhook,1,1.8364528545823171e-06,0,0,1,9.472836640932127e-06
212,#unitedonclimateadd,1,1.8364528545823171e-06,0,0,1,9.472836640932127e-06
215,changethanks,1,1.8364528545823171e-06,0,0,1,9.472836640932127e-06
240,loopholeadd,1,1.8364528545823171e-06,0,0,1,9.472836640932127e-06
265,#unitedonclimatejoin,1,1.8364528545823171e-06,0,0,1,9.472836640932127e-06
279,sixty,1,1.8364528545823171e-06,0,0,1,9.472836640932127e-06
280,changeadd,1,1.8364528545823171e-06,0,0,1,9.472836640932127e-06
283,framework,1,1.8364528545823171e-06,0,0,1,9.472836640932127e-06
301,to-do,1,1.8364528545823171e-06,0,0,1,9.472836640932127e-06
308,todayand,1,1.8364528545823171e-06,0,0,1,9.472836640932127e-06
315,#actonclimatedont,1,1.8364528545823171e-06,0,0,1,9.472836640932127e-06
323,#immigrationactionbut,1,1.8364528545823171e-06,0,0,1,9.472836640932127e-06
337,#actonclimateand,1,1.8364528545823171e-06,0,0,1,9.472836640932127e-06
345,happeningand,1,1.8364528545823171e-06,0,0,1,9.472836640932127e-06
346,#actonclimateadd,1,1.8364528545823171e-06,0,0,1,9.472836640932127e-06
347,#actonclimatethis,1,1.8364528545823171e-06,0,0,1,9.472836640932127e-06
386,seven-year,1,1.8364528545823171e-06,0,0,1,9.472836640932127e-06
422,aboutpresident,1,1.8364528545823171e-06,0,0,1,9.472836640932127e-06
424,canit,1,1.8364528545823171e-06,0,0,1,9.472836640932127e-06
423,@simas44,1,1.8364528545823171e-06,0,0,1,9.472836640932127e-06
469,271000,1,1.8364528545823171e-06,0,0,1,9.472836640932127e-06
475,octobera,1,1.8364528545823171e-06,0,0,1,9.472836640932127e-06
500,checklist,1,1.8364528545823171e-06,0,0,1,9.472836640932127e-06
499,brunch,1,1.8364528545823171e-06,0,0,1,9.472836640932127e-06
498,#getreadygetcovered,1,1.8364528545823171e-06,0,0,1,9.472836640932127e-06
509,tomorrowbefore,1,1.8364528545823171e-06,0,0,1,9.472836640932127e-06
551,progressfight,1,1.8364528545823171e-06,0,0,1,9.472836640932127e-06
552,#obamacarethats,1,1.8364528545823171e-06,0,0,1,9.472836640932127e-06
557,planshow,1,1.8364528545823171e-06,0,0,1,9.472836640932127e-06
566,methane,1,1.8364528545823171e-06,0,0,1,9.472836640932127e-06
580,waitwhich,1,1.8364528545823171e-06,0,0,1,9.472836640932127e-06
594,percentthe,1,1.8364528545823171e-06,0,0,1,9.472836640932127e-06
596,lowjust,1,1.8364528545823171e-06,0,0,1,9.472836640932127e-06
598,happyits,1,1.8364528545823171e-06,0,0,1,9.472836640932127e-06
597,#nationaldessertday,1,1.8364528545823171e-06,0,0,1,9.472836640932127e-06
605,cheaperthe,1,1.8364528545823171e-06,0,0,1,9.472836640932127e-06
616,#ourocean2015,1,1.8364528545823171e-06,0,0,1,9.472836640932127e-06
626,twenty-three,1,1.8364528545823171e-06,0,0,1,9.472836640932127e-06
625,#happyanniversary,1,1.8364528545823171e-06,0,0,1,9.472836640932127e-06
633,monthsbut,1,1.8364528545823171e-06,0,0,1,9.472836640932127e-06
638,yearthat,1,1.8364528545823171e-06,0,0,1,9.472836640932127e-06
639,enoughits,1,1.8364528545823171e-06,0,0,1,9.472836640932127e-06
641,violencestate,1,1.8364528545823171e-06,0,0,1,9.472836640932127e-06
645,liftbecome,1,1.8364528545823171e-06,0,0,1,9.472836640932127e-06
646,recurring,1,1.8364528545823171e-06,0,0,1,9.472836640932127e-06
647,hurrythe,1,1.8364528545823171e-06,0,0,1,9.472836640932127e-06
652,sweater,1,1.8364528545823171e-06,0,0,1,9.472836640932127e-06
648,#nationalcoffeeday,1,1.8364528545823171e-06,0,0,1,9.472836640932127e-06
656,shotenter,1,1.8364528545823171e-06,0,0,1,9.472836640932127e-06
657,@rollingstone,1,1.8364528545823171e-06,0,0,1,9.472836640932127e-06
661,buzzerthe,1,1.8364528545823171e-06,0,0,1,9.472836640932127e-06
663,outdont,1,1.8364528545823171e-06,0,0,1,9.472836640932127e-06
672,walksupport,1,1.8364528545823171e-06,0,0,1,9.472836640932127e-06
676,generationsand,1,1.8364528545823171e-06,0,0,1,9.472836640932127e-06
681,avert,1,1.8364528545823171e-06,0,0,1,9.472836640932127e-06
689,coveredthats,1,1.8364528545823171e-06,0,0,1,9.472836640932127e-06
690,#popeindc,1,1.8364528545823171e-06,0,0,1,9.472836640932127e-06
701,shutdownmembers,1,1.8364528545823171e-06,0,0,1,9.472836640932127e-06
703,readyfall,1,1.8364528545823171e-06,0,0,1,9.472836640932127e-06
720,economywhile,1,1.8364528545823171e-06,0,0,1,9.472836640932127e-06
734,seniorsincluding,1,1.8364528545823171e-06,0,0,1,9.472836640932127e-06
767,record-setting,1,1.8364528545823171e-06,0,0,1,9.472836640932127e-06
795,newsbut,1,1.8364528545823171e-06,0,0,1,9.472836640932127e-06
798,augusta,1,1.8364528545823171e-06,0,0,1,9.472836640932127e-06
801,highlighting,1,1.8364528545823171e-06,0,0,1,9.472836640932127e-06
805,far-off,1,1.8364528545823171e-06,0,0,1,9.472836640932127e-06
822,mckinley,1,1.8364528545823171e-06,0,0,1,9.472836640932127e-06
821,denali,1,1.8364528545823171e-06,0,0,1,9.472836640932127e-06
829,namebecause,1,1.8364528545823171e-06,0,0,1,9.472836640932127e-06
847,changeand,1,1.8364528545823171e-06,0,0,1,9.472836640932127e-06
858,weeksand,1,1.8364528545823171e-06,0,0,1,9.472836640932127e-06
857,unfinished,1,1.8364528545823171e-06,0,0,1,9.472836640932127e-06
863,historybecoming,1,1.8364528545823171e-06,0,0,1,9.472836640932127e-06
864,ranger,1,1.8364528545823171e-06,0,0,1,9.472836640932127e-06
871,applause,1,1.8364528545823171e-06,0,0,1,9.472836640932127e-06
886,#cuba,1,1.8364528545823171e-06,0,0,1,9.472836640932127e-06
887,1961,1,1.8364528545823171e-06,0,0,1,9.472836640932127e-06
896,80th,1,1.8364528545823171e-06,0,0,1,9.472836640932127e-06
895,#socialsecuritya,1,1.8364528545823171e-06,0,0,1,9.472836640932127e-06
899,digits,1,1.8364528545823171e-06,0,0,1,9.472836640932127e-06
901,timethanks,1,1.8364528545823171e-06,0,0,1,9.472836640932127e-06
906,boomingand,1,1.8364528545823171e-06,0,0,1,9.472836640932127e-06
910,embraced,1,1.8364528545823171e-06,0,0,1,9.472836640932127e-06
923,commemorates,1,1.8364528545823171e-06,0,0,1,9.472836640932127e-06
925,215000,1,1.8364528545823171e-06,0,0,1,9.472836640932127e-06
927,julymarking,1,1.8364528545823171e-06,0,0,1,9.472836640932127e-06
928,#jonvoyage,1,1.8364528545823171e-06,0,0,1,9.472836640932127e-06
939,surely,1,1.8364528545823171e-06,0,0,1,9.472836640932127e-06
938,strife,1,1.8364528545823171e-06,0,0,1,9.472836640932127e-06
946,resorting,1,1.8364528545823171e-06,0,0,1,9.472836640932127e-06
956,warned,1,1.8364528545823171e-06,0,0,1,9.472836640932127e-06
962,plausible,1,1.8364528545823171e-06,0,0,1,9.472836640932127e-06
973,achieves,1,1.8364528545823171e-06,0,0,1,9.472836640932127e-06
993,yearwish,1,1.8364528545823171e-06,0,0,1,9.472836640932127e-06
994,#actonclimateshow,1,1.8364528545823171e-06,0,0,1,9.472836640932127e-06
995,planetthats,1,1.8364528545823171e-06,0,0,1,9.472836640932127e-06
998,planadd,1,1.8364528545823171e-06,0,0,1,9.472836640932127e-06
1014,organizer-in-chief,1,1.8364528545823171e-06,0,0,1,9.472836640932127e-06
1012,birthdaysign,1,1.8364528545823171e-06,0,0,1,9.472836640932127e-06
1024,#nationalicecreammonthbetter,1,1.8364528545823171e-06,0,0,1,9.472836640932127e-06
1035,@thedailyshowand,1,1.8364528545823171e-06,0,0,1,9.472836640932127e-06
1049,@stationcdrkelly,1,1.8364528545823171e-06,0,0,1,9.472836640932127e-06
1056,eid,1,1.8364528545823171e-06,0,0,1,9.472836640932127e-06
1058,groundwork,1,1.8364528545823171e-06,0,0,1,9.472836640932127e-06
1066,perfectmile,1,1.8364528545823171e-06,0,0,1,9.472836640932127e-06
1074,oppressionit,1,1.8364528545823171e-06,0,0,1,9.472836640932127e-06
1083,sentencesor,1,1.8364528545823171e-06,0,0,1,9.472836640932127e-06
1101,pre-k,1,1.8364528545823171e-06,0,0,1,9.472836640932127e-06
1105,incarcerate,1,1.8364528545823171e-06,0,0,1,9.472836640932127e-06
1109,offand,1,1.8364528545823171e-06,0,0,1,9.472836640932127e-06
1124,frisked,1,1.8364528545823171e-06,0,0,1,9.472836640932127e-06
1143,offenders,1,1.8364528545823171e-06,0,0,1,9.472836640932127e-06
1148,underfunded,1,1.8364528545823171e-06,0,0,1,9.472836640932127e-06
1146,overcrowded,1,1.8364528545823171e-06,0,0,1,9.472836640932127e-06
1150,inequity,1,1.8364528545823171e-06,0,0,1,9.472836640932127e-06
1155,@nasanewhorizons,1,1.8364528545823171e-06,0,0,1,9.472836640932127e-06
1159,three-billion-mile,1,1.8364528545823171e-06,0,0,1,9.472836640932127e-06
1154,#plutoflyby,1,1.8364528545823171e-06,0,0,1,9.472836640932127e-06
1172,@ussoccerwnt,1,1.8364528545823171e-06,0,0,1,9.472836640932127e-06
1185,yearsshoot,1,1.8364528545823171e-06,0,0,1,9.472836640932127e-06
1183,daysshould,1,1.8364528545823171e-06,0,0,1,9.472836640932127e-06
1197,sometimesunions,1,1.8364528545823171e-06,0,0,1,9.472836640932127e-06
1194,40-hour,1,1.8364528545823171e-06,0,0,1,9.472836640932127e-06
1213,underpaid,1,1.8364528545823171e-06,0,0,1,9.472836640932127e-06
1217,goodbut,1,1.8364528545823171e-06,0,0,1,9.472836640932127e-06
1223,lovethats,1,1.8364528545823171e-06,0,0,1,9.472836640932127e-06
1235,junemarking,1,1.8364528545823171e-06,0,0,1,9.472836640932127e-06
1240,politicsthis,1,1.8364528545823171e-06,0,0,1,9.472836640932127e-06
1251,fightshow,1,1.8364528545823171e-06,0,0,1,9.472836640932127e-06
1254,buzzer,1,1.8364528545823171e-06,0,0,1,9.472836640932127e-06
1253,beater,1,1.8364528545823171e-06,0,0,1,9.472836640932127e-06
1261,268,1,1.8364528545823171e-06,0,0,1,9.472836640932127e-06
1271,clementa,1,1.8364528545823171e-06,0,0,1,9.472836640932127e-06
1272,pinckney,1,1.8364528545823171e-06,0,0,1,9.472836640932127e-06
1293,peoplestronger,1,1.8364528545823171e-06,0,0,1,9.472836640932127e-06
1302,soarswhen,1,1.8364528545823171e-06,0,0,1,9.472836640932127e-06
1312,clearthe,1,1.8364528545823171e-06,0,0,1,9.472836640932127e-06
1319,win-win,1,1.8364528545823171e-06,0,0,1,9.472836640932127e-06
1329,ramadan,1,1.8364528545823171e-06,0,0,1,9.472836640932127e-06
1328,kareem,1,1.8364528545823171e-06,0,0,1,9.472836640932127e-06
1331,hawks,1,1.8364528545823171e-06,0,0,1,9.472836640932127e-06
1332,#flagday,1,1.8364528545823171e-06,0,0,1,9.472836640932127e-06
1335,affecting,1,1.8364528545823171e-06,0,0,1,9.472836640932127e-06
1342,#nationalbestfriendsday,1,1.8364528545823171e-06,0,0,1,9.472836640932127e-06
1367,maymarking,1,1.8364528545823171e-06,0,0,1,9.472836640932127e-06
1377,#wearingorange,1,1.8364528545823171e-06,0,0,1,9.472836640932127e-06
1378,equallyno,1,1.8364528545823171e-06,0,0,1,9.472836640932127e-06
1379,loveour,1,1.8364528545823171e-06,0,0,1,9.472836640932127e-06
1381,rightsshare,1,1.8364528545823171e-06,0,0,1,9.472836640932127e-06
1392,fuller,1,1.8364528545823171e-06,0,0,1,9.472836640932127e-06
1404,hadnot,1,1.8364528545823171e-06,0,0,1,9.472836640932127e-06
1415,fourteen,1,1.8364528545823171e-06,0,0,1,9.472836640932127e-06
1417,bees,1,1.8364528545823171e-06,0,0,1,9.472836640932127e-06
1419,men-era,1,1.8364528545823171e-06,0,0,1,9.472836640932127e-06
1420,policiesadd,1,1.8364528545823171e-06,0,0,1,9.472836640932127e-06
1427,blues,1,1.8364528545823171e-06,0,0,1,9.472836640932127e-06
1426,#bbking,1,1.8364528545823171e-06,0,0,1,9.472836640932127e-06
1432,#nwhw,1,1.8364528545823171e-06,0,0,1,9.472836640932127e-06
1438,amtrak,1,1.8364528545823171e-06,0,0,1,9.472836640932127e-06
1455,aprilthats,1,1.8364528545823171e-06,0,0,1,9.472836640932127e-06
1466,translator,1,1.8364528545823171e-06,0,0,1,9.472836640932127e-06
1467,economyits,1,1.8364528545823171e-06,0,0,1,9.472836640932127e-06
1470,letterman,1,1.8364528545823171e-06,0,0,1,9.472836640932127e-06
1472,clearclimate,1,1.8364528545823171e-06,0,0,1,9.472836640932127e-06
1478,reiterates,1,1.8364528545823171e-06,0,0,1,9.472836640932127e-06
1488,schoolchildren,1,1.8364528545823171e-06,0,0,1,9.472836640932127e-06
1483,cuteness,1,1.8364528545823171e-06,0,0,1,9.472836640932127e-06
1484,ensues,1,1.8364528545823171e-06,0,0,1,9.472836640932127e-06
1491,fifth-grade,1,1.8364528545823171e-06,0,0,1,9.472836640932127e-06
1494,aspire,1,1.8364528545823171e-06,0,0,1,9.472836640932127e-06
1498,optionsjust,1,1.8364528545823171e-06,0,0,1,9.472836640932127e-06
1505,#whcd,1,1.8364528545823171e-06,0,0,1,9.472836640932127e-06
1509,cecily,1,1.8364528545823171e-06,0,0,1,9.472836640932127e-06
1513,futurebecause,1,1.8364528545823171e-06,0,0,1,9.472836640932127e-06
1523,3-point,1,1.8364528545823171e-06,0,0,1,9.472836640932127e-06
1526,landscape,1,1.8364528545823171e-06,0,0,1,9.472836640932127e-06
1527,stewards,1,1.8364528545823171e-06,0,0,1,9.472836640932127e-06
1533,generates,1,1.8364528545823171e-06,0,0,1,9.472836640932127e-06
1556,deniedor,1,1.8364528545823171e-06,0,0,1,9.472836640932127e-06
1561,paythese,1,1.8364528545823171e-06,0,0,1,9.472836640932127e-06
1567,workplaces,1,1.8364528545823171e-06,0,0,1,9.472836640932127e-06
1573,#obamatownhall,1,1.8364528545823171e-06,0,0,1,9.472836640932127e-06
1578,conversion,1,1.8364528545823171e-06,0,0,1,9.472836640932127e-06
1584,#openingday,1,1.8364528545823171e-06,0,0,1,9.472836640932127e-06
1587,75000,1,1.8364528545823171e-06,0,0,1,9.472836640932127e-06
1588,americansincluding,1,1.8364528545823171e-06,0,0,1,9.472836640932127e-06
1592,veteransto,1,1.8364528545823171e-06,0,0,1,9.472836640932127e-06
1594,twenty-fold,1,1.8364528545823171e-06,0,0,1,9.472836640932127e-06
1595,126000,1,1.8364528545823171e-06,0,0,1,9.472836640932127e-06
1596,61st,1,1.8364528545823171e-06,0,0,1,9.472836640932127e-06
1598,americannot,1,1.8364528545823171e-06,0,0,1,9.472836640932127e-06
1600,9-year-old,1,1.8364528545823171e-06,0,0,1,9.472836640932127e-06
1630,workrebuilding,1,1.8364528545823171e-06,0,0,1,9.472836640932127e-06
1633,readyenter,1,1.8364528545823171e-06,0,0,1,9.472836640932127e-06
1635,capitaland,1,1.8364528545823171e-06,0,0,1,9.472836640932127e-06
1638,punchline,1,1.8364528545823171e-06,0,0,1,9.472836640932127e-06
1642,6-year-old,1,1.8364528545823171e-06,0,0,1,9.472836640932127e-06
1643,supergirls,1,1.8364528545823171e-06,0,0,1,9.472836640932127e-06
1646,catalyst,1,1.8364528545823171e-06,0,0,1,9.472836640932127e-06
1649,16m,1,1.8364528545823171e-06,0,0,1,9.472836640932127e-06
1658,flunked-science,1,1.8364528545823171e-06,0,0,1,9.472836640932127e-06
1657,#championdenier,1,1.8364528545823171e-06,0,0,1,9.472836640932127e-06
1663,classnot,1,1.8364528545823171e-06,0,0,1,9.472836640932127e-06
1665,revisits,1,1.8364528545823171e-06,0,0,1,9.472836640932127e-06
1666,#baracketology,1,1.8364528545823171e-06,0,0,1,9.472836640932127e-06
1679,164,1,1.8364528545823171e-06,0,0,1,9.472836640932127e-06
1690,yourselfyoure,1,1.8364528545823171e-06,0,0,1,9.472836640932127e-06
1701,valuable,1,1.8364528545823171e-06,0,0,1,9.472836640932127e-06
1703,surest,1,1.8364528545823171e-06,0,0,1,9.472836640932127e-06
1706,#happyinternationalwomensday,1,1.8364528545823171e-06,0,0,1,9.472836640932127e-06
1715,continually,1,1.8364528545823171e-06,0,0,1,9.472836640932127e-06
1721,pine,1,1.8364528545823171e-06,0,0,1,9.472836640932127e-06
1749,2014the,1,1.8364528545823171e-06,0,0,1,9.472836640932127e-06
1753,progressstate,1,1.8364528545823171e-06,0,0,1,9.472836640932127e-06
1756,democracys,1,1.8364528545823171e-06,0,0,1,9.472836640932127e-06
1758,#enoughalreadytime,1,1.8364528545823171e-06,0,0,1,9.472836640932127e-06
1766,nerdy,1,1.8364528545823171e-06,0,0,1,9.472836640932127e-06
1767,nimoy,1,1.8364528545823171e-06,0,0,1,9.472836640932127e-06
1764,#llap,1,1.8364528545823171e-06,0,0,1,9.472836640932127e-06
1771,shutdownyour,1,1.8364528545823171e-06,0,0,1,9.472836640932127e-06
1772,#enoughalreadyno,1,1.8364528545823171e-06,0,0,1,9.472836640932127e-06
1777,boehners,1,1.8364528545823171e-06,0,0,1,9.472836640932127e-06
1788,partial,1,1.8364528545823171e-06,0,0,1,9.472836640932127e-06
1795,insuranceits,1,1.8364528545823171e-06,0,0,1,9.472836640932127e-06
1800,familieswe,1,1.8364528545823171e-06,0,0,1,9.472836640932127e-06
1804,#yolo,1,1.8364528545823171e-06,0,0,1,9.472836640932127e-06
1805,gamescongress,1,1.8364528545823171e-06,0,0,1,9.472836640932127e-06
1806,posturing,1,1.8364528545823171e-06,0,0,1,9.472836640932127e-06
1808,healthywithout,1,1.8364528545823171e-06,0,0,1,9.472836640932127e-06
1811,worrying,1,1.8364528545823171e-06,0,0,1,9.472836640932127e-06
1813,#grammys,1,1.8364528545823171e-06,0,0,1,9.472836640932127e-06
1820,#leadership,1,1.8364528545823171e-06,0,0,1,9.472836640932127e-06
1824,freer,1,1.8364528545823171e-06,0,0,1,9.472836640932127e-06
1834,257000,1,1.8364528545823171e-06,0,0,1,9.472836640932127e-06
1836,three-month,1,1.8364528545823171e-06,0,0,1,9.472836640932127e-06
1839,positively,1,1.8364528545823171e-06,0,0,1,9.472836640932127e-06
1850,actbut,1,1.8364528545823171e-06,0,0,1,9.472836640932127e-06
1854,coverageand,1,1.8364528545823171e-06,0,0,1,9.472836640932127e-06
1855,classmr,1,1.8364528545823171e-06,0,0,1,9.472836640932127e-06
1856,cubis,1,1.8364528545823171e-06,0,0,1,9.472836640932127e-06
1866,chaptertogetherand,1,1.8364528545823171e-06,0,0,1,9.472836640932127e-06
1870,tight-knit,1,1.8364528545823171e-06,0,0,1,9.472836640932127e-06
1876,wedge,1,1.8364528545823171e-06,0,0,1,9.472836640932127e-06
1877,endanger,1,1.8364528545823171e-06,0,0,1,9.472836640932127e-06
1888,collegeto,1,1.8364528545823171e-06,0,0,1,9.472836640932127e-06
1897,workersnot,1,1.8364528545823171e-06,0,0,1,9.472836640932127e-06
1903,practical,1,1.8364528545823171e-06,0,0,1,9.472836640932127e-06
1909,insured,1,1.8364528545823171e-06,0,0,1,9.472836640932127e-06
1924,happiest,1,1.8364528545823171e-06,0,0,1,9.472836640932127e-06
1927,#gosolar,1,1.8364528545823171e-06,0,0,1,9.472836640932127e-06
1941,everywherewe,1,1.8364528545823171e-06,0,0,1,9.472836640932127e-06
1943,protectedno,1,1.8364528545823171e-06,0,0,1,9.472836640932127e-06
1944,identities,1,1.8364528545823171e-06,0,0,1,9.472836640932127e-06
1948,knoxville,1,1.8364528545823171e-06,0,0,1,9.472836640932127e-06
1945,#freecommunitycollege,1,1.8364528545823171e-06,0,0,1,9.472836640932127e-06
1954,252000,1,1.8364528545823171e-06,0,0,1,9.472836640932127e-06
1959,lions,1,1.8364528545823171e-06,0,0,1,9.472836640932127e-06
1965,57-month,1,1.8364528545823171e-06,0,0,1,9.472836640932127e-06
1968,#healthy2015,1,1.8364528545823171e-06,0,0,1,9.472836640932127e-06
1974,entertained,1,1.8364528545823171e-06,0,0,1,9.472836640932127e-06
1977,uswith,1,1.8364528545823171e-06,0,0,1,9.472836640932127e-06
1983,surveyits,1,1.8364528545823171e-06,0,0,1,9.472836640932127e-06
1994,metric,1,1.8364528545823171e-06,0,0,1,9.472836640932127e-06
1996,wantamericas,1,1.8364528545823171e-06,0,0,1,9.472836640932127e-06
2001,truthiness,1,1.8364528545823171e-06,0,0,1,9.472836640932127e-06
2006,sign-ups,1,1.8364528545823171e-06,0,0,1,9.472836640932127e-06
2010,bristol,1,1.8364528545823171e-06,0,0,1,9.472836640932127e-06
2017,youour,1,1.8364528545823171e-06,0,0,1,9.472836640932127e-06
2030,@pennypritzker,1,1.8364528545823171e-06,0,0,1,9.472836640932127e-06
2048,265,1,1.8364528545823171e-06,0,0,1,9.472836640932127e-06
2050,321000,1,1.8364528545823171e-06,0,0,1,9.472836640932127e-06
2052,#nomoregames,1,1.8364528545823171e-06,0,0,1,9.472836640932127e-06
2064,aids-free,1,1.8364528545823171e-06,0,0,1,9.472836640932127e-06
2065,lifetimes,1,1.8364528545823171e-06,0,0,1,9.472836640932127e-06
2062,#worldaidsday,1,1.8364528545823171e-06,0,0,1,9.472836640932127e-06
2073,billpresident,1,1.8364528545823171e-06,0,0,1,9.472836640932127e-06
2078,worldwe,1,1.8364528545823171e-06,0,0,1,9.472836640932127e-06
2082,systemnow,1,1.8364528545823171e-06,0,0,1,9.472836640932127e-06
2084,accountabilitya,1,1.8364528545823171e-06,0,0,1,9.472836640932127e-06
2087,middle-ground,1,1.8364528545823171e-06,0,0,1,9.472836640932127e-06
2088,low-paying,1,1.8364528545823171e-06,0,0,1,9.472836640932127e-06
2092,familiesstand,1,1.8364528545823171e-06,0,0,1,9.472836640932127e-06
2100,doris,1,1.8364528545823171e-06,0,0,1,9.472836640932127e-06
2101,businesscheck,1,1.8364528545823171e-06,0,0,1,9.472836640932127e-06
2103,#ruinapixarmovie,1,1.8364528545823171e-06,0,0,1,9.472836640932127e-06
2104,funkes,1,1.8364528545823171e-06,0,0,1,9.472836640932127e-06
2114,freesign,1,1.8364528545823171e-06,0,0,1,9.472836640932127e-06
2116,backsjust,1,1.8364528545823171e-06,0,0,1,9.472836640932127e-06
2118,dayand,1,1.8364528545823171e-06,0,0,1,9.472836640932127e-06
2119,daylets,1,1.8364528545823171e-06,0,0,1,9.472836640932127e-06
2120,200k,1,1.8364528545823171e-06,0,0,1,9.472836640932127e-06
2132,trick-or-treating,1,1.8364528545823171e-06,0,0,1,9.472836640932127e-06
2157,scariest,1,1.8364528545823171e-06,0,0,1,9.472836640932127e-06
2155,haunted,1,1.8364528545823171e-06,0,0,1,9.472836640932127e-06
2162,menino,1,1.8364528545823171e-06,0,0,1,9.472836640932127e-06
2171,anymoreits,1,1.8364528545823171e-06,0,0,1,9.472836640932127e-06
2176,reformjoin,1,1.8364528545823171e-06,0,0,1,9.472836640932127e-06
2189,changestick,1,1.8364528545823171e-06,0,0,1,9.472836640932127e-06
2193,malala,1,1.8364528545823171e-06,0,0,1,9.472836640932127e-06
2192,kailashs,1,1.8364528545823171e-06,0,0,1,9.472836640932127e-06
2198,voiceuse,1,1.8364528545823171e-06,0,0,1,9.472836640932127e-06
2199,upshow,1,1.8364528545823171e-06,0,0,1,9.472836640932127e-06
2201,compensated,1,1.8364528545823171e-06,0,0,1,9.472836640932127e-06
2207,monthsits,1,1.8364528545823171e-06,0,0,1,9.472836640932127e-06
2208,248000,1,1.8364528545823171e-06,0,0,1,9.472836640932127e-06
2210,downit,1,1.8364528545823171e-06,0,0,1,9.472836640932127e-06
2220,pocketstheyll,1,1.8364528545823171e-06,0,0,1,9.472836640932127e-06
2227,elementary,1,1.8364528545823171e-06,0,0,1,9.472836640932127e-06
2230,scores,1,1.8364528545823171e-06,0,0,1,9.472836640932127e-06
2233,uninterrupted,1,1.8364528545823171e-06,0,0,1,9.472836640932127e-06
2234,insurancethanks,1,1.8364528545823171e-06,0,0,1,9.472836640932127e-06
2240,governmentand,1,1.8364528545823171e-06,0,0,1,9.472836640932127e-06
2242,agreecutting,1,1.8364528545823171e-06,0,0,1,9.472836640932127e-06
2245,@govinslee,1,1.8364528545823171e-06,0,0,1,9.472836640932127e-06
2248,#monumentsmatter,1,1.8364528545823171e-06,0,0,1,9.472836640932127e-06
2261,lshanah,1,1.8364528545823171e-06,0,0,1,9.472836640932127e-06
2262,#cgi2014,1,1.8364528545823171e-06,0,0,1,9.472836640932127e-06
2266,usnot,1,1.8364528545823171e-06,0,0,1,9.472836640932127e-06
2271,earths,1,1.8364528545823171e-06,0,0,1,9.472836640932127e-06
2274,#walkthewalk,1,1.8364528545823171e-06,0,0,1,9.472836640932127e-06
2281,crimeits,1,1.8364528545823171e-06,0,0,1,9.472836640932127e-06
2284,#bettercare,1,1.8364528545823171e-06,0,0,1,9.472836640932127e-06
2287,centuries,1,1.8364528545823171e-06,0,0,1,9.472836640932127e-06
2296,concludes,1,1.8364528545823171e-06,0,0,1,9.472836640932127e-06
2301,#gettingthingsdone,1,1.8364528545823171e-06,0,0,1,9.472836640932127e-06
2311,thirteen,1,1.8364528545823171e-06,0,0,1,9.472836640932127e-06
2315,reining,1,1.8364528545823171e-06,0,0,1,9.472836640932127e-06
2314,debtgo,1,1.8364528545823171e-06,0,0,1,9.472836640932127e-06
2320,abusepresident,1,1.8364528545823171e-06,0,0,1,9.472836640932127e-06
2323,@salon,1,1.8364528545823171e-06,0,0,1,9.472836640932127e-06
2331,weeknow,1,1.8364528545823171e-06,0,0,1,9.472836640932127e-06
2340,warms,1,1.8364528545823171e-06,0,0,1,9.472836640932127e-06
2341,affordabilityits,1,1.8364528545823171e-06,0,0,1,9.472836640932127e-06
2343,pastamerican,1,1.8364528545823171e-06,0,0,1,9.472836640932127e-06
2342,#wematter,1,1.8364528545823171e-06,0,0,1,9.472836640932127e-06
2350,policyits,1,1.8364528545823171e-06,0,0,1,9.472836640932127e-06
2357,#llws,1,1.8364528545823171e-06,0,0,1,9.472836640932127e-06
2358,all-stars,1,1.8364528545823171e-06,0,0,1,9.472836640932127e-06
2366,growingbut,1,1.8364528545823171e-06,0,0,1,9.472836640932127e-06
2367,13-year,1,1.8364528545823171e-06,0,0,1,9.472836640932127e-06
2369,#ferguson,1,1.8364528545823171e-06,0,0,1,9.472836640932127e-06
2378,airman,1,1.8364528545823171e-06,0,0,1,9.472836640932127e-06
2380,genie,1,1.8364528545823171e-06,0,0,1,9.472836640932127e-06
2382,nanny,1,1.8364528545823171e-06,0,0,1,9.472836640932127e-06
2388,cake,1,1.8364528545823171e-06,0,0,1,9.472836640932127e-06
2389,pie,1,1.8364528545823171e-06,0,0,1,9.472836640932127e-06
2398,birthdaymake,1,1.8364528545823171e-06,0,0,1,9.472836640932127e-06
2403,yearspresident,1,1.8364528545823171e-06,0,0,1,9.472836640932127e-06
2405,growththats,1,1.8364528545823171e-06,0,0,1,9.472836640932127e-06
2409,#53,1,1.8364528545823171e-06,0,0,1,9.472836640932127e-06
2412,corners,1,1.8364528545823171e-06,0,0,1,9.472836640932127e-06
2419,wastes,1,1.8364528545823171e-06,0,0,1,9.472836640932127e-06
2418,taxpayerspresident,1,1.8364528545823171e-06,0,0,1,9.472836640932127e-06
2416,leaderships,1,1.8364528545823171e-06,0,0,1,9.472836640932127e-06
2420,#workplacefairness,1,1.8364528545823171e-06,0,0,1,9.472836640932127e-06
2421,#suelessdomore,1,1.8364528545823171e-06,0,0,1,9.472836640932127e-06
2433,lew,1,1.8364528545823171e-06,0,0,1,9.472836640932127e-06
2437,@tedstrickland,1,1.8364528545823171e-06,0,0,1,9.472836640932127e-06
2449,renouncing,1,1.8364528545823171e-06,0,0,1,9.472836640932127e-06
2455,yearsbut,1,1.8364528545823171e-06,0,0,1,9.472836640932127e-06
2459,seeker,1,1.8364528545823171e-06,0,0,1,9.472836640932127e-06
2477,rallied,1,1.8364528545823171e-06,0,0,1,9.472836640932127e-06
2487,officepresident,1,1.8364528545823171e-06,0,0,1,9.472836640932127e-06
2490,nationas,1,1.8364528545823171e-06,0,0,1,9.472836640932127e-06
2497,#independenceday,1,1.8364528545823171e-06,0,0,1,9.472836640932127e-06
2498,stripes,1,1.8364528545823171e-06,0,0,1,9.472836640932127e-06
2500,262000,1,1.8364528545823171e-06,0,0,1,9.472836640932127e-06
2504,womannot,1,1.8364528545823171e-06,0,0,1,9.472836640932127e-06
2502,bossmade,1,1.8364528545823171e-06,0,0,1,9.472836640932127e-06
2522,skyline,1,1.8364528545823171e-06,0,0,1,9.472836640932127e-06
2524,fightingpresident,1,1.8364528545823171e-06,0,0,1,9.472836640932127e-06
2527,#doma,1,1.8364528545823171e-06,0,0,1,9.472836640932127e-06
2529,#letsdothis,1,1.8364528545823171e-06,0,0,1,9.472836640932127e-06
2534,co-breadwinner,1,1.8364528545823171e-06,0,0,1,9.472836640932127e-06
2554,childcare,1,1.8364528545823171e-06,0,0,1,9.472836640932127e-06
2556,frillstheyre,1,1.8364528545823171e-06,0,0,1,9.472836640932127e-06
2563,thatin,1,1.8364528545823171e-06,0,0,1,9.472836640932127e-06
2562,2014someone,1,1.8364528545823171e-06,0,0,1,9.472836640932127e-06
2565,#nationofmakers,1,1.8364528545823171e-06,0,0,1,9.472836640932127e-06
2568,dignityregardless,1,1.8364528545823171e-06,0,0,1,9.472836640932127e-06
2579,@georgehwbush,1,1.8364528545823171e-06,0,0,1,9.472836640932127e-06
2582,skydiving,1,1.8364528545823171e-06,0,0,1,9.472836640932127e-06
2578,#41,1,1.8364528545823171e-06,0,0,1,9.472836640932127e-06
2585,frustrating,1,1.8364528545823171e-06,0,0,1,9.472836640932127e-06
2586,hardpresident,1,1.8364528545823171e-06,0,0,1,9.472836640932127e-06
2601,knowall,1,1.8364528545823171e-06,0,0,1,9.472836640932127e-06
2602,knowthat,1,1.8364528545823171e-06,0,0,1,9.472836640932127e-06
2608,216000,1,1.8364528545823171e-06,0,0,1,9.472836640932127e-06
2616,@voxdotcom,1,1.8364528545823171e-06,0,0,1,9.472836640932127e-06
2620,dim,1,1.8364528545823171e-06,0,0,1,9.472836640932127e-06
2632,12s,1,1.8364528545823171e-06,0,0,1,9.472836640932127e-06
2637,noise,1,1.8364528545823171e-06,0,0,1,9.472836640932127e-06
2633,@seahawks,1,1.8364528545823171e-06,0,0,1,9.472836640932127e-06
2638,womenand,1,1.8364528545823171e-06,0,0,1,9.472836640932127e-06
2641,compass,1,1.8364528545823171e-06,0,0,1,9.472836640932127e-06
2640,60th,1,1.8364528545823171e-06,0,0,1,9.472836640932127e-06
2645,discriminationno,1,1.8364528545823171e-06,0,0,1,9.472836640932127e-06
2644,#idahot,1,1.8364528545823171e-06,0,0,1,9.472836640932127e-06
2653,albright,1,1.8364528545823171e-06,0,0,1,9.472836640932127e-06
2658,#smallbusinessweek,1,1.8364528545823171e-06,0,0,1,9.472836640932127e-06
2661,#workingfamilies,1,1.8364528545823171e-06,0,0,1,9.472836640932127e-06
2665,solarmore,1,1.8364528545823171e-06,0,0,1,9.472836640932127e-06
2664,10-fold,1,1.8364528545823171e-06,0,0,1,9.472836640932127e-06
2671,#happyteacherappreciationday,1,1.8364528545823171e-06,0,0,1,9.472836640932127e-06
2675,goingto,1,1.8364528545823171e-06,0,0,1,9.472836640932127e-06
2677,#nfcm,1,1.8364528545823171e-06,0,0,1,9.472836640932127e-06
2681,discouraged,1,1.8364528545823171e-06,0,0,1,9.472836640932127e-06
2685,#1010means,1,1.8364528545823171e-06,0,0,1,9.472836640932127e-06
2687,catholics,1,1.8364528545823171e-06,0,0,1,9.472836640932127e-06
2686,canonization,1,1.8364528545823171e-06,0,0,1,9.472836640932127e-06
2691,xxiii,1,1.8364528545823171e-06,0,0,1,9.472836640932127e-06
2694,reformfor,1,1.8364528545823171e-06,0,0,1,9.472836640932127e-06
2700,insurancebut,1,1.8364528545823171e-06,0,0,1,9.472836640932127e-06
2702,#whatrepealmeansand,1,1.8364528545823171e-06,0,0,1,9.472836640932127e-06
2704,#happyearthday,1,1.8364528545823171e-06,0,0,1,9.472836640932127e-06
2713,wageexcept,1,1.8364528545823171e-06,0,0,1,9.472836640932127e-06
2720,workingfor,1,1.8364528545823171e-06,0,0,1,9.472836640932127e-06
2721,#8million,1,1.8364528545823171e-06,0,0,1,9.472836640932127e-06
2723,chancethats,1,1.8364528545823171e-06,0,0,1,9.472836640932127e-06
2727,#jackierobinsonday,1,1.8364528545823171e-06,0,0,1,9.472836640932127e-06
2728,bostonians,1,1.8364528545823171e-06,0,0,1,9.472836640932127e-06
2735,commonsense,1,1.8364528545823171e-06,0,0,1,9.472836640932127e-06
2740,onpresident,1,1.8364528545823171e-06,0,0,1,9.472836640932127e-06
2748,077,1,1.8364528545823171e-06,0,0,1,9.472836640932127e-06
2755,f­­or,1,1.8364528545823171e-06,0,0,1,9.472836640932127e-06
2762,commentators,1,1.8364528545823171e-06,0,0,1,9.472836640932127e-06
2767,hourpresident,1,1.8364528545823171e-06,0,0,1,9.472836640932127e-06
2769,engages,1,1.8364528545823171e-06,0,0,1,9.472836640932127e-06
2770,#davidletterman,1,1.8364528545823171e-06,0,0,1,9.472836640932127e-06
2774,everybodythats,1,1.8364528545823171e-06,0,0,1,9.472836640932127e-06
2775,ten-ten,1,1.8364528545823171e-06,0,0,1,9.472836640932127e-06
2780,groundhog,1,1.8364528545823171e-06,0,0,1,9.472836640932127e-06
2777,dayexcept,1,1.8364528545823171e-06,0,0,1,9.472836640932127e-06
2782,fewwe,1,1.8364528545823171e-06,0,0,1,9.472836640932127e-06
2783,2003,1,1.8364528545823171e-06,0,0,1,9.472836640932127e-06
2797,progressits,1,1.8364528545823171e-06,0,0,1,9.472836640932127e-06
2800,survivorsthey,1,1.8364528545823171e-06,0,0,1,9.472836640932127e-06
2807,@ipccch,1,1.8364528545823171e-06,0,0,1,9.472836640932127e-06
2808,warns,1,1.8364528545823171e-06,0,0,1,9.472836640932127e-06
2806,#climatefool,1,1.8364528545823171e-06,0,0,1,9.472836640932127e-06
2821,problembe,1,1.8364528545823171e-06,0,0,1,9.472836640932127e-06
2827,#thekidsneedtoknow,1,1.8364528545823171e-06,0,0,1,9.472836640932127e-06
2832,100month,1,1.8364528545823171e-06,0,0,1,9.472836640932127e-06
2831,#100challenge,1,1.8364528545823171e-06,0,0,1,9.472836640932127e-06
2836,snooze,1,1.8364528545823171e-06,0,0,1,9.472836640932127e-06
2837,lifesaving,1,1.8364528545823171e-06,0,0,1,9.472836640932127e-06
2846,teami,1,1.8364528545823171e-06,0,0,1,9.472836640932127e-06
2848,photosand,1,1.8364528545823171e-06,0,0,1,9.472836640932127e-06
2851,@chicagosmayor,1,1.8364528545823171e-06,0,0,1,9.472836640932127e-06
2849,#lifehappens,1,1.8364528545823171e-06,0,0,1,9.472836640932127e-06
2853,baracketology,1,1.8364528545823171e-06,0,0,1,9.472836640932127e-06
2855,insurancepass,1,1.8364528545823171e-06,0,0,1,9.472836640932127e-06
2858,healthyand,1,1.8364528545823171e-06,0,0,1,9.472836640932127e-06
2868,slice,1,1.8364528545823171e-06,0,0,1,9.472836640932127e-06
2871,startedif,1,1.8364528545823171e-06,0,0,1,9.472836640932127e-06
2870,responsibly,1,1.8364528545823171e-06,0,0,1,9.472836640932127e-06
2869,aheadpresident,1,1.8364528545823171e-06,0,0,1,9.472836640932127e-06
2878,@galifianakisz,1,1.8364528545823171e-06,0,0,1,9.472836640932127e-06
2877,#betweentwoferns,1,1.8364528545823171e-06,0,0,1,9.472836640932127e-06
2882,all-night,1,1.8364528545823171e-06,0,0,1,9.472836640932127e-06
2885,#affordablecare,1,1.8364528545823171e-06,0,0,1,9.472836640932127e-06
2887,fits,1,1.8364528545823171e-06,0,0,1,9.472836640932127e-06
2888,rosettas,1,1.8364528545823171e-06,0,0,1,9.472836640932127e-06
2891,bloody,1,1.8364528545823171e-06,0,0,1,9.472836640932127e-06
2890,1955,1,1.8364528545823171e-06,0,0,1,9.472836640932127e-06
2898,pre-school,1,1.8364528545823171e-06,0,0,1,9.472836640932127e-06
2896,curriculums,1,1.8364528545823171e-06,0,0,1,9.472836640932127e-06
2900,fafsa,1,1.8364528545823171e-06,0,0,1,9.472836640932127e-06
2904,grandparents,1,1.8364528545823171e-06,0,0,1,9.472836640932127e-06
2905,succeedthere,1,1.8364528545823171e-06,0,0,1,9.472836640932127e-06
2910,dayevery,1,1.8364528545823171e-06,0,0,1,9.472836640932127e-06
2911,nightyou,1,1.8364528545823171e-06,0,0,1,9.472836640932127e-06
2912,#fairshot,1,1.8364528545823171e-06,0,0,1,9.472836640932127e-06
2914,careyoure,1,1.8364528545823171e-06,0,0,1,9.472836640932127e-06
2913,#asegurate,1,1.8364528545823171e-06,0,0,1,9.472836640932127e-06
2921,americansabout,1,1.8364528545823171e-06,0,0,1,9.472836640932127e-06
2922,republicanssupport,1,1.8364528545823171e-06,0,0,1,9.472836640932127e-06
2924,ash,1,1.8364528545823171e-06,0,0,1,9.472836640932127e-06
2926,#readacrossamerica,1,1.8364528545823171e-06,0,0,1,9.472836640932127e-06
2927,#timetoenroll,1,1.8364528545823171e-06,0,0,1,9.472836640932127e-06
2928,riskyno,1,1.8364528545823171e-06,0,0,1,9.472836640932127e-06
2930,filmmakers,1,1.8364528545823171e-06,0,0,1,9.472836640932127e-06
2932,youwe,1,1.8364528545823171e-06,0,0,1,9.472836640932127e-06
2952,menthe,1,1.8364528545823171e-06,0,0,1,9.472836640932127e-06
2951,forgiving,1,1.8364528545823171e-06,0,0,1,9.472836640932127e-06
2954,light-rail,1,1.8364528545823171e-06,0,0,1,9.472836640932127e-06
2960,minnesotans,1,1.8364528545823171e-06,0,0,1,9.472836640932127e-06
2968,positioned,1,1.8364528545823171e-06,0,0,1,9.472836640932127e-06
2977,metals,1,1.8364528545823171e-06,0,0,1,9.472836640932127e-06
2979,305,1,1.8364528545823171e-06,0,0,1,9.472836640932127e-06
2981,@latenightseths,1,1.8364528545823171e-06,0,0,1,9.472836640932127e-06
2985,investors,1,1.8364528545823171e-06,0,0,1,9.472836640932127e-06
2986,eager,1,1.8364528545823171e-06,0,0,1,9.472836640932127e-06
2987,battered,1,1.8364528545823171e-06,0,0,1,9.472836640932127e-06
2990,@fallontonight@michelleobama,1,1.8364528545823171e-06,0,0,1,9.472836640932127e-06
2991,lovable,1,1.8364528545823171e-06,0,0,1,9.472836640932127e-06
2993,amee,1,1.8364528545823171e-06,0,0,1,9.472836640932127e-06
2994,insuranceand,1,1.8364528545823171e-06,0,0,1,9.472836640932127e-06
3007,leaping,1,1.8364528545823171e-06,0,0,1,9.472836640932127e-06
3015,driest,1,1.8364528545823171e-06,0,0,1,9.472836640932127e-06
3019,valentine,1,1.8364528545823171e-06,0,0,1,9.472836640932127e-06
3021,@adorablecareact,1,1.8364528545823171e-06,0,0,1,9.472836640932127e-06
3022,@houseofcards,1,1.8364528545823171e-06,0,0,1,9.472836640932127e-06
3024,spoilers,1,1.8364528545823171e-06,0,0,1,9.472836640932127e-06
3025,#16,1,1.8364528545823171e-06,0,0,1,9.472836640932127e-06
3026,nowim,1,1.8364528545823171e-06,0,0,1,9.472836640932127e-06
3034,holly,1,1.8364528545823171e-06,0,0,1,9.472836640932127e-06
3039,eva,1,1.8364528545823171e-06,0,0,1,9.472836640932127e-06
3041,@mikesamfootball,1,1.8364528545823171e-06,0,0,1,9.472836640932127e-06
3042,sportsmanship,1,1.8364528545823171e-06,0,0,1,9.472836640932127e-06
3045,1751,1,1.8364528545823171e-06,0,0,1,9.472836640932127e-06
3044,#ofafellows,1,1.8364528545823171e-06,0,0,1,9.472836640932127e-06
3053,job-seekers,1,1.8364528545823171e-06,0,0,1,9.472836640932127e-06
3056,225,1,1.8364528545823171e-06,0,0,1,9.472836640932127e-06
3063,choiceenroll,1,1.8364528545823171e-06,0,0,1,9.472836640932127e-06
3064,broncos,1,1.8364528545823171e-06,0,0,1,9.472836640932127e-06
3065,seahawks,1,1.8364528545823171e-06,0,0,1,9.472836640932127e-06
3068,@animalplanet,1,1.8364528545823171e-06,0,0,1,9.472836640932127e-06
3073,#punxsutawneyphil,1,1.8364528545823171e-06,0,0,1,9.472836640932127e-06
3074,aheadmake,1,1.8364528545823171e-06,0,0,1,9.472836640932127e-06
3072,#groundhogday,1,1.8364528545823171e-06,0,0,1,9.472836640932127e-06
3079,@waxmanclimate,1,1.8364528545823171e-06,0,0,1,9.472836640932127e-06
3081,childrennothing,1,1.8364528545823171e-06,0,0,1,9.472836640932127e-06
3086,slip,1,1.8364528545823171e-06,0,0,1,9.472836640932127e-06
3087,@oprah,1,1.8364528545823171e-06,0,0,1,9.472836640932127e-06
3089,@peggyolson,1,1.8364528545823171e-06,0,0,1,9.472836640932127e-06
3090,coworkers,1,1.8364528545823171e-06,0,0,1,9.472836640932127e-06
3099,remsburg,1,1.8364528545823171e-06,0,0,1,9.472836640932127e-06
3101,translate,1,1.8364528545823171e-06,0,0,1,9.472836640932127e-06
3106,steals,1,1.8364528545823171e-06,0,0,1,9.472836640932127e-06
3107,guaranteeing,1,1.8364528545823171e-06,0,0,1,9.472836640932127e-06
3115,stilland,1,1.8364528545823171e-06,0,0,1,9.472836640932127e-06
3125,seeger,1,1.8364528545823171e-06,0,0,1,9.472836640932127e-06
3128,affront,1,1.8364528545823171e-06,0,0,1,9.472836640932127e-06
3129,decency,1,1.8364528545823171e-06,0,0,1,9.472836640932127e-06
3137,reproductive,1,1.8364528545823171e-06,0,0,1,9.472836640932127e-06
3138,#roe41,1,1.8364528545823171e-06,0,0,1,9.472836640932127e-06
3143,41st,1,1.8364528545823171e-06,0,0,1,9.472836640932127e-06
3146,@kalpenn,1,1.8364528545823171e-06,0,0,1,9.472836640932127e-06
3149,dunking,1,1.8364528545823171e-06,0,0,1,9.472836640932127e-06
3148,@kingjames,1,1.8364528545823171e-06,0,0,1,9.472836640932127e-06
3147,#airflotus,1,1.8364528545823171e-06,0,0,1,9.472836640932127e-06
3150,@dcck,1,1.8364528545823171e-06,0,0,1,9.472836640932127e-06
3161,popcorn,1,1.8364528545823171e-06,0,0,1,9.472836640932127e-06
3160,flavor,1,1.8364528545823171e-06,0,0,1,9.472836640932127e-06
3163,@npr,1,1.8364528545823171e-06,0,0,1,9.472836640932127e-06
3165,transformative,1,1.8364528545823171e-06,0,0,1,9.472836640932127e-06
3182,accounttheyre,1,1.8364528545823171e-06,0,0,1,9.472836640932127e-06
3192,handout,1,1.8364528545823171e-06,0,0,1,9.472836640932127e-06
3199,not-for-profits,1,1.8364528545823171e-06,0,0,1,9.472836640932127e-06
3201,coptic,1,1.8364528545823171e-06,0,0,1,9.472836640932127e-06
3207,abstraction,1,1.8364528545823171e-06,0,0,1,9.472836640932127e-06
3210,#gotcovered,1,1.8364528545823171e-06,0,0,1,9.472836640932127e-06
3214,toughwe,1,1.8364528545823171e-06,0,0,1,9.472836640932127e-06
3216,howards,1,1.8364528545823171e-06,0,0,1,9.472836640932127e-06
3219,leukemia,1,1.8364528545823171e-06,0,0,1,9.472836640932127e-06
3225,lois,1,1.8364528545823171e-06,0,0,1,9.472836640932127e-06
3224,insurancebefore,1,1.8364528545823171e-06,0,0,1,9.472836640932127e-06
3223,680,1,1.8364528545823171e-06,0,0,1,9.472836640932127e-06
3227,bunions,1,1.8364528545823171e-06,0,0,1,9.472836640932127e-06
3232,rosetta,1,1.8364528545823171e-06,0,0,1,9.472836640932127e-06
3234,careand,1,1.8364528545823171e-06,0,0,1,9.472836640932127e-06
3238,outadd,1,1.8364528545823171e-06,0,0,1,9.472836640932127e-06
3240,dcenter,1,1.8364528545823171e-06,0,0,1,9.472836640932127e-06
3249,rightsbut,1,1.8364528545823171e-06,0,0,1,9.472836640932127e-06
3251,shrunk,1,1.8364528545823171e-06,0,0,1,9.472836640932127e-06
3252,texan,1,1.8364528545823171e-06,0,0,1,9.472836640932127e-06
3253,seasonal,1,1.8364528545823171e-06,0,0,1,9.472836640932127e-06
3258,signups,1,1.8364528545823171e-06,0,0,1,9.472836640932127e-06
3260,#dec23the,1,1.8364528545823171e-06,0,0,1,9.472836640932127e-06
3266,#happyholidays,1,1.8364528545823171e-06,0,0,1,9.472836640932127e-06
3269,jan,1,1.8364528545823171e-06,0,0,1,9.472836640932127e-06
3279,directionbut,1,1.8364528545823171e-06,0,0,1,9.472836640932127e-06
3281,checkups,1,1.8364528545823171e-06,0,0,1,9.472836640932127e-06
3286,pediatric,1,1.8364528545823171e-06,0,0,1,9.472836640932127e-06
3285,dental,1,1.8364528545823171e-06,0,0,1,9.472836640932127e-06
3294,largeness,1,1.8364528545823171e-06,0,0,1,9.472836640932127e-06
3296,#whholiday,1,1.8364528545823171e-06,0,0,1,9.472836640932127e-06
3301,@thenationaltree,1,1.8364528545823171e-06,0,0,1,9.472836640932127e-06
3307,remembers,1,1.8364528545823171e-06,0,0,1,9.472836640932127e-06
3313,acne,1,1.8364528545823171e-06,0,0,1,9.472836640932127e-06
3315,toenail,1,1.8364528545823171e-06,0,0,1,9.472836640932127e-06
3314,fungus,1,1.8364528545823171e-06,0,0,1,9.472836640932127e-06
3316,okaybecause,1,1.8364528545823171e-06,0,0,1,9.472836640932127e-06
3320,lovepresident,1,1.8364528545823171e-06,0,0,1,9.472836640932127e-06
3323,mobility,1,1.8364528545823171e-06,0,0,1,9.472836640932127e-06
3325,productivity,1,1.8364528545823171e-06,0,0,1,9.472836640932127e-06
3326,#safeclimatecaucus,1,1.8364528545823171e-06,0,0,1,9.472836640932127e-06
3333,trivia,1,1.8364528545823171e-06,0,0,1,9.472836640932127e-06
3331,dome,1,1.8364528545823171e-06,0,0,1,9.472836640932127e-06
3341,#smallbizsatremember,1,1.8364528545823171e-06,0,0,1,9.472836640932127e-06
3344,#thanksgivukkah,1,1.8364528545823171e-06,0,0,1,9.472836640932127e-06
3351,inspirations,1,1.8364528545823171e-06,0,0,1,9.472836640932127e-06
3352,shrek,1,1.8364528545823171e-06,0,0,1,9.472836640932127e-06
3349,@dwanimation,1,1.8364528545823171e-06,0,0,1,9.472836640932127e-06
3363,undermined,1,1.8364528545823171e-06,0,0,1,9.472836640932127e-06
3368,17-year-olds,1,1.8364528545823171e-06,0,0,1,9.472836640932127e-06
3369,celiac,1,1.8364528545823171e-06,0,0,1,9.472836640932127e-06
3375,teenagers,1,1.8364528545823171e-06,0,0,1,9.472836640932127e-06
3376,growingand,1,1.8364528545823171e-06,0,0,1,9.472836640932127e-06
3377,#nationalchildday,1,1.8364528545823171e-06,0,0,1,9.472836640932127e-06
3381,handwritten,1,1.8364528545823171e-06,0,0,1,9.472836640932127e-06
3380,#gettysburgaddress,1,1.8364528545823171e-06,0,0,1,9.472836640932127e-06
3385,sikh,1,1.8364528545823171e-06,0,0,1,9.472836640932127e-06
3384,#happygurpurab,1,1.8364528545823171e-06,0,0,1,9.472836640932127e-06
3387,#followfriday,1,1.8364528545823171e-06,0,0,1,9.472836640932127e-06
3389,@sfwish,1,1.8364528545823171e-06,0,0,1,9.472836640932127e-06
3388,#sfbatkid,1,1.8364528545823171e-06,0,0,1,9.472836640932127e-06
3403,@pryan,1,1.8364528545823171e-06,0,0,1,9.472836640932127e-06
3404,204000,1,1.8364528545823171e-06,0,0,1,9.472836640932127e-06
3405,44-month,1,1.8364528545823171e-06,0,0,1,9.472836640932127e-06
3407,64-32now,1,1.8364528545823171e-06,0,0,1,9.472836640932127e-06
3409,opted,1,1.8364528545823171e-06,0,0,1,9.472836640932127e-06
3413,overjoyed,1,1.8364528545823171e-06,0,0,1,9.472836640932127e-06
3411,couples,1,1.8364528545823171e-06,0,0,1,9.472836640932127e-06
3422,methe,1,1.8364528545823171e-06,0,0,1,9.472836640932127e-06
3423,enda,1,1.8364528545823171e-06,0,0,1,9.472836640932127e-06
3425,saal,1,1.8364528545823171e-06,0,0,1,9.472836640932127e-06
3429,ideological,1,1.8364528545823171e-06,0,0,1,9.472836640932127e-06
3431,carethat,1,1.8364528545823171e-06,0,0,1,9.472836640932127e-06
3437,355,1,1.8364528545823171e-06,0,0,1,9.472836640932127e-06
3440,@drose,1,1.8364528545823171e-06,0,0,1,9.472836640932127e-06
3439,#bullsnation,1,1.8364528545823171e-06,0,0,1,9.472836640932127e-06
3442,#o29,1,1.8364528545823171e-06,0,0,1,9.472836640932127e-06
3446,#thisisreal,1,1.8364528545823171e-06,0,0,1,9.472836640932127e-06
3447,americansrepublicans,1,1.8364528545823171e-06,0,0,1,9.472836640932127e-06
3448,democratssupport,1,1.8364528545823171e-06,0,0,1,9.472836640932127e-06
3451,@ofatruthteam,1,1.8364528545823171e-06,0,0,1,9.472836640932127e-06
3456,190b,1,1.8364528545823171e-06,0,0,1,9.472836640932127e-06
3464,twain,1,1.8364528545823171e-06,0,0,1,9.472836640932127e-06
3466,yesterdayno,1,1.8364528545823171e-06,0,0,1,9.472836640932127e-06
3460,curtain,1,1.8364528545823171e-06,0,0,1,9.472836640932127e-06
3457,attire,1,1.8364528545823171e-06,0,0,1,9.472836640932127e-06
3470,#timeforrealwork,1,1.8364528545823171e-06,0,0,1,9.472836640932127e-06
3475,betterinstead,1,1.8364528545823171e-06,0,0,1,9.472836640932127e-06
3484,continuecongress,1,1.8364528545823171e-06,0,0,1,9.472836640932127e-06
3488,ditch,1,1.8364528545823171e-06,0,0,1,9.472836640932127e-06
3494,5000000000,1,1.8364528545823171e-06,0,0,1,9.472836640932127e-06
3496,nutritional,1,1.8364528545823171e-06,0,0,1,9.472836640932127e-06
3499,concessions,1,1.8364528545823171e-06,0,0,1,9.472836640932127e-06
3502,#nationalcomingoutday,1,1.8364528545823171e-06,0,0,1,9.472836640932127e-06
3504,halted,1,1.8364528545823171e-06,0,0,1,9.472836640932127e-06
3513,obsession,1,1.8364528545823171e-06,0,0,1,9.472836640932127e-06
3512,dismantling,1,1.8364528545823171e-06,0,0,1,9.472836640932127e-06
3515,ransoms,1,1.8364528545823171e-06,0,0,1,9.472836640932127e-06
3516,ransom,1,1.8364528545823171e-06,0,0,1,9.472836640932127e-06
3526,hardship,1,1.8364528545823171e-06,0,0,1,9.472836640932127e-06
3527,careening,1,1.8364528545823171e-06,0,0,1,9.472836640932127e-06
3529,@speakerboehners,1,1.8364528545823171e-06,0,0,1,9.472836640932127e-06
3534,@thinkprogress,1,1.8364528545823171e-06,0,0,1,9.472836640932127e-06
3538,openit,1,1.8364528545823171e-06,0,0,1,9.472836640932127e-06
3554,summarizes,1,1.8364528545823171e-06,0,0,1,9.472836640932127e-06
3555,summarizing,1,1.8364528545823171e-06,0,0,1,9.472836640932127e-06
3559,predictions,1,1.8364528545823171e-06,0,0,1,9.472836640932127e-06
3561,@springsteen,1,1.8364528545823171e-06,0,0,1,9.472836640932127e-06
3566,stresses,1,1.8364528545823171e-06,0,0,1,9.472836640932127e-06
3565,#navyyardshooting,1,1.8364528545823171e-06,0,0,1,9.472836640932127e-06
3574,importantpassing,1,1.8364528545823171e-06,0,0,1,9.472836640932127e-06
3580,#ortheyshutdownthegovernment,1,1.8364528545823171e-06,0,0,1,9.472836640932127e-06
3581,americansbut,1,1.8364528545823171e-06,0,0,1,9.472836640932127e-06
3586,@ernestmoniz,1,1.8364528545823171e-06,0,0,1,9.472836640932127e-06
3588,loansall,1,1.8364528545823171e-06,0,0,1,9.472836640932127e-06
3590,12b,1,1.8364528545823171e-06,0,0,1,9.472836640932127e-06
3597,@jonathandelarco,1,1.8364528545823171e-06,0,0,1,9.472836640932127e-06
3598,discriminate,1,1.8364528545823171e-06,0,0,1,9.472836640932127e-06
3605,voyager,1,1.8364528545823171e-06,0,0,1,9.472836640932127e-06
3603,human-made,1,1.8364528545823171e-06,0,0,1,9.472836640932127e-06
3604,object,1,1.8364528545823171e-06,0,0,1,9.472836640932127e-06
3606,#patriotday,1,1.8364528545823171e-06,0,0,1,9.472836640932127e-06
3612,gases,1,1.8364528545823171e-06,0,0,1,9.472836640932127e-06
3618,@diananyad,1,1.8364528545823171e-06,0,0,1,9.472836640932127e-06
3620,outtell,1,1.8364528545823171e-06,0,0,1,9.472836640932127e-06
3619,#standwith,1,1.8364528545823171e-06,0,0,1,9.472836640932127e-06
3622,willingnesswe,1,1.8364528545823171e-06,0,0,1,9.472836640932127e-06
3626,fromwhen,1,1.8364528545823171e-06,0,0,1,9.472836640932127e-06
3636,possessing,1,1.8364528545823171e-06,0,0,1,9.472836640932127e-06
3637,prophecy,1,1.8364528545823171e-06,0,0,1,9.472836640932127e-06
3642,washingtons,1,1.8364528545823171e-06,0,0,1,9.472836640932127e-06
3644,vaccinations,1,1.8364528545823171e-06,0,0,1,9.472836640932127e-06
3648,tully,1,1.8364528545823171e-06,0,0,1,9.472836640932127e-06
3645,junior-senior,1,1.8364528545823171e-06,0,0,1,9.472836640932127e-06
3650,prohibitively,1,1.8364528545823171e-06,0,0,1,9.472836640932127e-06
3652,suffrage,1,1.8364528545823171e-06,0,0,1,9.472836640932127e-06
3653,#roar,1,1.8364528545823171e-06,0,0,1,9.472836640932127e-06
3655,@katyperry,1,1.8364528545823171e-06,0,0,1,9.472836640932127e-06
3658,wout,1,1.8364528545823171e-06,0,0,1,9.472836640932127e-06
3659,onlineyou,1,1.8364528545823171e-06,0,0,1,9.472836640932127e-06
3660,syracuse,1,1.8364528545823171e-06,0,0,1,9.472836640932127e-06
3667,expensivepresident,1,1.8364528545823171e-06,0,0,1,9.472836640932127e-06
3668,knowledge-based,1,1.8364528545823171e-06,0,0,1,9.472836640932127e-06
3671,sportscenter,1,1.8364528545823171e-06,0,0,1,9.472836640932127e-06
3673,columbine,1,1.8364528545823171e-06,0,0,1,9.472836640932127e-06
3677,mauser,1,1.8364528545823171e-06,0,0,1,9.472836640932127e-06
3678,ericas,1,1.8364528545823171e-06,0,0,1,9.472836640932127e-06
3682,lonnie,1,1.8364528545823171e-06,0,0,1,9.472836640932127e-06
3689,cholesterol,1,1.8364528545823171e-06,0,0,1,9.472836640932127e-06
3694,rightthanks,1,1.8364528545823171e-06,0,0,1,9.472836640932127e-06
3699,hrsweek,1,1.8364528545823171e-06,0,0,1,9.472836640932127e-06
3698,14500still,1,1.8364528545823171e-06,0,0,1,9.472836640932127e-06
3705,discounts,1,1.8364528545823171e-06,0,0,1,9.472836640932127e-06
3707,billsi,1,1.8364528545823171e-06,0,0,1,9.472836640932127e-06
3710,30m,1,1.8364528545823171e-06,0,0,1,9.472836640932127e-06
3711,alejandro,1,1.8364528545823171e-06,0,0,1,9.472836640932127e-06
3715,morales,1,1.8364528545823171e-06,0,0,1,9.472836640932127e-06
3712,cadet,1,1.8364528545823171e-06,0,0,1,9.472836640932127e-06
3714,jrotc,1,1.8364528545823171e-06,0,0,1,9.472836640932127e-06
3713,dreamer,1,1.8364528545823171e-06,0,0,1,9.472836640932127e-06
3717,wears,1,1.8364528545823171e-06,0,0,1,9.472836640932127e-06
3720,homeyou,1,1.8364528545823171e-06,0,0,1,9.472836640932127e-06
3729,dragging,1,1.8364528545823171e-06,0,0,1,9.472836640932127e-06
3732,bubbles,1,1.8364528545823171e-06,0,0,1,9.472836640932127e-06
3734,2000-2010,1,1.8364528545823171e-06,0,0,1,9.472836640932127e-06
3739,rock-solid,1,1.8364528545823171e-06,0,0,1,9.472836640932127e-06
3747,backamerican,1,1.8364528545823171e-06,0,0,1,9.472836640932127e-06
3746,5m,1,1.8364528545823171e-06,0,0,1,9.472836640932127e-06
3750,durable,1,1.8364528545823171e-06,0,0,1,9.472836640932127e-06
3751,800b,1,1.8364528545823171e-06,0,0,1,9.472836640932127e-06
3752,52nd,1,1.8364528545823171e-06,0,0,1,9.472836640932127e-06
3755,upthats,1,1.8364528545823171e-06,0,0,1,9.472836640932127e-06
3759,timea,1,1.8364528545823171e-06,0,0,1,9.472836640932127e-06
3765,peek-a-boo,1,1.8364528545823171e-06,0,0,1,9.472836640932127e-06
3766,#obamanooga,1,1.8364528545823171e-06,0,0,1,9.472836640932127e-06
3769,dignitythe,1,1.8364528545823171e-06,0,0,1,9.472836640932127e-06
3778,marketplaces,1,1.8364528545823171e-06,0,0,1,9.472836640932127e-06
3779,integrated,1,1.8364528545823171e-06,0,0,1,9.472836640932127e-06
3785,adas,1,1.8364528545823171e-06,0,0,1,9.472836640932127e-06
3792,establishing,1,1.8364528545823171e-06,0,0,1,9.472836640932127e-06
3802,loveyou,1,1.8364528545823171e-06,0,0,1,9.472836640932127e-06
3808,susies,1,1.8364528545823171e-06,0,0,1,9.472836640932127e-06
3807,pats,1,1.8364528545823171e-06,0,0,1,9.472836640932127e-06
3805,dreamwe,1,1.8364528545823171e-06,0,0,1,9.472836640932127e-06
3810,somethingyouve,1,1.8364528545823171e-06,0,0,1,9.472836640932127e-06
3814,ignorance,1,1.8364528545823171e-06,0,0,1,9.472836640932127e-06
3816,rungs,1,1.8364528545823171e-06,0,0,1,9.472836640932127e-06
3815,ladder,1,1.8364528545823171e-06,0,0,1,9.472836640932127e-06
3820,quadrupled,1,1.8364528545823171e-06,0,0,1,9.472836640932127e-06
3824,ketchup,1,1.8364528545823171e-06,0,0,1,9.472836640932127e-06
3825,mustard,1,1.8364528545823171e-06,0,0,1,9.472836640932127e-06
3826,@uoflcardinals,1,1.8364528545823171e-06,0,0,1,9.472836640932127e-06
3836,duchess,1,1.8364528545823171e-06,0,0,1,9.472836640932127e-06
3834,cambridge,1,1.8364528545823171e-06,0,0,1,9.472836640932127e-06
3842,helen,1,1.8364528545823171e-06,0,0,1,9.472836640932127e-06
3846,#nomorenames,1,1.8364528545823171e-06,0,0,1,9.472836640932127e-06
3849,trayvon,1,1.8364528545823171e-06,0,0,1,9.472836640932127e-06
3850,@nrdc,1,1.8364528545823171e-06,0,0,1,9.472836640932127e-06
3853,@epa,1,1.8364528545823171e-06,0,0,1,9.472836640932127e-06
3860,95th,1,1.8364528545823171e-06,0,0,1,9.472836640932127e-06
3859,#mandeladay,1,1.8364528545823171e-06,0,0,1,9.472836640932127e-06
3861,#immigrationnot,1,1.8364528545823171e-06,0,0,1,9.472836640932127e-06
3863,americansdemocrats,1,1.8364528545823171e-06,0,0,1,9.472836640932127e-06
3864,republicansagree,1,1.8364528545823171e-06,0,0,1,9.472836640932127e-06
3867,all-star,1,1.8364528545823171e-06,0,0,1,9.472836640932127e-06
3868,nl,1,1.8364528545823171e-06,0,0,1,9.472836640932127e-06
3865,#asg,1,1.8364528545823171e-06,0,0,1,9.472836640932127e-06
3876,vip,1,1.8364528545823171e-06,0,0,1,9.472836640932127e-06
3877,decreased,1,1.8364528545823171e-06,0,0,1,9.472836640932127e-06
3882,ittheyre,1,1.8364528545823171e-06,0,0,1,9.472836640932127e-06
3884,300b,1,1.8364528545823171e-06,0,0,1,9.472836640932127e-06
3887,joys,1,1.8364528545823171e-06,0,0,1,9.472836640932127e-06
3886,#ramadan,1,1.8364528545823171e-06,0,0,1,9.472836640932127e-06
3892,#smartergov,1,1.8364528545823171e-06,0,0,1,9.472836640932127e-06
3898,1964,1,1.8364528545823171e-06,0,0,1,9.472836640932127e-06
3900,lyndon,1,1.8364528545823171e-06,0,0,1,9.472836640932127e-06
3905,compact,1,1.8364528545823171e-06,0,0,1,9.472836640932127e-06
3912,selfie,1,1.8364528545823171e-06,0,0,1,9.472836640932127e-06
3919,plaintiffs,1,1.8364528545823171e-06,0,0,1,9.472836640932127e-06
3922,#standwithwendy,1,1.8364528545823171e-06,0,0,1,9.472836640932127e-06
3925,déjà,1,1.8364528545823171e-06,0,0,1,9.472836640932127e-06
3926,vu,1,1.8364528545823171e-06,0,0,1,9.472836640932127e-06
3929,habitable,1,1.8364528545823171e-06,0,0,1,9.472836640932127e-06
3930,consume,1,1.8364528545823171e-06,0,0,1,9.472836640932127e-06
3933,planetpresident,1,1.8364528545823171e-06,0,0,1,9.472836640932127e-06
3935,timewe,1,1.8364528545823171e-06,0,0,1,9.472836640932127e-06
3936,#americanstoryand,1,1.8364528545823171e-06,0,0,1,9.472836640932127e-06
3941,scorer,1,1.8364528545823171e-06,0,0,1,9.472836640932127e-06
3942,socceryouve,1,1.8364528545823171e-06,0,0,1,9.472836640932127e-06
3939,#chasingabby,1,1.8364528545823171e-06,0,0,1,9.472836640932127e-06
3944,marbles,1,1.8364528545823171e-06,0,0,1,9.472836640932127e-06
3946,#sbw2013,1,1.8364528545823171e-06,0,0,1,9.472836640932127e-06
3949,#notok,1,1.8364528545823171e-06,0,0,1,9.472836640932127e-06
3951,afghanistanvp,1,1.8364528545823171e-06,0,0,1,9.472836640932127e-06
3952,1797,1,1.8364528545823171e-06,0,0,1,9.472836640932127e-06
3955,1885,1,1.8364528545823171e-06,0,0,1,9.472836640932127e-06
3972,@selcharrodeoros,1,1.8364528545823171e-06,0,0,1,9.472836640932127e-06
3975,encore,1,1.8364528545823171e-06,0,0,1,9.472836640932127e-06
3978,pointpresident,1,1.8364528545823171e-06,0,0,1,9.472836640932127e-06
3981,#newtownand,1,1.8364528545823171e-06,0,0,1,9.472836640932127e-06
3985,#tweetsfromhillary,1,1.8364528545823171e-06,0,0,1,9.472836640932127e-06
3988,valued,1,1.8364528545823171e-06,0,0,1,9.472836640932127e-06
3987,manspresident,1,1.8364528545823171e-06,0,0,1,9.472836640932127e-06
3991,dynamism,1,1.8364528545823171e-06,0,0,1,9.472836640932127e-06
3992,matched,1,1.8364528545823171e-06,0,0,1,9.472836640932127e-06
3996,178000,1,1.8364528545823171e-06,0,0,1,9.472836640932127e-06
3997,#whathasobamacaredoneformelately,1,1.8364528545823171e-06,0,0,1,9.472836640932127e-06
3998,#affordablecareact,1,1.8364528545823171e-06,0,0,1,9.472836640932127e-06
4004,outset,1,1.8364528545823171e-06,0,0,1,9.472836640932127e-06
4007,likeheat,1,1.8364528545823171e-06,0,0,1,9.472836640932127e-06
4011,funder,1,1.8364528545823171e-06,0,0,1,9.472836640932127e-06
4023,@jtimberlake,1,1.8364528545823171e-06,0,0,1,9.472836640932127e-06
4026,#stts,1,1.8364528545823171e-06,0,0,1,9.472836640932127e-06
4030,oklahomans,1,1.8364528545823171e-06,0,0,1,9.472836640932127e-06
4028,#moore,1,1.8364528545823171e-06,0,0,1,9.472836640932127e-06
4033,fastest-growing,1,1.8364528545823171e-06,0,0,1,9.472836640932127e-06
4035,@marchforinnov,1,1.8364528545823171e-06,0,0,1,9.472836640932127e-06
4038,immigrant-owned,1,1.8364528545823171e-06,0,0,1,9.472836640932127e-06
4037,775,1,1.8364528545823171e-06,0,0,1,9.472836640932127e-06
4047,alaskas,1,1.8364528545823171e-06,0,0,1,9.472836640932127e-06
4049,glacier,1,1.8364528545823171e-06,0,0,1,9.472836640932127e-06
4050,melt,1,1.8364528545823171e-06,0,0,1,9.472836640932127e-06
4051,entrepreneur,1,1.8364528545823171e-06,0,0,1,9.472836640932127e-06
4052,faizan,1,1.8364528545823171e-06,0,0,1,9.472836640932127e-06
4055,ninety-seven,1,1.8364528545823171e-06,0,0,1,9.472836640932127e-06
4057,streamlining,1,1.8364528545823171e-06,0,0,1,9.472836640932127e-06
4060,#science,1,1.8364528545823171e-06,0,0,1,9.472836640932127e-06
4062,#youwillnotbetakenseriouslyif,1,1.8364528545823171e-06,0,0,1,9.472836640932127e-06
4064,#climatechange,1,1.8364528545823171e-06,0,0,1,9.472836640932127e-06
4067,@warrenbuffett,1,1.8364528545823171e-06,0,0,1,9.472836640932127e-06
4068,176000,1,1.8364528545823171e-06,0,0,1,9.472836640932127e-06
4074,wendell,1,1.8364528545823171e-06,0,0,1,9.472836640932127e-06
4073,berry,1,1.8364528545823171e-06,0,0,1,9.472836640932127e-06
4072,#earthday,1,1.8364528545823171e-06,0,0,1,9.472836640932127e-06
4081,interfaith,1,1.8364528545823171e-06,0,0,1,9.472836640932127e-06
4082,over…,1,1.8364528545823171e-06,0,0,1,9.472836640932127e-06
4086,upcall,1,1.8364528545823171e-06,0,0,1,9.472836640932127e-06
4088,evilthats,1,1.8364528545823171e-06,0,0,1,9.472836640932127e-06
4087,compassionately,1,1.8364528545823171e-06,0,0,1,9.472836640932127e-06
4090,unafraid,1,1.8364528545823171e-06,0,0,1,9.472836640932127e-06
4092,explosions,1,1.8364528545823171e-06,0,0,1,9.472836640932127e-06
4094,kindness,1,1.8364528545823171e-06,0,0,1,9.472836640932127e-06
4096,democratswe,1,1.8364528545823171e-06,0,0,1,9.472836640932127e-06
4102,childisnt,1,1.8364528545823171e-06,0,0,1,9.472836640932127e-06
4106,usthe,1,1.8364528545823171e-06,0,0,1,9.472836640932127e-06
4105,peopleto,1,1.8364528545823171e-06,0,0,1,9.472836640932127e-06
4109,thatchers,1,1.8364528545823171e-06,0,0,1,9.472836640932127e-06
4110,brokenand,1,1.8364528545823171e-06,0,0,1,9.472836640932127e-06
4120,gunwhether,1,1.8364528545823171e-06,0,0,1,9.472836640932127e-06
4121,licensed,1,1.8364528545823171e-06,0,0,1,9.472836640932127e-06
4119,dealer,1,1.8364528545823171e-06,0,0,1,9.472836640932127e-06
4122,selleryou,1,1.8364528545823171e-06,0,0,1,9.472836640932127e-06
4129,3766,1,1.8364528545823171e-06,0,0,1,9.472836640932127e-06
4131,ohiomore,1,1.8364528545823171e-06,0,0,1,9.472836640932127e-06
4132,2001-2010,1,1.8364528545823171e-06,0,0,1,9.472836640932127e-06
4134,jogging,1,1.8364528545823171e-06,0,0,1,9.472836640932127e-06
4143,forgetfamilies,1,1.8364528545823171e-06,0,0,1,9.472836640932127e-06
4147,pieand,1,1.8364528545823171e-06,0,0,1,9.472836640932127e-06
4152,americans90support,1,1.8364528545823171e-06,0,0,1,9.472836640932127e-06
4157,longand,1,1.8364528545823171e-06,0,0,1,9.472836640932127e-06
4171,voteand,1,1.8364528545823171e-06,0,0,1,9.472836640932127e-06
4173,#iraq,1,1.8364528545823171e-06,0,0,1,9.472836640932127e-06
4176,snack,1,1.8364528545823171e-06,0,0,1,9.472836640932127e-06
4177,educationand,1,1.8364528545823171e-06,0,0,1,9.472836640932127e-06
4179,reachfor,1,1.8364528545823171e-06,0,0,1,9.472836640932127e-06
4183,geothermal,1,1.8364528545823171e-06,0,0,1,9.472836640932127e-06
4192,dougie,1,1.8364528545823171e-06,0,0,1,9.472836640932127e-06
4198,acquired,1,1.8364528545823171e-06,0,0,1,9.472836640932127e-06
4204,doits,1,1.8364528545823171e-06,0,0,1,9.472836640932127e-06
4203,#womensday,1,1.8364528545823171e-06,0,0,1,9.472836640932127e-06
4209,jobsnot,1,1.8364528545823171e-06,0,0,1,9.472836640932127e-06
4207,drastic,1,1.8364528545823171e-06,0,0,1,9.472836640932127e-06
4215,affordablenot,1,1.8364528545823171e-06,0,0,1,9.472836640932127e-06
4219,violencemore,1,1.8364528545823171e-06,0,0,1,9.472836640932127e-06
4221,168,1,1.8364528545823171e-06,0,0,1,9.472836640932127e-06
4226,sensible,1,1.8364528545823171e-06,0,0,1,9.472836640932127e-06
4228,arbitrary,1,1.8364528545823171e-06,0,0,1,9.472836640932127e-06
4234,gestures,1,1.8364528545823171e-06,0,0,1,9.472836640932127e-06
4237,#jobsovercuts,1,1.8364528545823171e-06,0,0,1,9.472836640932127e-06
4241,familiesnot,1,1.8364528545823171e-06,0,0,1,9.472836640932127e-06
4242,370000,1,1.8364528545823171e-06,0,0,1,9.472836640932127e-06
4247,shrinks,1,1.8364528545823171e-06,0,0,1,9.472836640932127e-06
4248,#oscars,1,1.8364528545823171e-06,0,0,1,9.472836640932127e-06
4249,newsflash,1,1.8364528545823171e-06,0,0,1,9.472836640932127e-06
4257,succession,1,1.8364528545823171e-06,0,0,1,9.472836640932127e-06
4252,anyones,1,1.8364528545823171e-06,0,0,1,9.472836640932127e-06
4253,calvin,1,1.8364528545823171e-06,0,0,1,9.472836640932127e-06
4259,cherelle,1,1.8364528545823171e-06,0,0,1,9.472836640932127e-06
4269,propels,1,1.8364528545823171e-06,0,0,1,9.472836640932127e-06
4270,tipped,1,1.8364528545823171e-06,0,0,1,9.472836640932127e-06
4271,workerswhich,1,1.8364528545823171e-06,0,0,1,9.472836640932127e-06
4276,hourdirectly,1,1.8364528545823171e-06,0,0,1,9.472836640932127e-06
4281,adapt,1,1.8364528545823171e-06,0,0,1,9.472836640932127e-06
4283,salesrt,1,1.8364528545823171e-06,0,0,1,9.472836640932127e-06
4286,wo,1,1.8364528545823171e-06,0,0,1,9.472836640932127e-06
4288,#theydeserveavote,1,1.8364528545823171e-06,0,0,1,9.472836640932127e-06
4289,authors,1,1.8364528545823171e-06,0,0,1,9.472836640932127e-06
4295,familiesgay,1,1.8364528545823171e-06,0,0,1,9.472836640932127e-06
4299,broad-based,1,1.8364528545823171e-06,0,0,1,9.472836640932127e-06
4305,grinding,1,1.8364528545823171e-06,0,0,1,9.472836640932127e-06
4309,gila,1,1.8364528545823171e-06,0,0,1,9.472836640932127e-06
4312,amplifies,1,1.8364528545823171e-06,0,0,1,9.472836640932127e-06
4317,ak-47,1,1.8364528545823171e-06,0,0,1,9.472836640932127e-06
4319,sporting,1,1.8364528545823171e-06,0,0,1,9.472836640932127e-06
4322,unlicensed,1,1.8364528545823171e-06,0,0,1,9.472836640932127e-06
4325,great-great,1,1.8364528545823171e-06,0,0,1,9.472836640932127e-06
4324,grandparent,1,1.8364528545823171e-06,0,0,1,9.472836640932127e-06
4326,jose,1,1.8364528545823171e-06,0,0,1,9.472836640932127e-06
4327,magana,1,1.8364528545823171e-06,0,0,1,9.472836640932127e-06
4330,magazinespresident,1,1.8364528545823171e-06,0,0,1,9.472836640932127e-06
4332,saveweve,1,1.8364528545823171e-06,0,0,1,9.472836640932127e-06
4335,countryon,1,1.8364528545823171e-06,0,0,1,9.472836640932127e-06
4336,166000,1,1.8364528545823171e-06,0,0,1,9.472836640932127e-06
4337,35th,1,1.8364528545823171e-06,0,0,1,9.472836640932127e-06
4346,againthe,1,1.8364528545823171e-06,0,0,1,9.472836640932127e-06
4347,pausing,1,1.8364528545823171e-06,0,0,1,9.472836640932127e-06
4353,imperfect,1,1.8364528545823171e-06,0,0,1,9.472836640932127e-06
4354,absolutism,1,1.8364528545823171e-06,0,0,1,9.472836640932127e-06
4358,spectacle,1,1.8364528545823171e-06,0,0,1,9.472836640932127e-06
4355,name-calling,1,1.8364528545823171e-06,0,0,1,9.472836640932127e-06
4365,truthsthat,1,1.8364528545823171e-06,0,0,1,9.472836640932127e-06
4362,equalis,1,1.8364528545823171e-06,0,0,1,9.472836640932127e-06
4364,guides,1,1.8364528545823171e-06,0,0,1,9.472836640932127e-06
4366,perpetual,1,1.8364528545823171e-06,0,0,1,9.472836640932127e-06
4368,itso,1,1.8364528545823171e-06,0,0,1,9.472836640932127e-06
4370,#fourmoreyears,1,1.8364528545823171e-06,0,0,1,9.472836640932127e-06
4375,#inaug2013,1,1.8364528545823171e-06,0,0,1,9.472836640932127e-06
4388,hinder,1,1.8364528545823171e-06,0,0,1,9.472836640932127e-06
4397,flaw,1,1.8364528545823171e-06,0,0,1,9.472836640932127e-06
4396,exploited,1,1.8364528545823171e-06,0,0,1,9.472836640932127e-06
4395,1-man,1,1.8364528545823171e-06,0,0,1,9.472836640932127e-06
4398,starship,1,1.8364528545823171e-06,0,0,1,9.472836640932127e-06
4402,168000,1,1.8364528545823171e-06,0,0,1,9.472836640932127e-06
4406,620,1,1.8364528545823171e-06,0,0,1,9.472836640932127e-06
4410,emancipation,1,1.8364528545823171e-06,0,0,1,9.472836640932127e-06
4415,economys,1,1.8364528545823171e-06,0,0,1,9.472836640932127e-06
4416,sustaining,1,1.8364528545823171e-06,0,0,1,9.472836640932127e-06
4419,self-inflicted,1,1.8364528545823171e-06,0,0,1,9.472836640932127e-06
4426,nowpresident,1,1.8364528545823171e-06,0,0,1,9.472836640932127e-06
4432,scroll,1,1.8364528545823171e-06,0,0,1,9.472836640932127e-06
4434,yearand,1,1.8364528545823171e-06,0,0,1,9.472836640932127e-06
4431,campaignwhat,1,1.8364528545823171e-06,0,0,1,9.472836640932127e-06
4440,petitions,1,1.8364528545823171e-06,0,0,1,9.472836640932127e-06
4442,reasonnonenot,1,1.8364528545823171e-06,0,0,1,9.472836640932127e-06
4448,obligationall,1,1.8364528545823171e-06,0,0,1,9.472836640932127e-06
4449,usto,1,1.8364528545823171e-06,0,0,1,9.472836640932127e-06
4454,@times,1,1.8364528545823171e-06,0,0,1,9.472836640932127e-06
4456,spider-mans,1,1.8364528545823171e-06,0,0,1,9.472836640932127e-06
4458,hugging,1,1.8364528545823171e-06,0,0,1,9.472836640932127e-06
4461,inouye,1,1.8364528545823171e-06,0,0,1,9.472836640932127e-06
4463,conscious,1,1.8364528545823171e-06,0,0,1,9.472836640932127e-06
4468,starring,1,1.8364528545823171e-06,0,0,1,9.472836640932127e-06
4479,taxesbut,1,1.8364528545823171e-06,0,0,1,9.472836640932127e-06
4485,actright,1,1.8364528545823171e-06,0,0,1,9.472836640932127e-06
4486,nowto,1,1.8364528545823171e-06,0,0,1,9.472836640932127e-06
4499,thanksnot,1,1.8364528545823171e-06,0,0,1,9.472836640932127e-06
4505,3-year-old,1,1.8364528545823171e-06,0,0,1,9.472836640932127e-06
4506,eyesalicia,1,1.8364528545823171e-06,0,0,1,9.472836640932127e-06
4510,committhis,1,1.8364528545823171e-06,0,0,1,9.472836640932127e-06
4511,dayto,1,1.8364528545823171e-06,0,0,1,9.472836640932127e-06
4515,ripples,1,1.8364528545823171e-06,0,0,1,9.472836640932127e-06
4514,lakethats,1,1.8364528545823171e-06,0,0,1,9.472836640932127e-06
4536,730pm,1,1.8364528545823171e-06,0,0,1,9.472836640932127e-06
4537,#electionday2012,1,1.8364528545823171e-06,0,0,1,9.472836640932127e-06
4541,ferrell,1,1.8364528545823171e-06,0,0,1,9.472836640932127e-06
4546,electiongrab,1,1.8364528545823171e-06,0,0,1,9.472836640932127e-06
4547,campaignall,1,1.8364528545823171e-06,0,0,1,9.472836640932127e-06
4548,knowjoe,1,1.8364528545823171e-06,0,0,1,9.472836640932127e-06
4556,schoolamy,1,1.8364528545823171e-06,0,0,1,9.472836640932127e-06
4559,amanda,1,1.8364528545823171e-06,0,0,1,9.472836640932127e-06
4558,ak,1,1.8364528545823171e-06,0,0,1,9.472836640932127e-06
4560,thingrt,1,1.8364528545823171e-06,0,0,1,9.472836640932127e-06
4563,lotand,1,1.8364528545823171e-06,0,0,1,9.472836640932127e-06
4567,ladens,1,1.8364528545823171e-06,0,0,1,9.472836640932127e-06
4565,compound,1,1.8364528545823171e-06,0,0,1,9.472836640932127e-06
4576,ipod,1,1.8364528545823171e-06,0,0,1,9.472836640932127e-06
4579,yall,1,1.8364528545823171e-06,0,0,1,9.472836640932127e-06
4582,callsyou,1,1.8364528545823171e-06,0,0,1,9.472836640932127e-06
4585,propel,1,1.8364528545823171e-06,0,0,1,9.472836640932127e-06
4592,campaignnot,1,1.8364528545823171e-06,0,0,1,9.472836640932127e-06
4599,likeand,1,1.8364528545823171e-06,0,0,1,9.472836640932127e-06
4601,lesbian,1,1.8364528545823171e-06,0,0,1,9.472836640932127e-06
4606,gi,1,1.8364528545823171e-06,0,0,1,9.472836640932127e-06
4605,enabling,1,1.8364528545823171e-06,0,0,1,9.472836640932127e-06
4604,bachelors,1,1.8364528545823171e-06,0,0,1,9.472836640932127e-06
4612,yearstay,1,1.8364528545823171e-06,0,0,1,9.472836640932127e-06
4613,yearsget,1,1.8364528545823171e-06,0,0,1,9.472836640932127e-06
4614,cincy,1,1.8364528545823171e-06,0,0,1,9.472836640932127e-06
4621,sturdy,1,1.8364528545823171e-06,0,0,1,9.472836640932127e-06
4623,wealthiestthats,1,1.8364528545823171e-06,0,0,1,9.472836640932127e-06
4626,gopresident,1,1.8364528545823171e-06,0,0,1,9.472836640932127e-06
4631,concord,1,1.8364528545823171e-06,0,0,1,9.472836640932127e-06
4635,daythats,1,1.8364528545823171e-06,0,0,1,9.472836640932127e-06
4636,bristow,1,1.8364528545823171e-06,0,0,1,9.472836640932127e-06
4638,haaretz,1,1.8364528545823171e-06,0,0,1,9.472836640932127e-06
4641,ferrells,1,1.8364528545823171e-06,0,0,1,9.472836640932127e-06
4643,campaignthats,1,1.8364528545823171e-06,0,0,1,9.472836640932127e-06
4646,must-share,1,1.8364528545823171e-06,0,0,1,9.472836640932127e-06
4648,leftno,1,1.8364528545823171e-06,0,0,1,9.472836640932127e-06
4653,jeep,1,1.8364528545823171e-06,0,0,1,9.472836640932127e-06
4656,479000,1,1.8364528545823171e-06,0,0,1,9.472836640932127e-06
4658,mid-1990s,1,1.8364528545823171e-06,0,0,1,9.472836640932127e-06
4659,5-year,1,1.8364528545823171e-06,0,0,1,9.472836640932127e-06
4663,oncolin,1,1.8364528545823171e-06,0,0,1,9.472836640932127e-06
4667,achievable,1,1.8364528545823171e-06,0,0,1,9.472836640932127e-06
4669,goalstheyre,1,1.8364528545823171e-06,0,0,1,9.472836640932127e-06
4673,self-interest,1,1.8364528545823171e-06,0,0,1,9.472836640932127e-06
4686,sharedthat,1,1.8364528545823171e-06,0,0,1,9.472836640932127e-06
4687,peopleyour,1,1.8364528545823171e-06,0,0,1,9.472836640932127e-06
4689,voiceshad,1,1.8364528545823171e-06,0,0,1,9.472836640932127e-06
4690,ourselveswe,1,1.8364528545823171e-06,0,0,1,9.472836640932127e-06
4697,salesman,1,1.8364528545823171e-06,0,0,1,9.472836640932127e-06
4700,presidentbecause,1,1.8364528545823171e-06,0,0,1,9.472836640932127e-06
4702,daysbecause,1,1.8364528545823171e-06,0,0,1,9.472836640932127e-06
4708,thingget,1,1.8364528545823171e-06,0,0,1,9.472836640932127e-06
4710,geneticsthis,1,1.8364528545823171e-06,0,0,1,9.472836640932127e-06
4712,canheres,1,1.8364528545823171e-06,0,0,1,9.472836640932127e-06
4713,state-by-state,1,1.8364528545823171e-06,0,0,1,9.472836640932127e-06
4716,teaching,1,1.8364528545823171e-06,0,0,1,9.472836640932127e-06
4714,dayyou,1,1.8364528545823171e-06,0,0,1,9.472836640932127e-06
4715,loreen,1,1.8364528545823171e-06,0,0,1,9.472836640932127e-06
4724,third-quarter,1,1.8364528545823171e-06,0,0,1,9.472836640932127e-06
4726,sandys,1,1.8364528545823171e-06,0,0,1,9.472836640932127e-06
4729,seaboard,1,1.8364528545823171e-06,0,0,1,9.472836640932127e-06
4733,blade,1,1.8364528545823171e-06,0,0,1,9.472836640932127e-06
4736,re-electing,1,1.8364528545823171e-06,0,0,1,9.472836640932127e-06
4738,fieldvolunteer,1,1.8364528545823171e-06,0,0,1,9.472836640932127e-06
4739,grabbing,1,1.8364528545823171e-06,0,0,1,9.472836640932127e-06
4740,pint,1,1.8364528545823171e-06,0,0,1,9.472836640932127e-06
4741,on-your-own,1,1.8364528545823171e-06,0,0,1,9.472836640932127e-06
4747,womenpresident,1,1.8364528545823171e-06,0,0,1,9.472836640932127e-06
4749,equalizer,1,1.8364528545823171e-06,0,0,1,9.472836640932127e-06
4752,fact-checker,1,1.8364528545823171e-06,0,0,1,9.472836640932127e-06
4751,bait-and-switch,1,1.8364528545823171e-06,0,0,1,9.472836640932127e-06
4769,symptoms,1,1.8364528545823171e-06,0,0,1,9.472836640932127e-06
4766,conditionspresident,1,1.8364528545823171e-06,0,0,1,9.472836640932127e-06
4771,call…,1,1.8364528545823171e-06,0,0,1,9.472836640932127e-06
4783,pregnant,1,1.8364528545823171e-06,0,0,1,9.472836640932127e-06
4789,conception,1,1.8364528545823171e-06,0,0,1,9.472836640932127e-06
4788,co-sponsored,1,1.8364528545823171e-06,0,0,1,9.472836640932127e-06
4791,redefine,1,1.8364528545823171e-06,0,0,1,9.472836640932127e-06
4798,hoarse,1,1.8364528545823171e-06,0,0,1,9.472836640932127e-06
4810,firehouse,1,1.8364528545823171e-06,0,0,1,9.472836640932127e-06
4813,spontaneous,1,1.8364528545823171e-06,0,0,1,9.472836640932127e-06
4818,staffers,1,1.8364528545823171e-06,0,0,1,9.472836640932127e-06
4820,all-nighter,1,1.8364528545823171e-06,0,0,1,9.472836640932127e-06
4822,@gwenstefani,1,1.8364528545823171e-06,0,0,1,9.472836640932127e-06
4823,hanging,1,1.8364528545823171e-06,0,0,1,9.472836640932127e-06
4824,@jaylenotonightmake,1,1.8364528545823171e-06,0,0,1,9.472836640932127e-06
4830,mourdockwhod,1,1.8364528545823171e-06,0,0,1,9.472836640932127e-06
4828,attackers,1,1.8364528545823171e-06,0,0,1,9.472836640932127e-06
4833,mourdocks,1,1.8364528545823171e-06,0,0,1,9.472836640932127e-06
4835,mourdockwho,1,1.8364528545823171e-06,0,0,1,9.472836640932127e-06
4836,pregnancies,1,1.8364528545823171e-06,0,0,1,9.472836640932127e-06
4842,voicewho,1,1.8364528545823171e-06,0,0,1,9.472836640932127e-06
4844,not-so-young,1,1.8364528545823171e-06,0,0,1,9.472836640932127e-06
4845,peopleincluding,1,1.8364528545823171e-06,0,0,1,9.472836640932127e-06
4843,meto,1,1.8364528545823171e-06,0,0,1,9.472836640932127e-06
4851,forits,1,1.8364528545823171e-06,0,0,1,9.472836640932127e-06
4852,mepresident,1,1.8364528545823171e-06,0,0,1,9.472836640932127e-06
4853,signage,1,1.8364528545823171e-06,0,0,1,9.472836640932127e-06
4864,businessesand,1,1.8364528545823171e-06,0,0,1,9.472836640932127e-06
4866,homemade,1,1.8364528545823171e-06,0,0,1,9.472836640932127e-06
4865,extra-big,1,1.8364528545823171e-06,0,0,1,9.472836640932127e-06
4870,second-term,1,1.8364528545823171e-06,0,0,1,9.472836640932127e-06
4872,messpresident,1,1.8364528545823171e-06,0,0,1,9.472836640932127e-06
4875,delray,1,1.8364528545823171e-06,0,0,1,9.472836640932127e-06
4877,1920s,1,1.8364528545823171e-06,0,0,1,9.472836640932127e-06
4882,medicareyouve,1,1.8364528545823171e-06,0,0,1,9.472836640932127e-06
4884,bankruptyou,1,1.8364528545823171e-06,0,0,1,9.472836640932127e-06
4887,nightit,1,1.8364528545823171e-06,0,0,1,9.472836640932127e-06
4892,coherent,1,1.8364528545823171e-06,0,0,1,9.472836640932127e-06
4904,forgetpresident,1,1.8364528545823171e-06,0,0,1,9.472836640932127e-06
4906,jobsin,1,1.8364528545823171e-06,0,0,1,9.472836640932127e-06
4908,afghan,1,1.8364528545823171e-06,0,0,1,9.472836640932127e-06
4917,premature,1,1.8364528545823171e-06,0,0,1,9.472836640932127e-06
4916,actionpresident,1,1.8364528545823171e-06,0,0,1,9.472836640932127e-06
4919,attackedpresident,1,1.8364528545823171e-06,0,0,1,9.472836640932127e-06
4921,48th,1,1.8364528545823171e-06,0,0,1,9.472836640932127e-06
4925,needpresident,1,1.8364528545823171e-06,0,0,1,9.472836640932127e-06
4929,geopolitical,1,1.8364528545823171e-06,0,0,1,9.472836640932127e-06
4935,refocused,1,1.8364528545823171e-06,0,0,1,9.472836640932127e-06
4937,2014mitt,1,1.8364528545823171e-06,0,0,1,9.472836640932127e-06
4939,strong-willed,1,1.8364528545823171e-06,0,0,1,9.472836640932127e-06
4940,mcgovern,1,1.8364528545823171e-06,0,0,1,9.472836640932127e-06
4942,virginian,1,1.8364528545823171e-06,0,0,1,9.472836640932127e-06
4945,choosebut,1,1.8364528545823171e-06,0,0,1,9.472836640932127e-06
4952,conditionlets,1,1.8364528545823171e-06,0,0,1,9.472836640932127e-06
4955,suited,1,1.8364528545823171e-06,0,0,1,9.472836640932127e-06
4960,jobpresident,1,1.8364528545823171e-06,0,0,1,9.472836640932127e-06
4966,massachusettsa,1,1.8364528545823171e-06,0,0,1,9.472836640932127e-06
4973,scored,1,1.8364528545823171e-06,0,0,1,9.472836640932127e-06
4975,wrongpresident,1,1.8364528545823171e-06,0,0,1,9.472836640932127e-06
4983,binder,1,1.8364528545823171e-06,0,0,1,9.472836640932127e-06
4982,applicants,1,1.8364528545823171e-06,0,0,1,9.472836640932127e-06
4987,#romneyexposed,1,1.8364528545823171e-06,0,0,1,9.472836640932127e-06
4988,@politicalwire,1,1.8364528545823171e-06,0,0,1,9.472836640932127e-06
5000,rubio-blunt,1,1.8364528545823171e-06,0,0,1,9.472836640932127e-06
5002,makingpresident,1,1.8364528545823171e-06,0,0,1,9.472836640932127e-06
5003,issuethis,1,1.8364528545823171e-06,0,0,1,9.472836640932127e-06
5004,itwhich,1,1.8364528545823171e-06,0,0,1,9.472836640932127e-06
5008,timespresident,1,1.8364528545823171e-06,0,0,1,9.472836640932127e-06
5010,deficitits,1,1.8364528545823171e-06,0,0,1,9.472836640932127e-06
5017,5-point,1,1.8364528545823171e-06,0,0,1,9.472836640932127e-06
5016,1-point,1,1.8364528545823171e-06,0,0,1,9.472836640932127e-06
5018,jobsgood,1,1.8364528545823171e-06,0,0,1,9.472836640932127e-06
5031,fundraiserclaiming,1,1.8364528545823171e-06,0,0,1,9.472836640932127e-06
5037,debateor,1,1.8364528545823171e-06,0,0,1,9.472836640932127e-06
5038,say-anything,1,1.8364528545823171e-06,0,0,1,9.472836640932127e-06
5045,five-year,1,1.8364528545823171e-06,0,0,1,9.472836640932127e-06
5052,guyhe,1,1.8364528545823171e-06,0,0,1,9.472836640932127e-06
5054,4000000,1,1.8364528545823171e-06,0,0,1,9.472836640932127e-06
5059,sweatshirt,1,1.8364528545823171e-06,0,0,1,9.472836640932127e-06
5060,weatherthis,1,1.8364528545823171e-06,0,0,1,9.472836640932127e-06
5058,clipboard,1,1.8364528545823171e-06,0,0,1,9.472836640932127e-06
5061,arlen,1,1.8364528545823171e-06,0,0,1,9.472836640932127e-06
5062,specter,1,1.8364528545823171e-06,0,0,1,9.472836640932127e-06
5067,todayyour,1,1.8364528545823171e-06,0,0,1,9.472836640932127e-06
5068,americansand,1,1.8364528545823171e-06,0,0,1,9.472836640932127e-06
5072,siding,1,1.8364528545823171e-06,0,0,1,9.472836640932127e-06
5071,classand,1,1.8364528545823171e-06,0,0,1,9.472836640932127e-06
5070,#teamjoeafter,1,1.8364528545823171e-06,0,0,1,9.472836640932127e-06
5081,working-class,1,1.8364528545823171e-06,0,0,1,9.472836640932127e-06
5083,equip,1,1.8364528545823171e-06,0,0,1,9.472836640932127e-06
5091,neighborsthey,1,1.8364528545823171e-06,0,0,1,9.472836640932127e-06
5093,#wrongagainryan,1,1.8364528545823171e-06,0,0,1,9.472836640932127e-06
5095,#readyforjoe,1,1.8364528545823171e-06,0,0,1,9.472836640932127e-06
5096,#ryanschoice,1,1.8364528545823171e-06,0,0,1,9.472836640932127e-06
5099,lesbiansor,1,1.8364528545823171e-06,0,0,1,9.472836640932127e-06
5105,reformaka,1,1.8364528545823171e-06,0,0,1,9.472836640932127e-06
5104,obamacareso,1,1.8364528545823171e-06,0,0,1,9.472836640932127e-06
5102,anymorepresident,1,1.8364528545823171e-06,0,0,1,9.472836640932127e-06
5106,one-third,1,1.8364528545823171e-06,0,0,1,9.472836640932127e-06
5114,futurepresident,1,1.8364528545823171e-06,0,0,1,9.472836640932127e-06
5117,trickle,1,1.8364528545823171e-06,0,0,1,9.472836640932127e-06
5116,topit,1,1.8364528545823171e-06,0,0,1,9.472836640932127e-06
5118,jerking,1,1.8364528545823171e-06,0,0,1,9.472836640932127e-06
5123,o-h,1,1.8364528545823171e-06,0,0,1,9.472836640932127e-06
5122,i-o,1,1.8364528545823171e-06,0,0,1,9.472836640932127e-06
5124,@obama2012follow,1,1.8364528545823171e-06,0,0,1,9.472836640932127e-06
5126,stark,1,1.8364528545823171e-06,0,0,1,9.472836640932127e-06
5129,elderlybut,1,1.8364528545823171e-06,0,0,1,9.472836640932127e-06
5130,formthen,1,1.8364528545823171e-06,0,0,1,9.472836640932127e-06
5138,audition,1,1.8364528545823171e-06,0,0,1,9.472836640932127e-06
5140,amateurish,1,1.8364528545823171e-06,0,0,1,9.472836640932127e-06
5143,fact-checked,1,1.8364528545823171e-06,0,0,1,9.472836640932127e-06
5145,fact-checkers,1,1.8364528545823171e-06,0,0,1,9.472836640932127e-06
5147,@mattforte22,1,1.8364528545823171e-06,0,0,1,9.472836640932127e-06
5146,@jonesdrew32,1,1.8364528545823171e-06,0,0,1,9.472836640932127e-06
5148,@tweez41,1,1.8364528545823171e-06,0,0,1,9.472836640932127e-06
5151,1825813,1,1.8364528545823171e-06,0,0,1,9.472836640932127e-06
5150,181,1,1.8364528545823171e-06,0,0,1,9.472836640932127e-06
5154,worrysomeone,1,1.8364528545823171e-06,0,0,1,9.472836640932127e-06
5153,elmo,1,1.8364528545823171e-06,0,0,1,9.472836640932127e-06
5165,nighthe,1,1.8364528545823171e-06,0,0,1,9.472836640932127e-06
5168,-@messina2012,1,1.8364528545823171e-06,0,0,1,9.472836640932127e-06
5175,technological,1,1.8364528545823171e-06,0,0,1,9.472836640932127e-06
5179,everyonefrom,1,1.8364528545823171e-06,0,0,1,9.472836640932127e-06
5180,outand,1,1.8364528545823171e-06,0,0,1,9.472836640932127e-06
5182,obamassign,1,1.8364528545823171e-06,0,0,1,9.472836640932127e-06
5188,tissue,1,1.8364528545823171e-06,0,0,1,9.472836640932127e-06
5189,easiest,1,1.8364528545823171e-06,0,0,1,9.472836640932127e-06
5191,billion-dollar,1,1.8364528545823171e-06,0,0,1,9.472836640932127e-06
5193,voiceits,1,1.8364528545823171e-06,0,0,1,9.472836640932127e-06
5195,coolest,1,1.8364528545823171e-06,0,0,1,9.472836640932127e-06
5197,2012a,1,1.8364528545823171e-06,0,0,1,9.472836640932127e-06
5200,millionth,1,1.8364528545823171e-06,0,0,1,9.472836640932127e-06
5199,2012only,1,1.8364528545823171e-06,0,0,1,9.472836640932127e-06
5198,1416,1,1.8364528545823171e-06,0,0,1,9.472836640932127e-06
5202,@rufusgifford,1,1.8364528545823171e-06,0,0,1,9.472836640932127e-06
5203,moly,1,1.8364528545823171e-06,0,0,1,9.472836640932127e-06
5208,@iamrashidajones,1,1.8364528545823171e-06,0,0,1,9.472836640932127e-06
5209,@jessetyler,1,1.8364528545823171e-06,0,0,1,9.472836640932127e-06
5211,great-grandchildrensarah,1,1.8364528545823171e-06,0,0,1,9.472836640932127e-06
5212,212451,1,1.8364528545823171e-06,0,0,1,9.472836640932127e-06
5217,tonightand,1,1.8364528545823171e-06,0,0,1,9.472836640932127e-06
5219,1928,1,1.8364528545823171e-06,0,0,1,9.472836640932127e-06
5221,presidentdonate,1,1.8364528545823171e-06,0,0,1,9.472836640932127e-06
5225,constance,1,1.8364528545823171e-06,0,0,1,9.472836640932127e-06
5226,affordablethen,1,1.8364528545823171e-06,0,0,1,9.472836640932127e-06
5227,pushes,1,1.8364528545823171e-06,0,0,1,9.472836640932127e-06
5232,54000,1,1.8364528545823171e-06,0,0,1,9.472836640932127e-06
5235,stay-at-home,1,1.8364528545823171e-06,0,0,1,9.472836640932127e-06
5239,crocodile,1,1.8364528545823171e-06,0,0,1,9.472836640932127e-06
5241,votinglets,1,1.8364528545823171e-06,0,0,1,9.472836640932127e-06
5242,@actuallynph,1,1.8364528545823171e-06,0,0,1,9.472836640932127e-06
5245,donationyour,1,1.8364528545823171e-06,0,0,1,9.472836640932127e-06
5250,otherspresident,1,1.8364528545823171e-06,0,0,1,9.472836640932127e-06
5253,50k,1,1.8364528545823171e-06,0,0,1,9.472836640932127e-06
5258,mei,1,1.8364528545823171e-06,0,0,1,9.472836640932127e-06
5260,deficit-reduction,1,1.8364528545823171e-06,0,0,1,9.472836640932127e-06
5263,bowling,1,1.8364528545823171e-06,0,0,1,9.472836640932127e-06
5267,coops,1,1.8364528545823171e-06,0,0,1,9.472836640932127e-06
5268,boovotepresident,1,1.8364528545823171e-06,0,0,1,9.472836640932127e-06
5270,stupidest,1,1.8364528545823171e-06,0,0,1,9.472836640932127e-06
5273,aisle,1,1.8364528545823171e-06,0,0,1,9.472836640932127e-06
5274,lockout,1,1.8364528545823171e-06,0,0,1,9.472836640932127e-06
5277,er,1,1.8364528545823171e-06,0,0,1,9.472836640932127e-06
5292,nationals-white,1,1.8364528545823171e-06,0,0,1,9.472836640932127e-06
5296,schoolsim,1,1.8364528545823171e-06,0,0,1,9.472836640932127e-06
5297,jobsim,1,1.8364528545823171e-06,0,0,1,9.472836640932127e-06
5298,mebut,1,1.8364528545823171e-06,0,0,1,9.472836640932127e-06
5299,describes,1,1.8364528545823171e-06,0,0,1,9.472836640932127e-06
5301,younot,1,1.8364528545823171e-06,0,0,1,9.472836640932127e-06
5302,82808,1,1.8364528545823171e-06,0,0,1,9.472836640932127e-06
5303,context,1,1.8364528545823171e-06,0,0,1,9.472836640932127e-06
5305,poster,1,1.8364528545823171e-06,0,0,1,9.472836640932127e-06
5306,913000,1,1.8364528545823171e-06,0,0,1,9.472836640932127e-06
5308,arrr,1,1.8364528545823171e-06,0,0,1,9.472836640932127e-06
5309,@lateshow,1,1.8364528545823171e-06,0,0,1,9.472836640932127e-06
5316,react,1,1.8364528545823171e-06,0,0,1,9.472836640932127e-06
5318,dayif,1,1.8364528545823171e-06,0,0,1,9.472836640932127e-06
5319,disdainfully,1,1.8364528545823171e-06,0,0,1,9.472836640932127e-06
5322,lesspresident,1,1.8364528545823171e-06,0,0,1,9.472836640932127e-06
5323,competepresident,1,1.8364528545823171e-06,0,0,1,9.472836640932127e-06
5325,deficitpresident,1,1.8364528545823171e-06,0,0,1,9.472836640932127e-06
5326,lshana,1,1.8364528545823171e-06,0,0,1,9.472836640932127e-06
5328,freechoose,1,1.8364528545823171e-06,0,0,1,9.472836640932127e-06
5331,necessitynot,1,1.8364528545823171e-06,0,0,1,9.472836640932127e-06
5330,luxuryadd,1,1.8364528545823171e-06,0,0,1,9.472836640932127e-06
5332,roadget,1,1.8364528545823171e-06,0,0,1,9.472836640932127e-06
5333,gab,1,1.8364528545823171e-06,0,0,1,9.472836640932127e-06
5335,sweatshirts,1,1.8364528545823171e-06,0,0,1,9.472836640932127e-06
5340,yorkyour,1,1.8364528545823171e-06,0,0,1,9.472836640932127e-06
5343,thempresident,1,1.8364528545823171e-06,0,0,1,9.472836640932127e-06
5349,principlesall,1,1.8364528545823171e-06,0,0,1,9.472836640932127e-06
5348,endowed,1,1.8364528545823171e-06,0,0,1,9.472836640932127e-06
5350,unalienable,1,1.8364528545823171e-06,0,0,1,9.472836640932127e-06
5353,soonand,1,1.8364528545823171e-06,0,0,1,9.472836640932127e-06
5360,hugethank,1,1.8364528545823171e-06,0,0,1,9.472836640932127e-06
5364,one-sixth,1,1.8364528545823171e-06,0,0,1,9.472836640932127e-06
5365,317954,1,1.8364528545823171e-06,0,0,1,9.472836640932127e-06
5366,111,1,1.8364528545823171e-06,0,0,1,9.472836640932127e-06
5371,outraised,1,1.8364528545823171e-06,0,0,1,9.472836640932127e-06
5370,augustthe,1,1.8364528545823171e-06,0,0,1,9.472836640932127e-06
5373,med,1,1.8364528545823171e-06,0,0,1,9.472836640932127e-06
5377,hug@jrpsaki,1,1.8364528545823171e-06,0,0,1,9.472836640932127e-06
5380,swoop,1,1.8364528545823171e-06,0,0,1,9.472836640932127e-06
5385,fab,1,1.8364528545823171e-06,0,0,1,9.472836640932127e-06
5386,sneaking,1,1.8364528545823171e-06,0,0,1,9.472836640932127e-06
5387,usits,1,1.8364528545823171e-06,0,0,1,9.472836640932127e-06
5390,beholden,1,1.8364528545823171e-06,0,0,1,9.472836640932127e-06
5391,bidder,1,1.8364528545823171e-06,0,0,1,9.472836640932127e-06
5395,citizensyou,1,1.8364528545823171e-06,0,0,1,9.472836640932127e-06
5394,changepresident,1,1.8364528545823171e-06,0,0,1,9.472836640932127e-06
5397,workpresident,1,1.8364528545823171e-06,0,0,1,9.472836640932127e-06
5398,moneypresident,1,1.8364528545823171e-06,0,0,1,9.472836640932127e-06
5399,heating,1,1.8364528545823171e-06,0,0,1,9.472836640932127e-06
5400,planetbecause,1,1.8364528545823171e-06,0,0,1,9.472836640932127e-06
5401,businessespresident,1,1.8364528545823171e-06,0,0,1,9.472836640932127e-06
5408,mea,1,1.8364528545823171e-06,0,0,1,9.472836640932127e-06
5411,classwe,1,1.8364528545823171e-06,0,0,1,9.472836640932127e-06
5414,non-violent,1,1.8364528545823171e-06,0,0,1,9.472836640932127e-06
5415,union@repjohnlewis,1,1.8364528545823171e-06,0,0,1,9.472836640932127e-06
5416,#thanks,1,1.8364528545823171e-06,0,0,1,9.472836640932127e-06
5419,#obama2012show,1,1.8364528545823171e-06,0,0,1,9.472836640932127e-06
5426,two-term,1,1.8364528545823171e-06,0,0,1,9.472836640932127e-06
5425,presidentpitch,1,1.8364528545823171e-06,0,0,1,9.472836640932127e-06
5427,actioncommit,1,1.8364528545823171e-06,0,0,1,9.472836640932127e-06
5429,obamapresident,1,1.8364528545823171e-06,0,0,1,9.472836640932127e-06
5430,trickle-downpresident,1,1.8364528545823171e-06,0,0,1,9.472836640932127e-06
5431,requirement,1,1.8364528545823171e-06,0,0,1,9.472836640932127e-06
5434,refunds,1,1.8364528545823171e-06,0,0,1,9.472836640932127e-06
5436,statespresident,1,1.8364528545823171e-06,0,0,1,9.472836640932127e-06
5437,ledbetters,1,1.8364528545823171e-06,0,0,1,9.472836640932127e-06
5447,michelles,1,1.8364528545823171e-06,0,0,1,9.472836640932127e-06
5449,worldfirst,1,1.8364528545823171e-06,0,0,1,9.472836640932127e-06
5450,deval,1,1.8364528545823171e-06,0,0,1,9.472836640932127e-06
5454,#committovote,1,1.8364528545823171e-06,0,0,1,9.472836640932127e-06
5463,@juliancastro,1,1.8364528545823171e-06,0,0,1,9.472836640932127e-06
5467,superman,1,1.8364528545823171e-06,0,0,1,9.472836640932127e-06
5468,freeits,1,1.8364528545823171e-06,0,0,1,9.472836640932127e-06
5469,truei,1,1.8364528545823171e-06,0,0,1,9.472836640932127e-06
5473,rabbit,1,1.8364528545823171e-06,0,0,1,9.472836640932127e-06
5477,3152919,1,1.8364528545823171e-06,0,0,1,9.472836640932127e-06
5480,familythen,1,1.8364528545823171e-06,0,0,1,9.472836640932127e-06
5482,homegrown,1,1.8364528545823171e-06,0,0,1,9.472836640932127e-06
5483,uspresident,1,1.8364528545823171e-06,0,0,1,9.472836640932127e-06
5485,whenpresident,1,1.8364528545823171e-06,0,0,1,9.472836640932127e-06
5487,youre-on-your-own,1,1.8364528545823171e-06,0,0,1,9.472836640932127e-06
5488,ideajust,1,1.8364528545823171e-06,0,0,1,9.472836640932127e-06
5489,retreads,1,1.8364528545823171e-06,0,0,1,9.472836640932127e-06
5498,etch-a-sketch,1,1.8364528545823171e-06,0,0,1,9.472836640932127e-06
5499,shaken,1,1.8364528545823171e-06,0,0,1,9.472836640932127e-06
5500,must-read,1,1.8364528545823171e-06,0,0,1,9.472836640932127e-06
5504,@students4obama,1,1.8364528545823171e-06,0,0,1,9.472836640932127e-06
5506,q&a,1,1.8364528545823171e-06,0,0,1,9.472836640932127e-06
5507,#reddit,1,1.8364528545823171e-06,0,0,1,9.472836640932127e-06
5508,ama,1,1.8364528545823171e-06,0,0,1,9.472836640932127e-06
5510,luxurythe,1,1.8364528545823171e-06,0,0,1,9.472836640932127e-06
5512,not-quite-last-place,1,1.8364528545823171e-06,0,0,1,9.472836640932127e-06
5515,mpg,1,1.8364528545823171e-06,0,0,1,9.472836640932127e-06
5518,certificateget,1,1.8364528545823171e-06,0,0,1,9.472836640932127e-06
5519,affordableand,1,1.8364528545823171e-06,0,0,1,9.472836640932127e-06
5520,armstrong,1,1.8364528545823171e-06,0,0,1,9.472836640932127e-06
5525,mugswith,1,1.8364528545823171e-06,0,0,1,9.472836640932127e-06
5528,enlist,1,1.8364528545823171e-06,0,0,1,9.472836640932127e-06
5527,birther,1,1.8364528545823171e-06,0,0,1,9.472836640932127e-06
5531,academic,1,1.8364528545823171e-06,0,0,1,9.472836640932127e-06
5532,mandates,1,1.8364528545823171e-06,0,0,1,9.472836640932127e-06
5538,educatorspreventing,1,1.8364528545823171e-06,0,0,1,9.472836640932127e-06
5537,couldve,1,1.8364528545823171e-06,0,0,1,9.472836640932127e-06
5540,six-year-olds,1,1.8364528545823171e-06,0,0,1,9.472836640932127e-06
5541,audiences,1,1.8364528545823171e-06,0,0,1,9.472836640932127e-06
5543,teacherspresident,1,1.8364528545823171e-06,0,0,1,9.472836640932127e-06
5544,classroompresident,1,1.8364528545823171e-06,0,0,1,9.472836640932127e-06
5545,childrenpresident,1,1.8364528545823171e-06,0,0,1,9.472836640932127e-06
5546,presidentthe,1,1.8364528545823171e-06,0,0,1,9.472836640932127e-06
5550,inpresident,1,1.8364528545823171e-06,0,0,1,9.472836640932127e-06
5551,obamathe,1,1.8364528545823171e-06,0,0,1,9.472836640932127e-06
5552,trusts,1,1.8364528545823171e-06,0,0,1,9.472836640932127e-06
5555,sonspres,1,1.8364528545823171e-06,0,0,1,9.472836640932127e-06
5558,akins,1,1.8364528545823171e-06,0,0,1,9.472836640932127e-06
5564,knots,1,1.8364528545823171e-06,0,0,1,9.472836640932127e-06
5563,contradictory,1,1.8364528545823171e-06,0,0,1,9.472836640932127e-06
5568,teachersand,1,1.8364528545823171e-06,0,0,1,9.472836640932127e-06
5570,romney-ryans,1,1.8364528545823171e-06,0,0,1,9.472836640932127e-06
5569,breaksand,1,1.8364528545823171e-06,0,0,1,9.472836640932127e-06
5574,gottavote․org,1,1.8364528545823171e-06,0,0,1,9.472836640932127e-06
5577,familiesand,1,1.8364528545823171e-06,0,0,1,9.472836640932127e-06
5579,circa,1,1.8364528545823171e-06,0,0,1,9.472836640932127e-06
5581,gut,1,1.8364528545823171e-06,0,0,1,9.472836640932127e-06
5583,retirees,1,1.8364528545823171e-06,0,0,1,9.472836640932127e-06
5584,checkpresident,1,1.8364528545823171e-06,0,0,1,9.472836640932127e-06
5586,wellpresident,1,1.8364528545823171e-06,0,0,1,9.472836640932127e-06
5588,fads,1,1.8364528545823171e-06,0,0,1,9.472836640932127e-06
5589,defines,1,1.8364528545823171e-06,0,0,1,9.472836640932127e-06
5590,eloquent,1,1.8364528545823171e-06,0,0,1,9.472836640932127e-06
5596,voteyou,1,1.8364528545823171e-06,0,0,1,9.472836640932127e-06
5597,iowas,1,1.8364528545823171e-06,0,0,1,9.472836640932127e-06
5599,renewablepresident,1,1.8364528545823171e-06,0,0,1,9.472836640932127e-06
5601,cones,1,1.8364528545823171e-06,0,0,1,9.472836640932127e-06
5602,denison,1,1.8364528545823171e-06,0,0,1,9.472836640932127e-06
5604,tab,1,1.8364528545823171e-06,0,0,1,9.472836640932127e-06
5603,familiessee,1,1.8364528545823171e-06,0,0,1,9.472836640932127e-06
5606,welfare-to-work,1,1.8364528545823171e-06,0,0,1,9.472836640932127e-06
5605,placement,1,1.8364528545823171e-06,0,0,1,9.472836640932127e-06
5609,politifact,1,1.8364528545823171e-06,0,0,1,9.472836640932127e-06
5608,pants,1,1.8364528545823171e-06,0,0,1,9.472836640932127e-06
5610,cutand,1,1.8364528545823171e-06,0,0,1,9.472836640932127e-06
5614,conservativeat,1,1.8364528545823171e-06,0,0,1,9.472836640932127e-06
5617,architect,1,1.8364528545823171e-06,0,0,1,9.472836640932127e-06
5621,muscle,1,1.8364528545823171e-06,0,0,1,9.472836640932127e-06
5622,seasonthis,1,1.8364528545823171e-06,0,0,1,9.472836640932127e-06
5624,voteobama,1,1.8364528545823171e-06,0,0,1,9.472836640932127e-06
5625,rock-n-roll,1,1.8364528545823171e-06,0,0,1,9.472836640932127e-06
5626,choicehes,1,1.8364528545823171e-06,0,0,1,9.472836640932127e-06
5629,shootaround,1,1.8364528545823171e-06,0,0,1,9.472836640932127e-06
5630,familytheir,1,1.8364528545823171e-06,0,0,1,9.472836640932127e-06
5631,fairy,1,1.8364528545823171e-06,0,0,1,9.472836640932127e-06
5634,issuestheyre,1,1.8364528545823171e-06,0,0,1,9.472836640932127e-06
5636,carepresident,1,1.8364528545823171e-06,0,0,1,9.472836640932127e-06
5638,textbooks,1,1.8364528545823171e-06,0,0,1,9.472836640932127e-06
5639,mammogram,1,1.8364528545823171e-06,0,0,1,9.472836640932127e-06
5640,planspresident,1,1.8364528545823171e-06,0,0,1,9.472836640932127e-06
5641,companiestheyre,1,1.8364528545823171e-06,0,0,1,9.472836640932127e-06
5643,@elizabethbanks,1,1.8364528545823171e-06,0,0,1,9.472836640932127e-06
5652,outraisedbut,1,1.8364528545823171e-06,0,0,1,9.472836640932127e-06
5656,eagerly,1,1.8364528545823171e-06,0,0,1,9.472836640932127e-06
5654,curiosity,1,1.8364528545823171e-06,0,0,1,9.472836640932127e-06
5655,discoverpresident,1,1.8364528545823171e-06,0,0,1,9.472836640932127e-06
5658,rover,1,1.8364528545823171e-06,0,0,1,9.472836640932127e-06
5659,realitypresident,1,1.8364528545823171e-06,0,0,1,9.472836640932127e-06
5661,heroesusa,1,1.8364528545823171e-06,0,0,1,9.472836640932127e-06
5664,tees,1,1.8364528545823171e-06,0,0,1,9.472836640932127e-06
5663,featuring,1,1.8364528545823171e-06,0,0,1,9.472836640932127e-06
5666,birthdayget,1,1.8364528545823171e-06,0,0,1,9.472836640932127e-06
5667,paralympic,1,1.8364528545823171e-06,0,0,1,9.472836640932127e-06
5668,fallsee,1,1.8364528545823171e-06,0,0,1,9.472836640932127e-06
5670,billie,1,1.8364528545823171e-06,0,0,1,9.472836640932127e-06
5672,jean,1,1.8364528545823171e-06,0,0,1,9.472836640932127e-06
5675,daytake,1,1.8364528545823171e-06,0,0,1,9.472836640932127e-06
5676,birthdaymade,1,1.8364528545823171e-06,0,0,1,9.472836640932127e-06
5678,fives,1,1.8364528545823171e-06,0,0,1,9.472836640932127e-06
5680,tomorrowdont,1,1.8364528545823171e-06,0,0,1,9.472836640932127e-06
5681,sharingmake,1,1.8364528545823171e-06,0,0,1,9.472836640932127e-06
5685,americanssaving,1,1.8364528545823171e-06,0,0,1,9.472836640932127e-06
5686,novemberpresident,1,1.8364528545823171e-06,0,0,1,9.472836640932127e-06
5688,grayer,1,1.8364528545823171e-06,0,0,1,9.472836640932127e-06
5692,phelps,1,1.8364528545823171e-06,0,0,1,9.472836640932127e-06
5693,swim,1,1.8364528545823171e-06,0,0,1,9.472836640932127e-06
5694,weekhere,1,1.8364528545823171e-06,0,0,1,9.472836640932127e-06
5696,barns,1,1.8364528545823171e-06,0,0,1,9.472836640932127e-06
5697,436,1,1.8364528545823171e-06,0,0,1,9.472836640932127e-06
5700,organizerthen,1,1.8364528545823171e-06,0,0,1,9.472836640932127e-06
5702,weekwish,1,1.8364528545823171e-06,0,0,1,9.472836640932127e-06
5701,51st,1,1.8364528545823171e-06,0,0,1,9.472836640932127e-06
5707,years@ofaoh,1,1.8364528545823171e-06,0,0,1,9.472836640932127e-06
5705,@curtiswourmsofa,1,1.8364528545823171e-06,0,0,1,9.472836640932127e-06
5712,up…,1,1.8364528545823171e-06,0,0,1,9.472836640932127e-06
5715,start-up,1,1.8364528545823171e-06,0,0,1,9.472836640932127e-06
5713,deduct,1,1.8364528545823171e-06,0,0,1,9.472836640932127e-06
5716,jumpstart,1,1.8364528545823171e-06,0,0,1,9.472836640932127e-06
5720,ina,1,1.8364528545823171e-06,0,0,1,9.472836640932127e-06
5722,generationpresident,1,1.8364528545823171e-06,0,0,1,9.472836640932127e-06
5721,@naturbanleague,1,1.8364528545823171e-06,0,0,1,9.472836640932127e-06
5724,629,1,1.8364528545823171e-06,0,0,1,9.472836640932127e-06
5729,notebook,1,1.8364528545823171e-06,0,0,1,9.472836640932127e-06
5728,laptopget,1,1.8364528545823171e-06,0,0,1,9.472836640932127e-06
5731,ratessaving,1,1.8364528545823171e-06,0,0,1,9.472836640932127e-06
5733,adstaking,1,1.8364528545823171e-06,0,0,1,9.472836640932127e-06
5734,contexttheyre,1,1.8364528545823171e-06,0,0,1,9.472836640932127e-06
5736,costco,1,1.8364528545823171e-06,0,0,1,9.472836640932127e-06
5737,sinegal,1,1.8364528545823171e-06,0,0,1,9.472836640932127e-06
5744,@ashleyjudd,1,1.8364528545823171e-06,0,0,1,9.472836640932127e-06
5745,@ofanc,1,1.8364528545823171e-06,0,0,1,9.472836640932127e-06
5748,advocates,1,1.8364528545823171e-06,0,0,1,9.472836640932127e-06
5751,starspresident,1,1.8364528545823171e-06,0,0,1,9.472836640932127e-06
5752,lending,1,1.8364528545823171e-06,0,0,1,9.472836640932127e-06
5753,generationstronger,1,1.8364528545823171e-06,0,0,1,9.472836640932127e-06
5760,yourt,1,1.8364528545823171e-06,0,0,1,9.472836640932127e-06
5767,departure,1,1.8364528545823171e-06,0,0,1,9.472836640932127e-06
5770,taxespotus,1,1.8364528545823171e-06,0,0,1,9.472836640932127e-06
5771,outpresident,1,1.8364528545823171e-06,0,0,1,9.472836640932127e-06
5774,entity,1,1.8364528545823171e-06,0,0,1,9.472836640932127e-06
5780,explanations,1,1.8364528545823171e-06,0,0,1,9.472836640932127e-06
5782,static,1,1.8364528545823171e-06,0,0,1,9.472836640932127e-06
5784,topsally,1,1.8364528545823171e-06,0,0,1,9.472836640932127e-06
5785,meaningfulcynthia,1,1.8364528545823171e-06,0,0,1,9.472836640932127e-06
5787,displace,1,1.8364528545823171e-06,0,0,1,9.472836640932127e-06
5786,800k,1,1.8364528545823171e-06,0,0,1,9.472836640932127e-06
5793,firstpresident,1,1.8364528545823171e-06,0,0,1,9.472836640932127e-06
5797,scout,1,1.8364528545823171e-06,0,0,1,9.472836640932127e-06
5796,mint,1,1.8364528545823171e-06,0,0,1,9.472836640932127e-06
5802,virginians,1,1.8364528545823171e-06,0,0,1,9.472836640932127e-06
5806,magnetits,1,1.8364528545823171e-06,0,0,1,9.472836640932127e-06
5809,okrent,1,1.8364528545823171e-06,0,0,1,9.472836640932127e-06
5816,familiesrt,1,1.8364528545823171e-06,0,0,1,9.472836640932127e-06
5821,doers,1,1.8364528545823171e-06,0,0,1,9.472836640932127e-06
5822,bipartisanship,1,1.8364528545823171e-06,0,0,1,9.472836640932127e-06
5823,americansfolks,1,1.8364528545823171e-06,0,0,1,9.472836640932127e-06
5824,myselfto,1,1.8364528545823171e-06,0,0,1,9.472836640932127e-06
5827,pirates,1,1.8364528545823171e-06,0,0,1,9.472836640932127e-06
5831,beforepresident,1,1.8364528545823171e-06,0,0,1,9.472836640932127e-06
5832,partiesits,1,1.8364528545823171e-06,0,0,1,9.472836640932127e-06
5833,door-to-door,1,1.8364528545823171e-06,0,0,1,9.472836640932127e-06
5835,kinkos,1,1.8364528545823171e-06,0,0,1,9.472836640932127e-06
5839,rightwhen,1,1.8364528545823171e-06,0,0,1,9.472836640932127e-06
5838,daythey,1,1.8364528545823171e-06,0,0,1,9.472836640932127e-06
5840,schoolspresident,1,1.8364528545823171e-06,0,0,1,9.472836640932127e-06
5845,bankruptpresident,1,1.8364528545823171e-06,0,0,1,9.472836640932127e-06
5847,accountvp,1,1.8364528545823171e-06,0,0,1,9.472836640932127e-06
5853,double-digit,1,1.8364528545823171e-06,0,0,1,9.472836640932127e-06
5855,griffith,1,1.8364528545823171e-06,0,0,1,9.472836640932127e-06
5856,425,1,1.8364528545823171e-06,0,0,1,9.472836640932127e-06
5857,incomemuch,1,1.8364528545823171e-06,0,0,1,9.472836640932127e-06
5861,familiesthen,1,1.8364528545823171e-06,0,0,1,9.472836640932127e-06
5865,skeptic,1,1.8364528545823171e-06,0,0,1,9.472836640932127e-06
5866,changeup,1,1.8364528545823171e-06,0,0,1,9.472836640932127e-06
5867,#dontdoublemyrateand,1,1.8364528545823171e-06,0,0,1,9.472836640932127e-06
5869,colonoscopies,1,1.8364528545823171e-06,0,0,1,9.472836640932127e-06
5872,livesnicholas,1,1.8364528545823171e-06,0,0,1,9.472836640932127e-06
5875,alivejust,1,1.8364528545823171e-06,0,0,1,9.472836640932127e-06
5877,old-school,1,1.8364528545823171e-06,0,0,1,9.472836640932127e-06
5878,outspent,1,1.8364528545823171e-06,0,0,1,9.472836640932127e-06
5879,cue,1,1.8364528545823171e-06,0,0,1,9.472836640932127e-06
5882,diploma,1,1.8364528545823171e-06,0,0,1,9.472836640932127e-06
5881,1915,1,1.8364528545823171e-06,0,0,1,9.472836640932127e-06
5886,youfighting,1,1.8364528545823171e-06,0,0,1,9.472836640932127e-06
5885,howfor,1,1.8364528545823171e-06,0,0,1,9.472836640932127e-06
5888,denver-based,1,1.8364528545823171e-06,0,0,1,9.472836640932127e-06
5892,recap,1,1.8364528545823171e-06,0,0,1,9.472836640932127e-06
5895,studentsand,1,1.8364528545823171e-06,0,0,1,9.472836640932127e-06
5896,affordableheres,1,1.8364528545823171e-06,0,0,1,9.472836640932127e-06
5897,ix,1,1.8364528545823171e-06,0,0,1,9.472836640932127e-06
5898,@michelleobamaairfares,1,1.8364528545823171e-06,0,0,1,9.472836640932127e-06
5902,160000month,1,1.8364528545823171e-06,0,0,1,9.472836640932127e-06
5904,discretionary,1,1.8364528545823171e-06,0,0,1,9.472836640932127e-06
5907,uplets,1,1.8364528545823171e-06,0,0,1,9.472836640932127e-06
5908,necessitypresident,1,1.8364528545823171e-06,0,0,1,9.472836640932127e-06
5911,mas,1,1.8364528545823171e-06,0,0,1,9.472836640932127e-06
5912,hikeor,1,1.8364528545823171e-06,0,0,1,9.472836640932127e-06
5913,expel,1,1.8364528545823171e-06,0,0,1,9.472836640932127e-06
5914,intents,1,1.8364528545823171e-06,0,0,1,9.472836640932127e-06
5918,sashas,1,1.8364528545823171e-06,0,0,1,9.472836640932127e-06
5925,neighborsthats,1,1.8364528545823171e-06,0,0,1,9.472836640932127e-06
5926,expels,1,1.8364528545823171e-06,0,0,1,9.472836640932127e-06
5929,shoes,1,1.8364528545823171e-06,0,0,1,9.472836640932127e-06
5930,presidentjoin,1,1.8364528545823171e-06,0,0,1,9.472836640932127e-06
5931,infrastructurepresident,1,1.8364528545823171e-06,0,0,1,9.472836640932127e-06
5935,@saramvalentine,1,1.8364528545823171e-06,0,0,1,9.472836640932127e-06
5939,-axe,1,1.8364528545823171e-06,0,0,1,9.472836640932127e-06
5940,nationpresident,1,1.8364528545823171e-06,0,0,1,9.472836640932127e-06
5941,jeopardize,1,1.8364528545823171e-06,0,0,1,9.472836640932127e-06
5942,pastpresident,1,1.8364528545823171e-06,0,0,1,9.472836640932127e-06
5944,stalematepresident,1,1.8364528545823171e-06,0,0,1,9.472836640932127e-06
5949,economythen,1,1.8364528545823171e-06,0,0,1,9.472836640932127e-06
5951,juniors,1,1.8364528545823171e-06,0,0,1,9.472836640932127e-06
5952,thembarbara,1,1.8364528545823171e-06,0,0,1,9.472836640932127e-06
5953,-david,1,1.8364528545823171e-06,0,0,1,9.472836640932127e-06
5957,exhibit,1,1.8364528545823171e-06,0,0,1,9.472836640932127e-06
5955,ancient,1,1.8364528545823171e-06,0,0,1,9.472836640932127e-06
5956,artifacts,1,1.8364528545823171e-06,0,0,1,9.472836640932127e-06
5958,scrolls,1,1.8364528545823171e-06,0,0,1,9.472836640932127e-06
5960,iva,1,1.8364528545823171e-06,0,0,1,9.472836640932127e-06
5964,rsvp,1,1.8364528545823171e-06,0,0,1,9.472836640932127e-06
5965,clocks,1,1.8364528545823171e-06,0,0,1,9.472836640932127e-06
5967,officersand,1,1.8364528545823171e-06,0,0,1,9.472836640932127e-06
5968,jobstell,1,1.8364528545823171e-06,0,0,1,9.472836640932127e-06
5969,-eva,1,1.8364528545823171e-06,0,0,1,9.472836640932127e-06
5971,-zach,1,1.8364528545823171e-06,0,0,1,9.472836640932127e-06
5972,faceparticularly,1,1.8364528545823171e-06,0,0,1,9.472836640932127e-06
5973,responder,1,1.8364528545823171e-06,0,0,1,9.472836640932127e-06
5979,stretchand,1,1.8364528545823171e-06,0,0,1,9.472836640932127e-06
5981,copies,1,1.8364528545823171e-06,0,0,1,9.472836640932127e-06
5980,@davidaxelrod,1,1.8364528545823171e-06,0,0,1,9.472836640932127e-06
5986,@benlabolt,1,1.8364528545823171e-06,0,0,1,9.472836640932127e-06
5988,comesay,1,1.8364528545823171e-06,0,0,1,9.472836640932127e-06
5990,@ofaca,1,1.8364528545823171e-06,0,0,1,9.472836640932127e-06
5992,loanspresident,1,1.8364528545823171e-06,0,0,1,9.472836640932127e-06
5993,shouldering,1,1.8364528545823171e-06,0,0,1,9.472836640932127e-06
5995,predictor,1,1.8364528545823171e-06,0,0,1,9.472836640932127e-06
5996,successby,1,1.8364528545823171e-06,0,0,1,9.472836640932127e-06
5994,faris,1,1.8364528545823171e-06,0,0,1,9.472836640932127e-06
5998,vehiclesregaining,1,1.8364528545823171e-06,0,0,1,9.472836640932127e-06
5997,automaker,1,1.8364528545823171e-06,0,0,1,9.472836640932127e-06
6005,todayd-daythe,1,1.8364528545823171e-06,0,0,1,9.472836640932127e-06
6007,retooled,1,1.8364528545823171e-06,0,0,1,9.472836640932127e-06
6006,230000,1,1.8364528545823171e-06,0,0,1,9.472836640932127e-06
6008,metime,1,1.8364528545823171e-06,0,0,1,9.472836640932127e-06
6009,monthand,1,1.8364528545823171e-06,0,0,1,9.472836640932127e-06
6010,#equalpayand,1,1.8364528545823171e-06,0,0,1,9.472836640932127e-06
6011,431000,1,1.8364528545823171e-06,0,0,1,9.472836640932127e-06
6019,economicsit,1,1.8364528545823171e-06,0,0,1,9.472836640932127e-06
6021,fifth-grader,1,1.8364528545823171e-06,0,0,1,9.472836640932127e-06
6027,36bringing,1,1.8364528545823171e-06,0,0,1,9.472836640932127e-06
6029,governorand,1,1.8364528545823171e-06,0,0,1,9.472836640932127e-06
6030,shadowy,1,1.8364528545823171e-06,0,0,1,9.472836640932127e-06
6032,489000,1,1.8364528545823171e-06,0,0,1,9.472836640932127e-06
6031,2010gaining,1,1.8364528545823171e-06,0,0,1,9.472836640932127e-06
6034,luzs,1,1.8364528545823171e-06,0,0,1,9.472836640932127e-06
6033,drawings,1,1.8364528545823171e-06,0,0,1,9.472836640932127e-06
6035,airfares,1,1.8364528545823171e-06,0,0,1,9.472836640932127e-06
6036,repay,1,1.8364528545823171e-06,0,0,1,9.472836640932127e-06
6045,malena,1,1.8364528545823171e-06,0,0,1,9.472836640932127e-06
6042,8-230,1,1.8364528545823171e-06,0,0,1,9.472836640932127e-06
6043,graders,1,1.8364528545823171e-06,0,0,1,9.472836640932127e-06
6049,rebecca,1,1.8364528545823171e-06,0,0,1,9.472836640932127e-06
6048,oversized,1,1.8364528545823171e-06,0,0,1,9.472836640932127e-06
6052,@marketwatch,1,1.8364528545823171e-06,0,0,1,9.472836640932127e-06
6053,educator,1,1.8364528545823171e-06,0,0,1,9.472836640932127e-06
6055,administrationmore,1,1.8364528545823171e-06,0,0,1,9.472836640932127e-06
6060,pridenarrated,1,1.8364528545823171e-06,0,0,1,9.472836640932127e-06
6059,@janemarielynch,1,1.8364528545823171e-06,0,0,1,9.472836640932127e-06
6064,vibes,1,1.8364528545823171e-06,0,0,1,9.472836640932127e-06
6065,aboutharvey,1,1.8364528545823171e-06,0,0,1,9.472836640932127e-06
6068,countsmake,1,1.8364528545823171e-06,0,0,1,9.472836640932127e-06
6069,youjust,1,1.8364528545823171e-06,0,0,1,9.472836640932127e-06
6071,respondwith,1,1.8364528545823171e-06,0,0,1,9.472836640932127e-06
6072,president…,1,1.8364528545823171e-06,0,0,1,9.472836640932127e-06
6073,equity,1,1.8364528545823171e-06,0,0,1,9.472836640932127e-06
6074,maximize,1,1.8364528545823171e-06,0,0,1,9.472836640932127e-06
6081,1992,1,1.8364528545823171e-06,0,0,1,9.472836640932127e-06
6088,marion,1,1.8364528545823171e-06,0,0,1,9.472836640932127e-06
6091,puppeteers,1,1.8364528545823171e-06,0,0,1,9.472836640932127e-06
6090,capita,1,1.8364528545823171e-06,0,0,1,9.472836640932127e-06
6094,workout,1,1.8364528545823171e-06,0,0,1,9.472836640932127e-06
6092,get-moving,1,1.8364528545823171e-06,0,0,1,9.472836640932127e-06
6099,parkers,1,1.8364528545823171e-06,0,0,1,9.472836640932127e-06
6098,nycairfare,1,1.8364528545823171e-06,0,0,1,9.472836640932127e-06
6103,merged,1,1.8364528545823171e-06,0,0,1,9.472836640932127e-06
6101,clothing,1,1.8364528545823171e-06,0,0,1,9.472836640932127e-06
6106,daysend,1,1.8364528545823171e-06,0,0,1,9.472836640932127e-06
6107,fares,1,1.8364528545823171e-06,0,0,1,9.472836640932127e-06
6108,quizzed,1,1.8364528545823171e-06,0,0,1,9.472836640932127e-06
6109,superhero,1,1.8364528545823171e-06,0,0,1,9.472836640932127e-06
6110,54-page,1,1.8364528545823171e-06,0,0,1,9.472836640932127e-06
6113,strategists,1,1.8364528545823171e-06,0,0,1,9.472836640932127e-06
6111,hussein,1,1.8364528545823171e-06,0,0,1,9.472836640932127e-06
6114,deficitand,1,1.8364528545823171e-06,0,0,1,9.472836640932127e-06
6117,modified,1,1.8364528545823171e-06,0,0,1,9.472836640932127e-06
6119,office…,1,1.8364528545823171e-06,0,0,1,9.472836640932127e-06
6120,upsetting,1,1.8364528545823171e-06,0,0,1,9.472836640932127e-06
6122,dade,1,1.8364528545823171e-06,0,0,1,9.472836640932127e-06
6121,behring,1,1.8364528545823171e-06,0,0,1,9.472836640932127e-06
6124,ask…,1,1.8364528545823171e-06,0,0,1,9.472836640932127e-06
6125,#romneyeconomicsand,1,1.8364528545823171e-06,0,0,1,9.472836640932127e-06
6129,bankrupted,1,1.8364528545823171e-06,0,0,1,9.472836640932127e-06
6130,gst,1,1.8364528545823171e-06,0,0,1,9.472836640932127e-06
6132,century-old,1,1.8364528545823171e-06,0,0,1,9.472836640932127e-06
6133,debtforcing,1,1.8364528545823171e-06,0,0,1,9.472836640932127e-06
6135,105-year-old,1,1.8364528545823171e-06,0,0,1,9.472836640932127e-06
6136,crippled,1,1.8364528545823171e-06,0,0,1,9.472836640932127e-06
6139,simple…,1,1.8364528545823171e-06,0,0,1,9.472836640932127e-06
6140,worthwhile,1,1.8364528545823171e-06,0,0,1,9.472836640932127e-06
6137,easypresident,1,1.8364528545823171e-06,0,0,1,9.472836640932127e-06
6142,barnard,1,1.8364528545823171e-06,0,0,1,9.472836640932127e-06
6145,steelworker,1,1.8364528545823171e-06,0,0,1,9.472836640932127e-06
6143,familyuntil,1,1.8364528545823171e-06,0,0,1,9.472836640932127e-06
6151,refinancingpresident,1,1.8364528545823171e-06,0,0,1,9.472836640932127e-06
6152,encouragement,1,1.8364528545823171e-06,0,0,1,9.472836640932127e-06
6154,obamasubject,1,1.8364528545823171e-06,0,0,1,9.472836640932127e-06
6156,1president,1,1.8364528545823171e-06,0,0,1,9.472836640932127e-06
6157,ratesrt,1,1.8364528545823171e-06,0,0,1,9.472836640932127e-06
6158,is…a,1,1.8364528545823171e-06,0,0,1,9.472836640932127e-06
6159,senatormake,1,1.8364528545823171e-06,0,0,1,9.472836640932127e-06
6161,ratestell,1,1.8364528545823171e-06,0,0,1,9.472836640932127e-06
6163,runningbecause,1,1.8364528545823171e-06,0,0,1,9.472836640932127e-06
6165,dayget,1,1.8364528545823171e-06,0,0,1,9.472836640932127e-06
6171,backpresident,1,1.8364528545823171e-06,0,0,1,9.472836640932127e-06
6172,tuck,1,1.8364528545823171e-06,0,0,1,9.472836640932127e-06
6173,togetherfirst,1,1.8364528545823171e-06,0,0,1,9.472836640932127e-06
6175,ohiotune,1,1.8364528545823171e-06,0,0,1,9.472836640932127e-06
6174,1245pm,1,1.8364528545823171e-06,0,0,1,9.472836640932127e-06
6176,electionbut,1,1.8364528545823171e-06,0,0,1,9.472836640932127e-06
6178,sidewalk,1,1.8364528545823171e-06,0,0,1,9.472836640932127e-06
6181,wildcats,1,1.8364528545823171e-06,0,0,1,9.472836640932127e-06
6182,settling,1,1.8364528545823171e-06,0,0,1,9.472836640932127e-06
6183,rowing,1,1.8364528545823171e-06,0,0,1,9.472836640932127e-06
6184,decorating,1,1.8364528545823171e-06,0,0,1,9.472836640932127e-06
6186,stickerjust,1,1.8364528545823171e-06,0,0,1,9.472836640932127e-06
6187,julia,1,1.8364528545823171e-06,0,0,1,9.472836640932127e-06
6188,banka,1,1.8364528545823171e-06,0,0,1,9.472836640932127e-06
6189,one-stop,1,1.8364528545823171e-06,0,0,1,9.472836640932127e-06
6193,islander,1,1.8364528545823171e-06,0,0,1,9.472836640932127e-06
6194,monththe,1,1.8364528545823171e-06,0,0,1,9.472836640932127e-06
6191,#aapi2012,1,1.8364528545823171e-06,0,0,1,9.472836640932127e-06
6197,clooneystoday,1,1.8364528545823171e-06,0,0,1,9.472836640932127e-06
6206,¡obama,1,1.8364528545823171e-06,0,0,1,9.472836640932127e-06
6207,coverednow,1,1.8364528545823171e-06,0,0,1,9.472836640932127e-06
6211,backnow,1,1.8364528545823171e-06,0,0,1,9.472836640932127e-06
6212,authorize,1,1.8364528545823171e-06,0,0,1,9.472836640932127e-06
6214,capped,1,1.8364528545823171e-06,0,0,1,9.472836640932127e-06
6215,incomehelping,1,1.8364528545823171e-06,0,0,1,9.472836640932127e-06
6218,pathformer,1,1.8364528545823171e-06,0,0,1,9.472836640932127e-06
6223,houseits,1,1.8364528545823171e-06,0,0,1,9.472836640932127e-06
6224,once-in-a-lifetime,1,1.8364528545823171e-06,0,0,1,9.472836640932127e-06
6228,presidenttell,1,1.8364528545823171e-06,0,0,1,9.472836640932127e-06
6230,shaking,1,1.8364528545823171e-06,0,0,1,9.472836640932127e-06
6232,lowyet,1,1.8364528545823171e-06,0,0,1,9.472836640932127e-06
6231,doubles,1,1.8364528545823171e-06,0,0,1,9.472836640932127e-06
6233,loanslet,1,1.8364528545823171e-06,0,0,1,9.472836640932127e-06
6236,slow-jamming,1,1.8364528545823171e-06,0,0,1,9.472836640932127e-06
6237,slow-jam,1,1.8364528545823171e-06,0,0,1,9.472836640932127e-06
6240,congressweve,1,1.8364528545823171e-06,0,0,1,9.472836640932127e-06
6242,rack,1,1.8364528545823171e-06,0,0,1,9.472836640932127e-06
6241,debtpresident,1,1.8364528545823171e-06,0,0,1,9.472836640932127e-06
6243,imperativepresident,1,1.8364528545823171e-06,0,0,1,9.472836640932127e-06
6244,elie,1,1.8364528545823171e-06,0,0,1,9.472836640932127e-06
6246,wiesel,1,1.8364528545823171e-06,0,0,1,9.472836640932127e-06
6247,availability,1,1.8364528545823171e-06,0,0,1,9.472836640932127e-06
6249,abyss,1,1.8364528545823171e-06,0,0,1,9.472836640932127e-06
6254,anti-bullying,1,1.8364528545823171e-06,0,0,1,9.472836640932127e-06
6256,adsbut,1,1.8364528545823171e-06,0,0,1,9.472836640932127e-06
6257,out-organizing,1,1.8364528545823171e-06,0,0,1,9.472836640932127e-06
6259,downchip,1,1.8364528545823171e-06,0,0,1,9.472836640932127e-06
6263,goas,1,1.8364528545823171e-06,0,0,1,9.472836640932127e-06
6261,canvassersbutton,1,1.8364528545823171e-06,0,0,1,9.472836640932127e-06
6262,enthusiasts,1,1.8364528545823171e-06,0,0,1,9.472836640932127e-06
6260,@ofava,1,1.8364528545823171e-06,0,0,1,9.472836640932127e-06
6268,mercury,1,1.8364528545823171e-06,0,0,1,9.472836640932127e-06
6267,120000,1,1.8364528545823171e-06,0,0,1,9.472836640932127e-06
6271,on200,1,1.8364528545823171e-06,0,0,1,9.472836640932127e-06
6273,brainstorming,1,1.8364528545823171e-06,0,0,1,9.472836640932127e-06
6276,yesterdaybut,1,1.8364528545823171e-06,0,0,1,9.472836640932127e-06
6280,peppers,1,1.8364528545823171e-06,0,0,1,9.472836640932127e-06
6278,#rockforbarack,1,1.8364528545823171e-06,0,0,1,9.472836640932127e-06
6281,#buffettruleputting,1,1.8364528545823171e-06,0,0,1,9.472836640932127e-06
6286,collar,1,1.8364528545823171e-06,0,0,1,9.472836640932127e-06
6287,agreeits,1,1.8364528545823171e-06,0,0,1,9.472836640932127e-06
6290,5400,1,1.8364528545823171e-06,0,0,1,9.472836640932127e-06
6293,stored,1,1.8364528545823171e-06,0,0,1,9.472836640932127e-06
6296,139,1,1.8364528545823171e-06,0,0,1,9.472836640932127e-06
6297,taxesless,1,1.8364528545823171e-06,0,0,1,9.472836640932127e-06
6299,49500,1,1.8364528545823171e-06,0,0,1,9.472836640932127e-06
6300,#buffettrulecommon-sense,1,1.8364528545823171e-06,0,0,1,9.472836640932127e-06
6302,seder,1,1.8364528545823171e-06,0,0,1,9.472836640932127e-06
6303,pokey,1,1.8364528545823171e-06,0,0,1,9.472836640932127e-06
6305,2009less,1,1.8364528545823171e-06,0,0,1,9.472836640932127e-06
6307,204,1,1.8364528545823171e-06,0,0,1,9.472836640932127e-06
6308,women-owned,1,1.8364528545823171e-06,0,0,1,9.472836640932127e-06
6315,toosounds,1,1.8364528545823171e-06,0,0,1,9.472836640932127e-06
6317,#whatsromneyhiding,1,1.8364528545823171e-06,0,0,1,9.472836640932127e-06
6321,disclosing,1,1.8364528545823171e-06,0,0,1,9.472836640932127e-06
6324,progressand,1,1.8364528545823171e-06,0,0,1,9.472836640932127e-06
6325,anything@whitehouse,1,1.8364528545823171e-06,0,0,1,9.472836640932127e-06
6328,edgeand,1,1.8364528545823171e-06,0,0,1,9.472836640932127e-06
6330,start-ups,1,1.8364528545823171e-06,0,0,1,9.472836640932127e-06
6329,game-changer,1,1.8364528545823171e-06,0,0,1,9.472836640932127e-06
6332,1470,1,1.8364528545823171e-06,0,0,1,9.472836640932127e-06
6331,#fairshare,1,1.8364528545823171e-06,0,0,1,9.472836640932127e-06
6337,twiceat,1,1.8364528545823171e-06,0,0,1,9.472836640932127e-06
6341,kendra,1,1.8364528545823171e-06,0,0,1,9.472836640932127e-06
6342,edith,1,1.8364528545823171e-06,0,0,1,9.472836640932127e-06
6348,345pm,1,1.8364528545823171e-06,0,0,1,9.472836640932127e-06
6349,affordabilityask,1,1.8364528545823171e-06,0,0,1,9.472836640932127e-06
6347,#askvp,1,1.8364528545823171e-06,0,0,1,9.472836640932127e-06
6351,asne,1,1.8364528545823171e-06,0,0,1,9.472836640932127e-06
6352,obamawhats,1,1.8364528545823171e-06,0,0,1,9.472836640932127e-06
6355,supporter-driven,1,1.8364528545823171e-06,0,0,1,9.472836640932127e-06
6353,@spotify,1,1.8364528545823171e-06,0,0,1,9.472836640932127e-06
6356,fooling,1,1.8364528545823171e-06,0,0,1,9.472836640932127e-06
6358,someonethe,1,1.8364528545823171e-06,0,0,1,9.472836640932127e-06
6359,thingone,1,1.8364528545823171e-06,0,0,1,9.472836640932127e-06
6362,yetchip,1,1.8364528545823171e-06,0,0,1,9.472836640932127e-06
6363,littlest,1,1.8364528545823171e-06,0,0,1,9.472836640932127e-06
6365,bark,1,1.8364528545823171e-06,0,0,1,9.472836640932127e-06
6364,baracka,1,1.8364528545823171e-06,0,0,1,9.472836640932127e-06
6366,pinterest,1,1.8364528545823171e-06,0,0,1,9.472836640932127e-06
6369,animated,1,1.8364528545823171e-06,0,0,1,9.472836640932127e-06
6371,chancetake,1,1.8364528545823171e-06,0,0,1,9.472836640932127e-06
6372,@omi66,1,1.8364528545823171e-06,0,0,1,9.472836640932127e-06
6373,bake,1,1.8364528545823171e-06,0,0,1,9.472836640932127e-06
6375,@kerryylee,1,1.8364528545823171e-06,0,0,1,9.472836640932127e-06
6376,perk,1,1.8364528545823171e-06,0,0,1,9.472836640932127e-06
6377,@gloriasteinem,1,1.8364528545823171e-06,0,0,1,9.472836640932127e-06
6378,kiddo,1,1.8364528545823171e-06,0,0,1,9.472836640932127e-06
6382,governing@elizabethforma,1,1.8364528545823171e-06,0,0,1,9.472836640932127e-06
6383,nowpotus,1,1.8364528545823171e-06,0,0,1,9.472836640932127e-06
6385,approximate,1,1.8364528545823171e-06,0,0,1,9.472836640932127e-06
6386,reformstill,1,1.8364528545823171e-06,0,0,1,9.472836640932127e-06
6387,2016many,1,1.8364528545823171e-06,0,0,1,9.472836640932127e-06
6388,@leahdungan,1,1.8364528545823171e-06,0,0,1,9.472836640932127e-06
6392,@gregburd,1,1.8364528545823171e-06,0,0,1,9.472836640932127e-06
6395,skip,1,1.8364528545823171e-06,0,0,1,9.472836640932127e-06
6394,preventative,1,1.8364528545823171e-06,0,0,1,9.472836640932127e-06
6393,compounded,1,1.8364528545823171e-06,0,0,1,9.472836640932127e-06
6398,#2012stories,1,1.8364528545823171e-06,0,0,1,9.472836640932127e-06
6399,medicareromneys,1,1.8364528545823171e-06,0,0,1,9.472836640932127e-06
6401,actand,1,1.8364528545823171e-06,0,0,1,9.472836640932127e-06
6402,savingby,1,1.8364528545823171e-06,0,0,1,9.472836640932127e-06
6403,finepotus,1,1.8364528545823171e-06,0,0,1,9.472836640932127e-06
6405,98th,1,1.8364528545823171e-06,0,0,1,9.472836640932127e-06
6406,percentilejust,1,1.8364528545823171e-06,0,0,1,9.472836640932127e-06
6404,#humblebrag,1,1.8364528545823171e-06,0,0,1,9.472836640932127e-06
6407,stephon,1,1.8364528545823171e-06,0,0,1,9.472836640932127e-06
6408,zoe,1,1.8364528545823171e-06,0,0,1,9.472836640932127e-06
6409,#aca13,1,1.8364528545823171e-06,0,0,1,9.472836640932127e-06
6411,todaynow,1,1.8364528545823171e-06,0,0,1,9.472836640932127e-06
6414,wondered,1,1.8364528545823171e-06,0,0,1,9.472836640932127e-06
6412,enlighten,1,1.8364528545823171e-06,0,0,1,9.472836640932127e-06
6415,348000,1,1.8364528545823171e-06,0,0,1,9.472836640932127e-06
6417,bayard,1,1.8364528545823171e-06,0,0,1,9.472836640932127e-06
6419,rustin,1,1.8364528545823171e-06,0,0,1,9.472836640932127e-06
6418,forefront,1,1.8364528545823171e-06,0,0,1,9.472836640932127e-06
6420,paddys,1,1.8364528545823171e-06,0,0,1,9.472836640932127e-06
6422,healthand,1,1.8364528545823171e-06,0,0,1,9.472836640932127e-06
6424,#nursesforobama,1,1.8364528545823171e-06,0,0,1,9.472836640932127e-06
6425,herean,1,1.8364528545823171e-06,0,0,1,9.472836640932127e-06
6428,@rhodaja,1,1.8364528545823171e-06,0,0,1,9.472836640932127e-06
6429,hanks,1,1.8364528545823171e-06,0,0,1,9.472836640932127e-06
6432,workthe,1,1.8364528545823171e-06,0,0,1,9.472836640932127e-06
6434,nighttune,1,1.8364528545823171e-06,0,0,1,9.472836640932127e-06
6435,yearpresident,1,1.8364528545823171e-06,0,0,1,9.472836640932127e-06
6439,traveleddont,1,1.8364528545823171e-06,0,0,1,9.472836640932127e-06
6441,bracketand,1,1.8364528545823171e-06,0,0,1,9.472836640932127e-06
6442,exampleget,1,1.8364528545823171e-06,0,0,1,9.472836640932127e-06
6443,conditionsthe,1,1.8364528545823171e-06,0,0,1,9.472836640932127e-06
6445,bonnies,1,1.8364528545823171e-06,0,0,1,9.472836640932127e-06
6444,23-year-old,1,1.8364528545823171e-06,0,0,1,9.472836640932127e-06
6451,@ofaok,1,1.8364528545823171e-06,0,0,1,9.472836640932127e-06
6453,i-75,1,1.8364528545823171e-06,0,0,1,9.472836640932127e-06
6454,presidentsports,1,1.8364528545823171e-06,0,0,1,9.472836640932127e-06
6455,marked,1,1.8364528545823171e-06,0,0,1,9.472836640932127e-06
6457,cathleen,1,1.8364528545823171e-06,0,0,1,9.472836640932127e-06
6459,regina,1,1.8364528545823171e-06,0,0,1,9.472836640932127e-06
6460,open-government,1,1.8364528545823171e-06,0,0,1,9.472836640932127e-06
6468,traveledthe,1,1.8364528545823171e-06,0,0,1,9.472836640932127e-06
6464,award-winning,1,1.8364528545823171e-06,0,0,1,9.472836640932127e-06
6467,guggenheim,1,1.8364528545823171e-06,0,0,1,9.472836640932127e-06
6470,unexpectedmichael,1,1.8364528545823171e-06,0,0,1,9.472836640932127e-06
6469,apodaca,1,1.8364528545823171e-06,0,0,1,9.472836640932127e-06
6473,fluke,1,1.8364528545823171e-06,0,0,1,9.472836640932127e-06
6475,casualness,1,1.8364528545823171e-06,0,0,1,9.472836640932127e-06
6477,foreclosed,1,1.8364528545823171e-06,0,0,1,9.472836640932127e-06
6485,preference,1,1.8364528545823171e-06,0,0,1,9.472836640932127e-06
6486,warpresident,1,1.8364528545823171e-06,0,0,1,9.472836640932127e-06
6489,shirtorder,1,1.8364528545823171e-06,0,0,1,9.472836640932127e-06
6490,@janellemonae,1,1.8364528545823171e-06,0,0,1,9.472836640932127e-06
6491,chips,1,1.8364528545823171e-06,0,0,1,9.472836640932127e-06
6494,wastetell,1,1.8364528545823171e-06,0,0,1,9.472836640932127e-06
6495,barackif,1,1.8364528545823171e-06,0,0,1,9.472836640932127e-06
6499,growingfive,1,1.8364528545823171e-06,0,0,1,9.472836640932127e-06
6498,athens,1,1.8364528545823171e-06,0,0,1,9.472836640932127e-06
6497,#opendoors2012,1,1.8364528545823171e-06,0,0,1,9.472836640932127e-06
6503,@mitchstewart,1,1.8364528545823171e-06,0,0,1,9.472836640932127e-06
6504,subsidiesthey,1,1.8364528545823171e-06,0,0,1,9.472836640932127e-06
6506,giveaway,1,1.8364528545823171e-06,0,0,1,9.472836640932127e-06
6509,battery,1,1.8364528545823171e-06,0,0,1,9.472836640932127e-06
6511,germanythe,1,1.8364528545823171e-06,0,0,1,9.472836640932127e-06
6515,lin,1,1.8364528545823171e-06,0,0,1,9.472836640932127e-06
6512,#linsanity,1,1.8364528545823171e-06,0,0,1,9.472836640932127e-06
6518,draws,1,1.8364528545823171e-06,0,0,1,9.472836640932127e-06
6520,housecheck,1,1.8364528545823171e-06,0,0,1,9.472836640932127e-06
6521,industrys,1,1.8364528545823171e-06,0,0,1,9.472836640932127e-06
6524,ounce,1,1.8364528545823171e-06,0,0,1,9.472836640932127e-06
6526,@uaw,1,1.8364528545823171e-06,0,0,1,9.472836640932127e-06
6528,#dinnerwithbarackis,1,1.8364528545823171e-06,0,0,1,9.472836640932127e-06
6529,bankruptand,1,1.8364528545823171e-06,0,0,1,9.472836640932127e-06
6530,michiganders,1,1.8364528545823171e-06,0,0,1,9.472836640932127e-06
6532,obamaone,1,1.8364528545823171e-06,0,0,1,9.472836640932127e-06
6534,american-made,1,1.8364528545823171e-06,0,0,1,9.472836640932127e-06
6538,areits,1,1.8364528545823171e-06,0,0,1,9.472836640932127e-06
6539,backjoan,1,1.8364528545823171e-06,0,0,1,9.472836640932127e-06
6537,@ofaks,1,1.8364528545823171e-06,0,0,1,9.472836640932127e-06
6541,industryand,1,1.8364528545823171e-06,0,0,1,9.472836640932127e-06
6542,stupid…thats,1,1.8364528545823171e-06,0,0,1,9.472836640932127e-06
6543,dusting,1,1.8364528545823171e-06,0,0,1,9.472836640932127e-06
6546,energypresident,1,1.8364528545823171e-06,0,0,1,9.472836640932127e-06
6559,sing,1,1.8364528545823171e-06,0,0,1,9.472836640932127e-06
6560,againthis,1,1.8364528545823171e-06,0,0,1,9.472836640932127e-06
6562,k-12,1,1.8364528545823171e-06,0,0,1,9.472836640932127e-06
6564,dayorder,1,1.8364528545823171e-06,0,0,1,9.472836640932127e-06
6566,presidentattend,1,1.8364528545823171e-06,0,0,1,9.472836640932127e-06
6569,profitsanother,1,1.8364528545823171e-06,0,0,1,9.472836640932127e-06
6570,rebounding,1,1.8364528545823171e-06,0,0,1,9.472836640932127e-06
6571,schedulepresident,1,1.8364528545823171e-06,0,0,1,9.472836640932127e-06
6574,@ofala,1,1.8364528545823171e-06,0,0,1,9.472836640932127e-06
6575,@questlove,1,1.8364528545823171e-06,0,0,1,9.472836640932127e-06
6578,speechlesssharon,1,1.8364528545823171e-06,0,0,1,9.472836640932127e-06
6580,@ofapa,1,1.8364528545823171e-06,0,0,1,9.472836640932127e-06
6579,47000,1,1.8364528545823171e-06,0,0,1,9.472836640932127e-06
6582,soonget,1,1.8364528545823171e-06,0,0,1,9.472836640932127e-06
6583,profit-sharing,1,1.8364528545823171e-06,0,0,1,9.472836640932127e-06
6585,couldand,1,1.8364528545823171e-06,0,0,1,9.472836640932127e-06
6586,excel,1,1.8364528545823171e-06,0,0,1,9.472836640932127e-06
6590,seoul,1,1.8364528545823171e-06,0,0,1,9.472836640932127e-06
6589,imported,1,1.8364528545823171e-06,0,0,1,9.472836640932127e-06
6591,economyproviding,1,1.8364528545823171e-06,0,0,1,9.472836640932127e-06
6593,bosss,1,1.8364528545823171e-06,0,0,1,9.472836640932127e-06
6595,grammys,1,1.8364528545823171e-06,0,0,1,9.472836640932127e-06
6596,bookmarks,1,1.8364528545823171e-06,0,0,1,9.472836640932127e-06
6597,thatll,1,1.8364528545823171e-06,0,0,1,9.472836640932127e-06
6598,full-scale,1,1.8364528545823171e-06,0,0,1,9.472836640932127e-06
6602,snapshot,1,1.8364528545823171e-06,0,0,1,9.472836640932127e-06
6603,frees,1,1.8364528545823171e-06,0,0,1,9.472836640932127e-06
6606,tackles,1,1.8364528545823171e-06,0,0,1,9.472836640932127e-06
6608,@rickymartin,1,1.8364528545823171e-06,0,0,1,9.472836640932127e-06
6607,#presidentialplaylist,1,1.8364528545823171e-06,0,0,1,9.472836640932127e-06
6610,callingwill,1,1.8364528545823171e-06,0,0,1,9.472836640932127e-06
6609,#womenforobama,1,1.8364528545823171e-06,0,0,1,9.472836640932127e-06
6612,@letsmove,1,1.8364528545823171e-06,0,0,1,9.472836640932127e-06
6617,wilco,1,1.8364528545823171e-06,0,0,1,9.472836640932127e-06
6616,doubtcheck,1,1.8364528545823171e-06,0,0,1,9.472836640932127e-06
6618,100and,1,1.8364528545823171e-06,0,0,1,9.472836640932127e-06
6619,someto,1,1.8364528545823171e-06,0,0,1,9.472836640932127e-06
6623,pacs,1,1.8364528545823171e-06,0,0,1,9.472836640932127e-06
6624,pose,1,1.8364528545823171e-06,0,0,1,9.472836640932127e-06
6625,scientist,1,1.8364528545823171e-06,0,0,1,9.472836640932127e-06
6635,matchup,1,1.8364528545823171e-06,0,0,1,9.472836640932127e-06
6634,gameday,1,1.8364528545823171e-06,0,0,1,9.472836640932127e-06
6638,homeownershis,1,1.8364528545823171e-06,0,0,1,9.472836640932127e-06
6637,3k,1,1.8364528545823171e-06,0,0,1,9.472836640932127e-06
6640,243000,1,1.8364528545823171e-06,0,0,1,9.472836640932127e-06
6641,obama-bashing,1,1.8364528545823171e-06,0,0,1,9.472836640932127e-06
6645,24335,1,1.8364528545823171e-06,0,0,1,9.472836640932127e-06
6648,20304,1,1.8364528545823171e-06,0,0,1,9.472836640932127e-06
6649,10192,1,1.8364528545823171e-06,0,0,1,9.472836640932127e-06
6654,growthtell,1,1.8364528545823171e-06,0,0,1,9.472836640932127e-06
6658,summary,1,1.8364528545823171e-06,0,0,1,9.472836640932127e-06
6657,fact-sheet,1,1.8364528545823171e-06,0,0,1,9.472836640932127e-06
6662,waned,1,1.8364528545823171e-06,0,0,1,9.472836640932127e-06
6663,democracies,1,1.8364528545823171e-06,0,0,1,9.472836640932127e-06
6665,corrosive,1,1.8364528545823171e-06,0,0,1,9.472836640932127e-06
6669,copouts,1,1.8364528545823171e-06,0,0,1,9.472836640932127e-06
6676,job-creation,1,1.8364528545823171e-06,0,0,1,9.472836640932127e-06
6677,record22,1,1.8364528545823171e-06,0,0,1,9.472836640932127e-06
6675,growthby,1,1.8364528545823171e-06,0,0,1,9.472836640932127e-06
6679,morningthe,1,1.8364528545823171e-06,0,0,1,9.472836640932127e-06
6680,rings,1,1.8364528545823171e-06,0,0,1,9.472836640932127e-06
6678,download,1,1.8364528545823171e-06,0,0,1,9.472836640932127e-06
6681,ringtone,1,1.8364528545823171e-06,0,0,1,9.472836640932127e-06
6682,#sotu2012,1,1.8364528545823171e-06,0,0,1,9.472836640932127e-06
6684,touchedmyself,1,1.8364528545823171e-06,0,0,1,9.472836640932127e-06
6686,39th,1,1.8364528545823171e-06,0,0,1,9.472836640932127e-06
6688,sang,1,1.8364528545823171e-06,0,0,1,9.472836640932127e-06
6690,jobsthrough,1,1.8364528545823171e-06,0,0,1,9.472836640932127e-06
6689,#visitus,1,1.8364528545823171e-06,0,0,1,9.472836640932127e-06
6696,application,1,1.8364528545823171e-06,0,0,1,9.472836640932127e-06
6700,optional,1,1.8364528545823171e-06,0,0,1,9.472836640932127e-06
6703,985-6433,1,1.8364528545823171e-06,0,0,1,9.472836640932127e-06
6705,volunteered,1,1.8364528545823171e-06,0,0,1,9.472836640932127e-06
6706,@michelleobamawill,1,1.8364528545823171e-06,0,0,1,9.472836640932127e-06
6708,specialist,1,1.8364528545823171e-06,0,0,1,9.472836640932127e-06
6710,tomorrowfind,1,1.8364528545823171e-06,0,0,1,9.472836640932127e-06
6712,#sopa,1,1.8364528545823171e-06,0,0,1,9.472836640932127e-06
6714,leaner,1,1.8364528545823171e-06,0,0,1,9.472836640932127e-06
6715,hiked,1,1.8364528545823171e-06,0,0,1,9.472836640932127e-06
6716,twitterhappy,1,1.8364528545823171e-06,0,0,1,9.472836640932127e-06
6717,#insourcing,1,1.8364528545823171e-06,0,0,1,9.472836640932127e-06
6718,countapply,1,1.8364528545823171e-06,0,0,1,9.472836640932127e-06
6719,dined,1,1.8364528545823171e-06,0,0,1,9.472836640932127e-06
6721,winnersthese,1,1.8364528545823171e-06,0,0,1,9.472836640932127e-06
6723,world-kathies,1,1.8364528545823171e-06,0,0,1,9.472836640932127e-06
6727,moratorium,1,1.8364528545823171e-06,0,0,1,9.472836640932127e-06
6724,canyon,1,1.8364528545823171e-06,0,0,1,9.472836640932127e-06
6735,resolutionsstrengthening,1,1.8364528545823171e-06,0,0,1,9.472836640932127e-06
6737,prints,1,1.8364528545823171e-06,0,0,1,9.472836640932127e-06
6736,framedesigned,1,1.8364528545823171e-06,0,0,1,9.472836640932127e-06
6740,valarie,1,1.8364528545823171e-06,0,0,1,9.472836640932127e-06
6739,kathie,1,1.8364528545823171e-06,0,0,1,9.472836640932127e-06
6741,180000,1,1.8364528545823171e-06,0,0,1,9.472836640932127e-06
6742,@hildasolisdol,1,1.8364528545823171e-06,0,0,1,9.472836640932127e-06
6743,#runwaytowin,1,1.8364528545823171e-06,0,0,1,9.472836640932127e-06
6747,itwill,1,1.8364528545823171e-06,0,0,1,9.472836640932127e-06
6748,number1-855-411-cfpbto,1,1.8364528545823171e-06,0,0,1,9.472836640932127e-06
6754,onand,1,1.8364528545823171e-06,0,0,1,9.472836640932127e-06
6757,tempting,1,1.8364528545823171e-06,0,0,1,9.472836640932127e-06
6756,funnybut,1,1.8364528545823171e-06,0,0,1,9.472836640932127e-06
6759,videoconference,1,1.8364528545823171e-06,0,0,1,9.472836640932127e-06
6758,caucus-goers,1,1.8364528545823171e-06,0,0,1,9.472836640932127e-06
6763,iowans,1,1.8364528545823171e-06,0,0,1,9.472836640932127e-06
6762,#promiseskept,1,1.8364528545823171e-06,0,0,1,9.472836640932127e-06
6764,2011youre,1,1.8364528545823171e-06,0,0,1,9.472836640932127e-06
6765,2011and,1,1.8364528545823171e-06,0,0,1,9.472836640932127e-06
6768,merch,1,1.8364528545823171e-06,0,0,1,9.472836640932127e-06
6769,tweet2012,1,1.8364528545823171e-06,0,0,1,9.472836640932127e-06
6771,coupon,1,1.8364528545823171e-06,0,0,1,9.472836640932127e-06
6772,gift2012,1,1.8364528545823171e-06,0,0,1,9.472836640932127e-06
6775,iand,1,1.8364528545823171e-06,0,0,1,9.472836640932127e-06
6774,bowant,1,1.8364528545823171e-06,0,0,1,9.472836640932127e-06
6777,flotus,1,1.8364528545823171e-06,0,0,1,9.472836640932127e-06
6781,cutabout,1,1.8364528545823171e-06,0,0,1,9.472836640932127e-06
6783,pop,1,1.8364528545823171e-06,0,0,1,9.472836640932127e-06
6785,menorah,1,1.8364528545823171e-06,0,0,1,9.472836640932127e-06
6787,@allihanson,1,1.8364528545823171e-06,0,0,1,9.472836640932127e-06
6788,peacetime,1,1.8364528545823171e-06,0,0,1,9.472836640932127e-06
6789,@lovespeacesoul,1,1.8364528545823171e-06,0,0,1,9.472836640932127e-06
6792,colon,1,1.8364528545823171e-06,0,0,1,9.472836640932127e-06
6793,76-year-old,1,1.8364528545823171e-06,0,0,1,9.472836640932127e-06
6794,16-year-old,1,1.8364528545823171e-06,0,0,1,9.472836640932127e-06
6795,shela,1,1.8364528545823171e-06,0,0,1,9.472836640932127e-06
6800,congressdont,1,1.8364528545823171e-06,0,0,1,9.472836640932127e-06
6801,grinch,1,1.8364528545823171e-06,0,0,1,9.472836640932127e-06
6802,#dinnerwithbarackenter,1,1.8364528545823171e-06,0,0,1,9.472836640932127e-06
6804,@ladygaga,1,1.8364528545823171e-06,0,0,1,9.472836640932127e-06
6806,successpresident,1,1.8364528545823171e-06,0,0,1,9.472836640932127e-06
6807,fittest,1,1.8364528545823171e-06,0,0,1,9.472836640932127e-06
6810,welfarepresident,1,1.8364528545823171e-06,0,0,1,9.472836640932127e-06
6811,buffettpresident,1,1.8364528545823171e-06,0,0,1,9.472836640932127e-06
6813,valuespresident,1,1.8364528545823171e-06,0,0,1,9.472836640932127e-06
6814,togetherpresident,1,1.8364528545823171e-06,0,0,1,9.472836640932127e-06
6817,inequalitya,1,1.8364528545823171e-06,0,0,1,9.472836640932127e-06
6816,depressionhurts,1,1.8364528545823171e-06,0,0,1,9.472836640932127e-06
6815,allpresident,1,1.8364528545823171e-06,0,0,1,9.472836640932127e-06
6819,percentpresident,1,1.8364528545823171e-06,0,0,1,9.472836640932127e-06
6821,morepresident,1,1.8364528545823171e-06,0,0,1,9.472836640932127e-06
6825,1500paid,1,1.8364528545823171e-06,0,0,1,9.472836640932127e-06
6827,surcharge,1,1.8364528545823171e-06,0,0,1,9.472836640932127e-06
6829,02,1,1.8364528545823171e-06,0,0,1,9.472836640932127e-06
6832,muchexcept,1,1.8364528545823171e-06,0,0,1,9.472836640932127e-06
6833,#smallbusinesssaturday,1,1.8364528545823171e-06,0,0,1,9.472836640932127e-06
6834,ornaments,1,1.8364528545823171e-06,0,0,1,9.472836640932127e-06
6835,10turkeyday,1,1.8364528545823171e-06,0,0,1,9.472836640932127e-06
6839,cheers,1,1.8364528545823171e-06,0,0,1,9.472836640932127e-06
6840,re-releasing,1,1.8364528545823171e-06,0,0,1,9.472836640932127e-06
6841,sitecheck,1,1.8364528545823171e-06,0,0,1,9.472836640932127e-06
6843,zip-up,1,1.8364528545823171e-06,0,0,1,9.472836640932127e-06
6844,obamawhy,1,1.8364528545823171e-06,0,0,1,9.472836640932127e-06
6845,buttons,1,1.8364528545823171e-06,0,0,1,9.472836640932127e-06
6847,differencethank,1,1.8364528545823171e-06,0,0,1,9.472836640932127e-06
6851,veteranslet,1,1.8364528545823171e-06,0,0,1,9.472836640932127e-06
6853,minutesput,1,1.8364528545823171e-06,0,0,1,9.472836640932127e-06
6855,9600,1,1.8364528545823171e-06,0,0,1,9.472836640932127e-06
6857,anti-net,1,1.8364528545823171e-06,0,0,1,9.472836640932127e-06
6862,5600,1,1.8364528545823171e-06,0,0,1,9.472836640932127e-06
6864,todayshout-out,1,1.8364528545823171e-06,0,0,1,9.472836640932127e-06
6863,#noon2,1,1.8364528545823171e-06,0,0,1,9.472836640932127e-06
6868,counseling,1,1.8364528545823171e-06,0,0,1,9.472836640932127e-06
6874,commemorative,1,1.8364528545823171e-06,0,0,1,9.472836640932127e-06
6873,coin,1,1.8364528545823171e-06,0,0,1,9.472836640932127e-06
6879,upenn,1,1.8364528545823171e-06,0,0,1,9.472836640932127e-06
6878,#greatertogether,1,1.8364528545823171e-06,0,0,1,9.472836640932127e-06
6880,shortages,1,1.8364528545823171e-06,0,0,1,9.472836640932127e-06
6884,wendi,1,1.8364528545823171e-06,0,0,1,9.472836640932127e-06
6882,juanita,1,1.8364528545823171e-06,0,0,1,9.472836640932127e-06
6888,enrolling,1,1.8364528545823171e-06,0,0,1,9.472836640932127e-06
6890,repayments,1,1.8364528545823171e-06,0,0,1,9.472836640932127e-06
6891,curious,1,1.8364528545823171e-06,0,0,1,9.472836640932127e-06
6892,@jayleno,1,1.8364528545823171e-06,0,0,1,9.472836640932127e-06
6893,#obama2012nows,1,1.8364528545823171e-06,0,0,1,9.472836640932127e-06
6894,tumblr,1,1.8364528545823171e-06,0,0,1,9.472836640932127e-06
6897,profiled,1,1.8364528545823171e-06,0,0,1,9.472836640932127e-06
6896,newsand,1,1.8364528545823171e-06,0,0,1,9.472836640932127e-06
6899,filibustered,1,1.8364528545823171e-06,0,0,1,9.472836640932127e-06
6898,billtheyve,1,1.8364528545823171e-06,0,0,1,9.472836640932127e-06
6903,retro-style,1,1.8364528545823171e-06,0,0,1,9.472836640932127e-06
6906,provisions,1,1.8364528545823171e-06,0,0,1,9.472836640932127e-06
6907,shiny,1,1.8364528545823171e-06,0,0,1,9.472836640932127e-06
6913,components,1,1.8364528545823171e-06,0,0,1,9.472836640932127e-06
6916,soda,1,1.8364528545823171e-06,0,0,1,9.472836640932127e-06
6915,@vps,1,1.8364528545823171e-06,0,0,1,9.472836640932127e-06
6919,51700,1,1.8364528545823171e-06,0,0,1,9.472836640932127e-06
6920,first-time,1,1.8364528545823171e-06,0,0,1,9.472836640932127e-06
6917,07,1,1.8364528545823171e-06,0,0,1,9.472836640932127e-06
6918,352000,1,1.8364528545823171e-06,0,0,1,9.472836640932127e-06
6921,answerpresident,1,1.8364528545823171e-06,0,0,1,9.472836640932127e-06
6923,acttell,1,1.8364528545823171e-06,0,0,1,9.472836640932127e-06
6924,actmake,1,1.8364528545823171e-06,0,0,1,9.472836640932127e-06
6926,internshipapply,1,1.8364528545823171e-06,0,0,1,9.472836640932127e-06
6927,#passthebillwill,1,1.8364528545823171e-06,0,0,1,9.472836640932127e-06
6932,gabrielle,1,1.8364528545823171e-06,0,0,1,9.472836640932127e-06
6935,reformtell,1,1.8364528545823171e-06,0,0,1,9.472836640932127e-06
6936,dayincluding,1,1.8364528545823171e-06,0,0,1,9.472836640932127e-06
6938,harvests,1,1.8364528545823171e-06,0,0,1,9.472836640932127e-06
6942,ownerspass,1,1.8364528545823171e-06,0,0,1,9.472836640932127e-06
6943,classroomspass,1,1.8364528545823171e-06,0,0,1,9.472836640932127e-06
6946,chipped,1,1.8364528545823171e-06,0,0,1,9.472836640932127e-06
6947,wayone,1,1.8364528545823171e-06,0,0,1,9.472836640932127e-06
6948,chipping,1,1.8364528545823171e-06,0,0,1,9.472836640932127e-06
6950,back-to-school,1,1.8364528545823171e-06,0,0,1,9.472836640932127e-06
6951,kal,1,1.8364528545823171e-06,0,0,1,9.472836640932127e-06
6952,penns,1,1.8364528545823171e-06,0,0,1,9.472836640932127e-06
6953,#dinnerwithbarackwhat,1,1.8364528545823171e-06,0,0,1,9.472836640932127e-06
6956,yardworkeven,1,1.8364528545823171e-06,0,0,1,9.472836640932127e-06
6955,pickup,1,1.8364528545823171e-06,0,0,1,9.472836640932127e-06
6960,life-saving,1,1.8364528545823171e-06,0,0,1,9.472836640932127e-06
6961,lapel,1,1.8364528545823171e-06,0,0,1,9.472836640932127e-06
6966,hashtagsand,1,1.8364528545823171e-06,0,0,1,9.472836640932127e-06
6970,meyer,1,1.8364528545823171e-06,0,0,1,9.472836640932127e-06
6971,#attackwatch,1,1.8364528545823171e-06,0,0,1,9.472836640932127e-06
6976,tenth,1,1.8364528545823171e-06,0,0,1,9.472836640932127e-06
6977,apron,1,1.8364528545823171e-06,0,0,1,9.472836640932127e-06
6980,tailgate,1,1.8364528545823171e-06,0,0,1,9.472836640932127e-06
6981,jobsits,1,1.8364528545823171e-06,0,0,1,9.472836640932127e-06
6984,collective,1,1.8364528545823171e-06,0,0,1,9.472836640932127e-06
6986,buffet,1,1.8364528545823171e-06,0,0,1,9.472836640932127e-06
6988,secretaryan,1,1.8364528545823171e-06,0,0,1,9.472836640932127e-06
6991,schooland,1,1.8364528545823171e-06,0,0,1,9.472836640932127e-06
6992,republicansincluding,1,1.8364528545823171e-06,0,0,1,9.472836640932127e-06
6995,watchand,1,1.8364528545823171e-06,0,0,1,9.472836640932127e-06
6998,caffeinated,1,1.8364528545823171e-06,0,0,1,9.472836640932127e-06
6999,tumbler,1,1.8364528545823171e-06,0,0,1,9.472836640932127e-06
7000,hilda,1,1.8364528545823171e-06,0,0,1,9.472836640932127e-06
7001,solis,1,1.8364528545823171e-06,0,0,1,9.472836640932127e-06
7002,votingstates,1,1.8364528545823171e-06,0,0,1,9.472836640932127e-06
7004,himtell,1,1.8364528545823171e-06,0,0,1,9.472836640932127e-06
7005,label,1,1.8364528545823171e-06,0,0,1,9.472836640932127e-06
7006,fran,1,1.8364528545823171e-06,0,0,1,9.472836640932127e-06
7011,krueger,1,1.8364528545823171e-06,0,0,1,9.472836640932127e-06
7018,@dhsjournal,1,1.8364528545823171e-06,0,0,1,9.472836640932127e-06
7017,43362,1,1.8364528545823171e-06,0,0,1,9.472836640932127e-06
7021,msg,1,1.8364528545823171e-06,0,0,1,9.472836640932127e-06
7019,friendsfamily,1,1.8364528545823171e-06,0,0,1,9.472836640932127e-06
7016,#irene,1,1.8364528545823171e-06,0,0,1,9.472836640932127e-06
7023,cutswho,1,1.8364528545823171e-06,0,0,1,9.472836640932127e-06
7026,oneget,1,1.8364528545823171e-06,0,0,1,9.472836640932127e-06
7027,irenemake,1,1.8364528545823171e-06,0,0,1,9.472836640932127e-06
7030,ratification,1,1.8364528545823171e-06,0,0,1,9.472836640932127e-06
7033,53025,1,1.8364528545823171e-06,0,0,1,9.472836640932127e-06
7034,wordsand,1,1.8364528545823171e-06,0,0,1,9.472836640932127e-06
7036,grudgingly,1,1.8364528545823171e-06,0,0,1,9.472836640932127e-06
7037,packers,1,1.8364528545823171e-06,0,0,1,9.472836640932127e-06
7040,unmentioned,1,1.8364528545823171e-06,0,0,1,9.472836640932127e-06
7045,quotable,1,1.8364528545823171e-06,0,0,1,9.472836640932127e-06
7046,slideshow,1,1.8364528545823171e-06,0,0,1,9.472836640932127e-06
7054,workhow,1,1.8364528545823171e-06,0,0,1,9.472836640932127e-06
7058,marta,1,1.8364528545823171e-06,0,0,1,9.472836640932127e-06
7059,presidenta,1,1.8364528545823171e-06,0,0,1,9.472836640932127e-06
7061,melody,1,1.8364528545823171e-06,0,0,1,9.472836640932127e-06
7066,bolts,1,1.8364528545823171e-06,0,0,1,9.472836640932127e-06
7069,removes,1,1.8364528545823171e-06,0,0,1,9.472836640932127e-06
7068,dampening,1,1.8364528545823171e-06,0,0,1,9.472836640932127e-06
7071,@pfeiffer44,1,1.8364528545823171e-06,0,0,1,9.472836640932127e-06
7070,840,1,1.8364528545823171e-06,0,0,1,9.472836640932127e-06
7076,wallet,1,1.8364528545823171e-06,0,0,1,9.472836640932127e-06
7077,defaulting,1,1.8364528545823171e-06,0,0,1,9.472836640932127e-06
7084,twitter@michaelcburgess,1,1.8364528545823171e-06,0,0,1,9.472836640932127e-06
7085,tx-26,1,1.8364528545823171e-06,0,0,1,9.472836640932127e-06
7081,@farenthold,1,1.8364528545823171e-06,0,0,1,9.472836640932127e-06
7086,tx-27,1,1.8364528545823171e-06,0,0,1,9.472836640932127e-06
7087,tx-32,1,1.8364528545823171e-06,0,0,1,9.472836640932127e-06
7088,@lamarsmithtx12,1,1.8364528545823171e-06,0,0,1,9.472836640932127e-06
7092,tx-21,1,1.8364528545823171e-06,0,0,1,9.472836640932127e-06
7089,@olsonpressshop,1,1.8364528545823171e-06,0,0,1,9.472836640932127e-06
7093,tx-22,1,1.8364528545823171e-06,0,0,1,9.472836640932127e-06
7090,@repcanseco,1,1.8364528545823171e-06,0,0,1,9.472836640932127e-06
7094,tx-23,1,1.8364528545823171e-06,0,0,1,9.472836640932127e-06
7091,@repkenmarchant,1,1.8364528545823171e-06,0,0,1,9.472836640932127e-06
7095,tx-24,1,1.8364528545823171e-06,0,0,1,9.472836640932127e-06
7098,@repkeygranger,1,1.8364528545823171e-06,0,0,1,9.472836640932127e-06
7100,tx-12,1,1.8364528545823171e-06,0,0,1,9.472836640932127e-06
7099,@repronpaul,1,1.8364528545823171e-06,0,0,1,9.472836640932127e-06
7101,tx-14,1,1.8364528545823171e-06,0,0,1,9.472836640932127e-06
7097,@repflores,1,1.8364528545823171e-06,0,0,1,9.472836640932127e-06
7102,tx-17,1,1.8364528545823171e-06,0,0,1,9.472836640932127e-06
7096,@randyneugebauer,1,1.8364528545823171e-06,0,0,1,9.472836640932127e-06
7103,tx-19,1,1.8364528545823171e-06,0,0,1,9.472836640932127e-06
7106,@repjoebarton,1,1.8364528545823171e-06,0,0,1,9.472836640932127e-06
7108,tx-06,1,1.8364528545823171e-06,0,0,1,9.472836640932127e-06
7104,@congculberson,1,1.8364528545823171e-06,0,0,1,9.472836640932127e-06
7109,tx-07,1,1.8364528545823171e-06,0,0,1,9.472836640932127e-06
7110,tx-08,1,1.8364528545823171e-06,0,0,1,9.472836640932127e-06
7105,@mccaulpressshop,1,1.8364528545823171e-06,0,0,1,9.472836640932127e-06
7111,tx-10,1,1.8364528545823171e-06,0,0,1,9.472836640932127e-06
7113,@kaybaileyhutch,1,1.8364528545823171e-06,0,0,1,9.472836640932127e-06
7115,@drphilroe,1,1.8364528545823171e-06,0,0,1,9.472836640932127e-06
7117,tn-1,1,1.8364528545823171e-06,0,0,1,9.472836640932127e-06
7116,@repchuck,1,1.8364528545823171e-06,0,0,1,9.472836640932127e-06
7118,tn-3,1,1.8364528545823171e-06,0,0,1,9.472836640932127e-06
7114,@desjarlaistn04,1,1.8364528545823171e-06,0,0,1,9.472836640932127e-06
7119,tn-4,1,1.8364528545823171e-06,0,0,1,9.472836640932127e-06
7121,@jimdemint,1,1.8364528545823171e-06,0,0,1,9.472836640932127e-06
7120,@grahamblog,1,1.8364528545823171e-06,0,0,1,9.472836640932127e-06
7122,@repjoepitts,1,1.8364528545823171e-06,0,0,1,9.472836640932127e-06
7124,pa-16,1,1.8364528545823171e-06,0,0,1,9.472836640932127e-06
7123,@reptimmurphy,1,1.8364528545823171e-06,0,0,1,9.472836640932127e-06
7125,pa-18,1,1.8364528545823171e-06,0,0,1,9.472836640932127e-06
7126,@repbilljohnson,1,1.8364528545823171e-06,0,0,1,9.472836640932127e-06
7130,oh-06,1,1.8364528545823171e-06,0,0,1,9.472836640932127e-06
7128,@steveaustria,1,1.8364528545823171e-06,0,0,1,9.472836640932127e-06
7131,oh-07,1,1.8364528545823171e-06,0,0,1,9.472836640932127e-06
7129,@stevelatourette,1,1.8364528545823171e-06,0,0,1,9.472836640932127e-06
7132,oh-14,1,1.8364528545823171e-06,0,0,1,9.472836640932127e-06
7127,@repstevestivers,1,1.8364528545823171e-06,0,0,1,9.472836640932127e-06
7133,oh-15,1,1.8364528545823171e-06,0,0,1,9.472836640932127e-06
7138,twitter@suemyrick,1,1.8364528545823171e-06,0,0,1,9.472836640932127e-06
7136,nc-09,1,1.8364528545823171e-06,0,0,1,9.472836640932127e-06
7135,@patrickmchenry,1,1.8364528545823171e-06,0,0,1,9.472836640932127e-06
7137,nc-10,1,1.8364528545823171e-06,0,0,1,9.472836640932127e-06
7140,@repreneeellmers,1,1.8364528545823171e-06,0,0,1,9.472836640932127e-06
7143,nc-02,1,1.8364528545823171e-06,0,0,1,9.472836640932127e-06
7141,@repwalterjones,1,1.8364528545823171e-06,0,0,1,9.472836640932127e-06
7144,nc-03,1,1.8364528545823171e-06,0,0,1,9.472836640932127e-06
7142,@virginiafoxx,1,1.8364528545823171e-06,0,0,1,9.472836640932127e-06
7145,nc-05,1,1.8364528545823171e-06,0,0,1,9.472836640932127e-06
7139,@howardcoble,1,1.8364528545823171e-06,0,0,1,9.472836640932127e-06
7146,nc-06,1,1.8364528545823171e-06,0,0,1,9.472836640932127e-06
7148,@reprichardhanna,1,1.8364528545823171e-06,0,0,1,9.472836640932127e-06
7150,ny-24,1,1.8364528545823171e-06,0,0,1,9.472836640932127e-06
7147,@repbuerkle,1,1.8364528545823171e-06,0,0,1,9.472836640932127e-06
7151,ny-25,1,1.8364528545823171e-06,0,0,1,9.472836640932127e-06
7149,@reptomreed,1,1.8364528545823171e-06,0,0,1,9.472836640932127e-06
7152,ny-29,1,1.8364528545823171e-06,0,0,1,9.472836640932127e-06
7158,ny-3,1,1.8364528545823171e-06,0,0,1,9.472836640932127e-06
7153,@repmichaelgrimm,1,1.8364528545823171e-06,0,0,1,9.472836640932127e-06
7156,ny-13,1,1.8364528545823171e-06,0,0,1,9.472836640932127e-06
7154,@repnanhayworth,1,1.8364528545823171e-06,0,0,1,9.472836640932127e-06
7157,ny-19,1,1.8364528545823171e-06,0,0,1,9.472836640932127e-06
7160,@repfrankguinta,1,1.8364528545823171e-06,0,0,1,9.472836640932127e-06
7161,nh-1,1,1.8364528545823171e-06,0,0,1,9.472836640932127e-06
7159,@repcharlesbass,1,1.8364528545823171e-06,0,0,1,9.472836640932127e-06
7162,nh-2,1,1.8364528545823171e-06,0,0,1,9.472836640932127e-06
7165,mo-07,1,1.8364528545823171e-06,0,0,1,9.472836640932127e-06
7167,@repalannunnelee,1,1.8364528545823171e-06,0,0,1,9.472836640932127e-06
7169,ms-1,1,1.8364528545823171e-06,0,0,1,9.472836640932127e-06
7166,@greggharper,1,1.8364528545823171e-06,0,0,1,9.472836640932127e-06
7170,ms-3,1,1.8364528545823171e-06,0,0,1,9.472836640932127e-06
7171,@davidvitter,1,1.8364528545823171e-06,0,0,1,9.472836640932127e-06
7173,@conghuelskamp,1,1.8364528545823171e-06,0,0,1,9.472836640932127e-06
7178,ks-1,1,1.8364528545823171e-06,0,0,1,9.472836640932127e-06
7175,@replynnjenkins,1,1.8364528545823171e-06,0,0,1,9.472836640932127e-06
7179,ks-2,1,1.8364528545823171e-06,0,0,1,9.472836640932127e-06
7180,ks-3,1,1.8364528545823171e-06,0,0,1,9.472836640932127e-06
7176,@repmikepompeo,1,1.8364528545823171e-06,0,0,1,9.472836640932127e-06
7181,ks-4,1,1.8364528545823171e-06,0,0,1,9.472836640932127e-06
7183,@sendancoats,1,1.8364528545823171e-06,0,0,1,9.472836640932127e-06
7182,@senatorlugar,1,1.8364528545823171e-06,0,0,1,9.472836640932127e-06
7187,@tomrooney,1,1.8364528545823171e-06,0,0,1,9.472836640932127e-06
7188,fl-16,1,1.8364528545823171e-06,0,0,1,9.472836640932127e-06
7186,@roslehtinen,1,1.8364528545823171e-06,0,0,1,9.472836640932127e-06
7189,fl-18,1,1.8364528545823171e-06,0,0,1,9.472836640932127e-06
7184,@allenwest,1,1.8364528545823171e-06,0,0,1,9.472836640932127e-06
7191,fl-22,1,1.8364528545823171e-06,0,0,1,9.472836640932127e-06
7185,@mariodb,1,1.8364528545823171e-06,0,0,1,9.472836640932127e-06
7190,fl-21@repsandyadams,1,1.8364528545823171e-06,0,0,1,9.472836640932127e-06
7192,fl-24,1,1.8364528545823171e-06,0,0,1,9.472836640932127e-06
7195,@repdennisross,1,1.8364528545823171e-06,0,0,1,9.472836640932127e-06
7197,fl-12,1,1.8364528545823171e-06,0,0,1,9.472836640932127e-06
7196,@vernbuchanan,1,1.8364528545823171e-06,0,0,1,9.472836640932127e-06
7198,fl-13,1,1.8364528545823171e-06,0,0,1,9.472836640932127e-06
7194,@conniemackiv,1,1.8364528545823171e-06,0,0,1,9.472836640932127e-06
7199,fl-14,1,1.8364528545823171e-06,0,0,1,9.472836640932127e-06
7193,@congbillposey,1,1.8364528545823171e-06,0,0,1,9.472836640932127e-06
7200,fl-15,1,1.8364528545823171e-06,0,0,1,9.472836640932127e-06
7202,@congjeffmiller,1,1.8364528545823171e-06,0,0,1,9.472836640932127e-06
7204,fl-01,1,1.8364528545823171e-06,0,0,1,9.472836640932127e-06
7203,@repsoutherland,1,1.8364528545823171e-06,0,0,1,9.472836640932127e-06
7205,fl-02,1,1.8364528545823171e-06,0,0,1,9.472836640932127e-06
7201,@andercrenshaw,1,1.8364528545823171e-06,0,0,1,9.472836640932127e-06
7206,fl-04@reprivera,1,1.8364528545823171e-06,0,0,1,9.472836640932127e-06
7207,fl-25,1,1.8364528545823171e-06,0,0,1,9.472836640932127e-06
7209,voterstweet,1,1.8364528545823171e-06,0,0,1,9.472836640932127e-06
7208,@senrubiopress,1,1.8364528545823171e-06,0,0,1,9.472836640932127e-06
7212,@repjohncampbell,1,1.8364528545823171e-06,0,0,1,9.472836640932127e-06
7214,ca-48@darrellissa,1,1.8364528545823171e-06,0,0,1,9.472836640932127e-06
7215,ca-49,1,1.8364528545823171e-06,0,0,1,9.472836640932127e-06
7210,@bilbrayca50,1,1.8364528545823171e-06,0,0,1,9.472836640932127e-06
7216,ca-50,1,1.8364528545823171e-06,0,0,1,9.472836640932127e-06
7211,@repjeffdenham,1,1.8364528545823171e-06,0,0,1,9.472836640932127e-06
7213,ca-19,1,1.8364528545823171e-06,0,0,1,9.472836640932127e-06
7217,@repedroyce,1,1.8364528545823171e-06,0,0,1,9.472836640932127e-06
7220,ca-40,1,1.8364528545823171e-06,0,0,1,9.472836640932127e-06
7219,@repjerrylewis,1,1.8364528545823171e-06,0,0,1,9.472836640932127e-06
7221,ca-41,1,1.8364528545823171e-06,0,0,1,9.472836640932127e-06
7218,@repgarymiller,1,1.8364528545823171e-06,0,0,1,9.472836640932127e-06
7222,ca-42,1,1.8364528545823171e-06,0,0,1,9.472836640932127e-06
7224,@senjonkyl,1,1.8364528545823171e-06,0,0,1,9.472836640932127e-06
7223,@senjohnmccain,1,1.8364528545823171e-06,0,0,1,9.472836640932127e-06
7233,donow,1,1.8364528545823171e-06,0,0,1,9.472836640932127e-06
7234,fellows,1,1.8364528545823171e-06,0,0,1,9.472836640932127e-06
7237,lesbians,1,1.8364528545823171e-06,0,0,1,9.472836640932127e-06
7241,atlantis,1,1.8364528545823171e-06,0,0,1,9.472836640932127e-06
7249,2-1,1,1.8364528545823171e-06,0,0,1,9.472836640932127e-06
7250,abby,1,1.8364528545823171e-06,0,0,1,9.472836640932127e-06
7251,wambach,1,1.8364528545823171e-06,0,0,1,9.472836640932127e-06
7254,indomitable,1,1.8364528545823171e-06,0,0,1,9.472836640932127e-06
7255,1-0,1,1.8364528545823171e-06,0,0,1,9.472836640932127e-06
7259,perseverance,1,1.8364528545823171e-06,0,0,1,9.472836640932127e-06
7263,lincolns,1,1.8364528545823171e-06,0,0,1,9.472836640932127e-06
7264,campaignso,1,1.8364528545823171e-06,0,0,1,9.472836640932127e-06
7266,axelrod,1,1.8364528545823171e-06,0,0,1,9.472836640932127e-06
7267,forgo,1,1.8364528545823171e-06,0,0,1,9.472836640932127e-06
7271,excitedjohn,1,1.8364528545823171e-06,0,0,1,9.472836640932127e-06
7270,475000,1,1.8364528545823171e-06,0,0,1,9.472836640932127e-06
7274,16th,1,1.8364528545823171e-06,0,0,1,9.472836640932127e-06
7276,440pm,1,1.8364528545823171e-06,0,0,1,9.472836640932127e-06
7280,trim,1,1.8364528545823171e-06,0,0,1,9.472836640932127e-06
7283,923pm,1,1.8364528545823171e-06,0,0,1,9.472836640932127e-06
7286,botswana,1,1.8364528545823171e-06,0,0,1,9.472836640932127e-06
7290,dads,1,1.8364528545823171e-06,0,0,1,9.472836640932127e-06
7293,worryhell,1,1.8364528545823171e-06,0,0,1,9.472836640932127e-06
7291,appearances,1,1.8364528545823171e-06,0,0,1,9.472836640932127e-06
7297,touring,1,1.8364528545823171e-06,0,0,1,9.472836640932127e-06
7295,cree,1,1.8364528545823171e-06,0,0,1,9.472836640932127e-06
7298,#sumorg11,1,1.8364528545823171e-06,0,0,1,9.472836640932127e-06
7300,congresswoman-elect,1,1.8364528545823171e-06,0,0,1,9.472836640932127e-06
7301,hochul,1,1.8364528545823171e-06,0,0,1,9.472836640932127e-06
7304,tornado,1,1.8364528545823171e-06,0,0,1,9.472836640932127e-06
7307,#mespeech,1,1.8364528545823171e-06,0,0,1,9.472836640932127e-06
7311,geraldine,1,1.8364528545823171e-06,0,0,1,9.472836640932127e-06
7310,ferraro,1,1.8364528545823171e-06,0,0,1,9.472836640932127e-06
7314,trailblazer,1,1.8364528545823171e-06,0,0,1,9.472836640932127e-06
7317,santiago,1,1.8364528545823171e-06,0,0,1,9.472836640932127e-06
7315,320pm,1,1.8364528545823171e-06,0,0,1,9.472836640932127e-06
7320,irish-americans,1,1.8364528545823171e-06,0,0,1,9.472836640932127e-06
7326,1230pm,1,1.8364528545823171e-06,0,0,1,9.472836640932127e-06
7330,tsunamis,1,1.8364528545823171e-06,0,0,1,9.472836640932127e-06
7334,503pm,1,1.8364528545823171e-06,0,0,1,9.472836640932127e-06
7337,anyonedemocrat,1,1.8364528545823171e-06,0,0,1,9.472836640932127e-06
7338,congressto,1,1.8364528545823171e-06,0,0,1,9.472836640932127e-06
7339,515pm,1,1.8364528545823171e-06,0,0,1,9.472836640932127e-06
7340,gibbs,1,1.8364528545823171e-06,0,0,1,9.472836640932127e-06
7342,secretaryand,1,1.8364528545823171e-06,0,0,1,9.472836640932127e-06
7344,genuine,1,1.8364528545823171e-06,0,0,1,9.472836640932127e-06
7352,energy-efficient,1,1.8364528545823171e-06,0,0,1,9.472836640932127e-06
7351,cheapest,1,1.8364528545823171e-06,0,0,1,9.472836640932127e-06
7354,futureby,1,1.8364528545823171e-06,0,0,1,9.472836640932127e-06
7361,re-fighting,1,1.8364528545823171e-06,0,0,1,9.472836640932127e-06
7364,informationfrom,1,1.8364528545823171e-06,0,0,1,9.472836640932127e-06
7366,childbecome,1,1.8364528545823171e-06,0,0,1,9.472836640932127e-06
7368,futureif,1,1.8364528545823171e-06,0,0,1,9.472836640932127e-06
7367,americathen,1,1.8364528545823171e-06,0,0,1,9.472836640932127e-06
7369,2035,1,1.8364528545823171e-06,0,0,1,9.472836640932127e-06
7370,sputnik,1,1.8364528545823171e-06,0,0,1,9.472836640932127e-06
7372,dowhat,1,1.8364528545823171e-06,0,0,1,9.472836640932127e-06
7371,anyoneis,1,1.8364528545823171e-06,0,0,1,9.472836640932127e-06
7375,out-innovate,1,1.8364528545823171e-06,0,0,1,9.472836640932127e-06
7374,out-educate,1,1.8364528545823171e-06,0,0,1,9.472836640932127e-06
7373,out-build,1,1.8364528545823171e-06,0,0,1,9.472836640932127e-06
7376,discourage,1,1.8364528545823171e-06,0,0,1,9.472836640932127e-06
7378,knownthe,1,1.8364528545823171e-06,0,0,1,9.472836640932127e-06
7379,allfor,1,1.8364528545823171e-06,0,0,1,9.472836640932127e-06
7382,735pm,1,1.8364528545823171e-06,0,0,1,9.472836640932127e-06
7392,landover,1,1.8364528545823171e-06,0,0,1,9.472836640932127e-06
7393,230pm,1,1.8364528545823171e-06,0,0,1,9.472836640932127e-06
7395,#protectourprogress,1,1.8364528545823171e-06,0,0,1,9.472836640932127e-06
7400,holbrooke,1,1.8364528545823171e-06,0,0,1,9.472836640932127e-06
7401,915am,1,1.8364528545823171e-06,0,0,1,9.472836640932127e-06
7402,tax-cut,1,1.8364528545823171e-06,0,0,1,9.472836640932127e-06
7403,14000,1,1.8364528545823171e-06,0,0,1,9.472836640932127e-06
7404,discharged,1,1.8364528545823171e-06,0,0,1,9.472836640932127e-06
7409,lifts,1,1.8364528545823171e-06,0,0,1,9.472836640932127e-06
7410,candles,1,1.8364528545823171e-06,0,0,1,9.472836640932127e-06
7417,@lacasablanca,1,1.8364528545823171e-06,0,0,1,9.472836640932127e-06
7416,@billburton44,1,1.8364528545823171e-06,0,0,1,9.472836640932127e-06
7418,@macon44,1,1.8364528545823171e-06,0,0,1,9.472836640932127e-06
7421,@whitehouseostp,1,1.8364528545823171e-06,0,0,1,9.472836640932127e-06
7419,@opengov,1,1.8364528545823171e-06,0,0,1,9.472836640932127e-06
7423,relaunches,1,1.8364528545823171e-06,0,0,1,9.472836640932127e-06
7424,earmarksitems,1,1.8364528545823171e-06,0,0,1,9.472836640932127e-06
7427,expectingand,1,1.8364528545823171e-06,0,0,1,9.472836640932127e-06
7428,themis,1,1.8364528545823171e-06,0,0,1,9.472836640932127e-06
7429,friendsi,1,1.8364528545823171e-06,0,0,1,9.472836640932127e-06
7431,beand,1,1.8364528545823171e-06,0,0,1,9.472836640932127e-06
7433,tomorrowsign,1,1.8364528545823171e-06,0,0,1,9.472836640932127e-06
7434,voteif,1,1.8364528545823171e-06,0,0,1,9.472836640932127e-06
7436,upare,1,1.8364528545823171e-06,0,0,1,9.472836640932127e-06
7435,canvasses,1,1.8364528545823171e-06,0,0,1,9.472836640932127e-06
7444,sidelineswith,1,1.8364528545823171e-06,0,0,1,9.472836640932127e-06
7445,electionwe,1,1.8364528545823171e-06,0,0,1,9.472836640932127e-06
7447,bullied,1,1.8364528545823171e-06,0,0,1,9.472836640932127e-06
7446,#itgetsbetter,1,1.8364528545823171e-06,0,0,1,9.472836640932127e-06
7449,overnightbut,1,1.8364528545823171e-06,0,0,1,9.472836640932127e-06
7450,growingwhere,1,1.8364528545823171e-06,0,0,1,9.472836640932127e-06
7453,againreaching,1,1.8364528545823171e-06,0,0,1,9.472836640932127e-06
7456,@timkaine,1,1.8364528545823171e-06,0,0,1,9.472836640932127e-06
7457,dadt,1,1.8364528545823171e-06,0,0,1,9.472836640932127e-06
7463,teaming,1,1.8364528545823171e-06,0,0,1,9.472836640932127e-06
7461,@mtv,1,1.8364528545823171e-06,0,0,1,9.472836640932127e-06
7459,@bet,1,1.8364528545823171e-06,0,0,1,9.472836640932127e-06
7460,@cmtshows,1,1.8364528545823171e-06,0,0,1,9.472836640932127e-06
7464,aunts,1,1.8364528545823171e-06,0,0,1,9.472836640932127e-06
7467,uncles,1,1.8364528545823171e-06,0,0,1,9.472836640932127e-06
7466,themnov,1,1.8364528545823171e-06,0,0,1,9.472836640932127e-06
7469,overcomes,1,1.8364528545823171e-06,0,0,1,9.472836640932127e-06
7471,nowand,1,1.8364528545823171e-06,0,0,1,9.472836640932127e-06
7477,electionswe,1,1.8364528545823171e-06,0,0,1,9.472836640932127e-06
7481,apathy,1,1.8364528545823171e-06,0,0,1,9.472836640932127e-06
7483,echo,1,1.8364528545823171e-06,0,0,1,9.472836640932127e-06
7484,relive,1,1.8364528545823171e-06,0,0,1,9.472836640932127e-06
7486,partwe,1,1.8364528545823171e-06,0,0,1,9.472836640932127e-06
7487,believethat,1,1.8364528545823171e-06,0,0,1,9.472836640932127e-06
7491,325pm,1,1.8364528545823171e-06,0,0,1,9.472836640932127e-06
7496,930am,1,1.8364528545823171e-06,0,0,1,9.472836640932127e-06
7500,quran,1,1.8364528545823171e-06,0,0,1,9.472836640932127e-06
7501,valuesthis,1,1.8364528545823171e-06,0,0,1,9.472836640932127e-06
7502,countryresponsibility,1,1.8364528545823171e-06,0,0,1,9.472836640932127e-06
7506,runwayscreating,1,1.8364528545823171e-06,0,0,1,9.472836640932127e-06
7507,iraqi,1,1.8364528545823171e-06,0,0,1,9.472836640932127e-06
7510,officeand,1,1.8364528545823171e-06,0,0,1,9.472836640932127e-06
7511,blockade,1,1.8364528545823171e-06,0,0,1,9.472836640932127e-06
7515,tragedyand,1,1.8364528545823171e-06,0,0,1,9.472836640932127e-06
7518,deceptive,1,1.8364528545823171e-06,0,0,1,9.472836640932127e-06
7520,gamble,1,1.8364528545823171e-06,0,0,1,9.472836640932127e-06
7522,unshakableall,1,1.8364528545823171e-06,0,0,1,9.472836640932127e-06
7521,faiths,1,1.8364528545823171e-06,0,0,1,9.472836640932127e-06
7523,slips,1,1.8364528545823171e-06,0,0,1,9.472836640932127e-06
7525,160000,1,1.8364528545823171e-06,0,0,1,9.472836640932127e-06
7524,1140,1,1.8364528545823171e-06,0,0,1,9.472836640932127e-06
7526,juncture,1,1.8364528545823171e-06,0,0,1,9.472836640932127e-06
7528,sounder,1,1.8364528545823171e-06,0,0,1,9.472836640932127e-06
7527,footing,1,1.8364528545823171e-06,0,0,1,9.472836640932127e-06
7529,overwhelmed,1,1.8364528545823171e-06,0,0,1,9.472836640932127e-06
7530,112th,1,1.8364528545823171e-06,0,0,1,9.472836640932127e-06
7531,naysayers,1,1.8364528545823171e-06,0,0,1,9.472836640932127e-06
7532,cash-strapped,1,1.8364528545823171e-06,0,0,1,9.472836640932127e-06
7535,doingas,1,1.8364528545823171e-06,0,0,1,9.472836640932127e-06
7536,ushering,1,1.8364528545823171e-06,0,0,1,9.472836640932127e-06
7538,takeovers,1,1.8364528545823171e-06,0,0,1,9.472836640932127e-06
7541,drowned,1,1.8364528545823171e-06,0,0,1,9.472836640932127e-06
7542,desert,1,1.8364528545823171e-06,0,0,1,9.472836640932127e-06
7548,green-car,1,1.8364528545823171e-06,0,0,1,9.472836640932127e-06
7547,batteries,1,1.8364528545823171e-06,0,0,1,9.472836640932127e-06
7554,appealing,1,1.8364528545823171e-06,0,0,1,9.472836640932127e-06
7556,healthcaregov,1,1.8364528545823171e-06,0,0,1,9.472836640932127e-06
7558,1045,1,1.8364528545823171e-06,0,0,1,9.472836640932127e-06
7559,byrds,1,1.8364528545823171e-06,0,0,1,9.472836640932127e-06
7563,medvedev,1,1.8364528545823171e-06,0,0,1,9.472836640932127e-06
7561,@kremlinrussiae,1,1.8364528545823171e-06,0,0,1,9.472836640932127e-06
7565,designate,1,1.8364528545823171e-06,0,0,1,9.472836640932127e-06
7569,dreary,1,1.8364528545823171e-06,0,0,1,9.472836640932127e-06
7570,admiration,1,1.8364528545823171e-06,0,0,1,9.472836640932127e-06
7578,summon,1,1.8364528545823171e-06,0,0,1,9.472836640932127e-06
7582,atideas,1,1.8364528545823171e-06,0,0,1,9.472836640932127e-06
7585,partyas,1,1.8364528545823171e-06,0,0,1,9.472836640932127e-06
7583,fossil,1,1.8364528545823171e-06,0,0,1,9.472836640932127e-06
7584,fuels,1,1.8364528545823171e-06,0,0,1,9.472836640932127e-06
7587,etwatch,1,1.8364528545823171e-06,0,0,1,9.472836640932127e-06
7589,ordeal,1,1.8364528545823171e-06,0,0,1,9.472836640932127e-06
7592,teamyoure,1,1.8364528545823171e-06,0,0,1,9.472836640932127e-06
7596,economynot,1,1.8364528545823171e-06,0,0,1,9.472836640932127e-06
7597,legislationand,1,1.8364528545823171e-06,0,0,1,9.472836640932127e-06
7599,kalamazoo,1,1.8364528545823171e-06,0,0,1,9.472836640932127e-06
7605,resiliency,1,1.8364528545823171e-06,0,0,1,9.472836640932127e-06
7602,fulfills,1,1.8364528545823171e-06,0,0,1,9.472836640932127e-06
7606,back--we,1,1.8364528545823171e-06,0,0,1,9.472836640932127e-06
7609,staked,1,1.8364528545823171e-06,0,0,1,9.472836640932127e-06
7608,backi,1,1.8364528545823171e-06,0,0,1,9.472836640932127e-06
7611,pre-crisis,1,1.8364528545823171e-06,0,0,1,9.472836640932127e-06
7614,1245,1,1.8364528545823171e-06,0,0,1,9.472836640932127e-06
7618,solar-panel,1,1.8364528545823171e-06,0,0,1,9.472836640932127e-06
7617,fremont,1,1.8364528545823171e-06,0,0,1,9.472836640932127e-06
7623,@usgs,1,1.8364528545823171e-06,0,0,1,9.472836640932127e-06
7620,@usdagov,1,1.8364528545823171e-06,0,0,1,9.472836640932127e-06
7625,reformthis,1,1.8364528545823171e-06,0,0,1,9.472836640932127e-06
7627,lieberman,1,1.8364528545823171e-06,0,0,1,9.472836640932127e-06
7630,lobbyist-inspired,1,1.8364528545823171e-06,0,0,1,9.472836640932127e-06
7628,carve-outs,1,1.8364528545823171e-06,0,0,1,9.472836640932127e-06
7632,reform--and,1,1.8364528545823171e-06,0,0,1,9.472836640932127e-06
7635,lena,1,1.8364528545823171e-06,0,0,1,9.472836640932127e-06
7634,horne,1,1.8364528545823171e-06,0,0,1,9.472836640932127e-06
7637,excellence,1,1.8364528545823171e-06,0,0,1,9.472836640932127e-06
7638,lawelena,1,1.8364528545823171e-06,0,0,1,9.472836640932127e-06
7642,hand--we,1,1.8364528545823171e-06,0,0,1,9.472836640932127e-06
7648,#sb1070,1,1.8364528545823171e-06,0,0,1,9.472836640932127e-06
7651,daya,1,1.8364528545823171e-06,0,0,1,9.472836640932127e-06
7654,godmother,1,1.8364528545823171e-06,0,0,1,9.472836640932127e-06
7659,kaczynski,1,1.8364528545823171e-06,0,0,1,9.472836640932127e-06
7664,refundssee,1,1.8364528545823171e-06,0,0,1,9.472836640932127e-06
7668,bombings,1,1.8364528545823171e-06,0,0,1,9.472836640932127e-06
7673,possiblethis,1,1.8364528545823171e-06,0,0,1,9.472836640932127e-06
7674,1115,1,1.8364528545823171e-06,0,0,1,9.472836640932127e-06
7675,ithelp,1,1.8364528545823171e-06,0,0,1,9.472836640932127e-06
7676,century-long,1,1.8364528545823171e-06,0,0,1,9.472836640932127e-06
7677,culminate,1,1.8364528545823171e-06,0,0,1,9.472836640932127e-06
7680,prescriptions,1,1.8364528545823171e-06,0,0,1,9.472836640932127e-06
7684,arcadia,1,1.8364528545823171e-06,0,0,1,9.472836640932127e-06
7683,1100am,1,1.8364528545823171e-06,0,0,1,9.472836640932127e-06
7685,todayits,1,1.8364528545823171e-06,0,0,1,9.472836640932127e-06
7687,arne,1,1.8364528545823171e-06,0,0,1,9.472836640932127e-06
7688,duncan,1,1.8364528545823171e-06,0,0,1,9.472836640932127e-06
7686,530pm,1,1.8364528545823171e-06,0,0,1,9.472836640932127e-06
7690,congratulationsto,1,1.8364528545823171e-06,0,0,1,9.472836640932127e-06
7689,competed,1,1.8364528545823171e-06,0,0,1,9.472836640932127e-06
7691,olympicsand,1,1.8364528545823171e-06,0,0,1,9.472836640932127e-06
7693,chilean,1,1.8364528545823171e-06,0,0,1,9.472836640932127e-06
7696,washingtonsee,1,1.8364528545823171e-06,0,0,1,9.472836640932127e-06
7698,morejoin,1,1.8364528545823171e-06,0,0,1,9.472836640932127e-06
7697,2pm,1,1.8364528545823171e-06,0,0,1,9.472836640932127e-06
7699,billstime,1,1.8364528545823171e-06,0,0,1,9.472836640932127e-06
7709,vancouver,1,1.8364528545823171e-06,0,0,1,9.472836640932127e-06
7710,alarming,1,1.8364528545823171e-06,0,0,1,9.472836640932127e-06
7711,studyhealth,1,1.8364528545823171e-06,0,0,1,9.472836640932127e-06
7712,@thejointstaff,1,1.8364528545823171e-06,0,0,1,9.472836640932127e-06
7713,homosexuals,1,1.8364528545823171e-06,0,0,1,9.472836640932127e-06
7714,#questiontime,1,1.8364528545823171e-06,0,0,1,9.472836640932127e-06
7716,follow-up,1,1.8364528545823171e-06,0,0,1,9.472836640932127e-06
7715,@youtube,1,1.8364528545823171e-06,0,0,1,9.472836640932127e-06
7717,classadd,1,1.8364528545823171e-06,0,0,1,9.472836640932127e-06
7719,momentto,1,1.8364528545823171e-06,0,0,1,9.472836640932127e-06
7718,anew,1,1.8364528545823171e-06,0,0,1,9.472836640932127e-06
7722,stirs,1,1.8364528545823171e-06,0,0,1,9.472836640932127e-06
7721,passions,1,1.8364528545823171e-06,0,0,1,9.472836640932127e-06
7720,controversythats,1,1.8364528545823171e-06,0,0,1,9.472836640932127e-06
7724,anti-poverty,1,1.8364528545823171e-06,0,0,1,9.472836640932127e-06
7725,deposits,1,1.8364528545823171e-06,0,0,1,9.472836640932127e-06
7727,canal,1,1.8364528545823171e-06,0,0,1,9.472836640932127e-06
7728,populari,1,1.8364528545823171e-06,0,0,1,9.472836640932127e-06
7732,plouffes,1,1.8364528545823171e-06,0,0,1,9.472836640932127e-06
7733,youon,1,1.8364528545823171e-06,0,0,1,9.472836640932127e-06
7735,forceful,1,1.8364528545823171e-06,0,0,1,9.472836640932127e-06
7736,medalone,1,1.8364528545823171e-06,0,0,1,9.472836640932127e-06
7739,photographer,1,1.8364528545823171e-06,0,0,1,9.472836640932127e-06
7740,souza,1,1.8364528545823171e-06,0,0,1,9.472836640932127e-06
7742,discontent,1,1.8364528545823171e-06,0,0,1,9.472836640932127e-06
7741,changea,1,1.8364528545823171e-06,0,0,1,9.472836640932127e-06
7747,todaytell,1,1.8364528545823171e-06,0,0,1,9.472836640932127e-06
7751,#mlk,1,1.8364528545823171e-06,0,0,1,9.472836640932127e-06
7753,actionjoin,1,1.8364528545823171e-06,0,0,1,9.472836640932127e-06
7758,preval,1,1.8364528545823171e-06,0,0,1,9.472836640932127e-06
7756,#haiti,1,1.8364528545823171e-06,0,0,1,9.472836640932127e-06
7757,haitian,1,1.8364528545823171e-06,0,0,1,9.472836640932127e-06
7759,#haitiwatch,1,1.8364528545823171e-06,0,0,1,9.472836640932127e-06
7761,eluded,1,1.8364528545823171e-06,0,0,1,9.472836640932127e-06
7764,discussionstoday,1,1.8364528545823171e-06,0,0,1,9.472836640932127e-06
7765,rhodes,1,1.8364528545823171e-06,0,0,1,9.472836640932127e-06
7766,sebelius,1,1.8364528545823171e-06,0,0,1,9.472836640932127e-06
7769,@senchrisdodd,1,1.8364528545823171e-06,0,0,1,9.472836640932127e-06
7776,1008426,1,1.8364528545823171e-06,0,0,1,9.472836640932127e-06
7778,stakes,1,1.8364528545823171e-06,0,0,1,9.472836640932127e-06
7779,personalize,1,1.8364528545823171e-06,0,0,1,9.472836640932127e-06
7780,resisted,1,1.8364528545823171e-06,0,0,1,9.472836640932127e-06
7782,thisvicki,1,1.8364528545823171e-06,0,0,1,9.472836640932127e-06
7783,seriousness,1,1.8364528545823171e-06,0,0,1,9.472836640932127e-06
7784,washingtonnot,1,1.8364528545823171e-06,0,0,1,9.472836640932127e-06
7785,850k,1,1.8364528545823171e-06,0,0,1,9.472836640932127e-06
7786,switchboard,1,1.8364528545823171e-06,0,0,1,9.472836640932127e-06
7793,begintune,1,1.8364528545823171e-06,0,0,1,9.472836640932127e-06
7794,luckiest,1,1.8364528545823171e-06,0,0,1,9.472836640932127e-06
7796,copenhagen,1,1.8364528545823171e-06,0,0,1,9.472836640932127e-06
7801,singh,1,1.8364528545823171e-06,0,0,1,9.472836640932127e-06
7803,unveiled,1,1.8364528545823171e-06,0,0,1,9.472836640932127e-06
7806,#forthood,1,1.8364528545823171e-06,0,0,1,9.472836640932127e-06
7808,@jimoberstar,1,1.8364528545823171e-06,0,0,1,9.472836640932127e-06
7809,@kendrickbmeek,1,1.8364528545823171e-06,0,0,1,9.472836640932127e-06
7810,@repblumenauer,1,1.8364528545823171e-06,0,0,1,9.472836640932127e-06
7811,@timryan,1,1.8364528545823171e-06,0,0,1,9.472836640932127e-06
7813,timethe,1,1.8364528545823171e-06,0,0,1,9.472836640932127e-06
7816,paid-for,1,1.8364528545823171e-06,0,0,1,9.472836640932127e-06
7819,226317,1,1.8364528545823171e-06,0,0,1,9.472836640932127e-06
7821,mislead,1,1.8364528545823171e-06,0,0,1,9.472836640932127e-06
7823,youbut,1,1.8364528545823171e-06,0,0,1,9.472836640932127e-06
7820,mirrors,1,1.8364528545823171e-06,0,0,1,9.472836640932127e-06
7824,stepbut,1,1.8364528545823171e-06,0,0,1,9.472836640932127e-06
7825,helphost,1,1.8364528545823171e-06,0,0,1,9.472836640932127e-06
7828,reformlets,1,1.8364528545823171e-06,0,0,1,9.472836640932127e-06
7830,newshouse,1,1.8364528545823171e-06,0,0,1,9.472836640932127e-06
7829,1960s,1,1.8364528545823171e-06,0,0,1,9.472836640932127e-06
7832,calculation,1,1.8364528545823171e-06,0,0,1,9.472836640932127e-06
7833,cost…less,1,1.8364528545823171e-06,0,0,1,9.472836640932127e-06
7837,bickering,1,1.8364528545823171e-06,0,0,1,9.472836640932127e-06
7839,schoolwatch,1,1.8364528545823171e-06,0,0,1,9.472836640932127e-06
7843,kennedya,1,1.8364528545823171e-06,0,0,1,9.472836640932127e-06
7842,colleague,1,1.8364528545823171e-06,0,0,1,9.472836640932127e-06
7845,plug,1,1.8364528545823171e-06,0,0,1,9.472836640932127e-06
7844,grandma,1,1.8364528545823171e-06,0,0,1,9.472836640932127e-06
7847,learnshare,1,1.8364528545823171e-06,0,0,1,9.472836640932127e-06
7850,primetime,1,1.8364528545823171e-06,0,0,1,9.472836640932127e-06
7851,chu,1,1.8364528545823171e-06,0,0,1,9.472836640932127e-06
7853,#nhtd09,1,1.8364528545823171e-06,0,0,1,9.472836640932127e-06
7855,#healthcare09,1,1.8364528545823171e-06,0,0,1,9.472836640932127e-06
7856,news--,1,1.8364528545823171e-06,0,0,1,9.472836640932127e-06
7857,pharmaceuticals,1,1.8364528545823171e-06,0,0,1,9.472836640932127e-06
7859,tobacco,1,1.8364528545823171e-06,0,0,1,9.472836640932127e-06
7861,fatherhood,1,1.8364528545823171e-06,0,0,1,9.472836640932127e-06
7860,#fathersday,1,1.8364528545823171e-06,0,0,1,9.472836640932127e-06
7862,colberts,1,1.8364528545823171e-06,0,0,1,9.472836640932127e-06
7864,head-shave,1,1.8364528545823171e-06,0,0,1,9.472836640932127e-06
7868,fractured,1,1.8364528545823171e-06,0,0,1,9.472836640932127e-06
7867,ankle,1,1.8364528545823171e-06,0,0,1,9.472836640932127e-06
7870,cairo,1,1.8364528545823171e-06,0,0,1,9.472836640932127e-06
7875,1215,1,1.8364528545823171e-06,0,0,1,9.472836640932127e-06
7897,megyn,1,1.8364528545823171e-06,1,2.2780963315814773e-06,0,0
7905,@seanduffywi,1,1.8364528545823171e-06,1,2.2780963315814773e-06,0,0
7914,verifiably,1,1.8364528545823171e-06,1,2.2780963315814773e-06,0,0
7912,minuses,1,1.8364528545823171e-06,1,2.2780963315814773e-06,0,0
7918,thwart,1,1.8364528545823171e-06,1,2.2780963315814773e-06,0,0
7927,libertarians,1,1.8364528545823171e-06,1,2.2780963315814773e-06,0,0
7933,@pfizer,1,1.8364528545823171e-06,1,2.2780963315814773e-06,0,0
7954,hotly,1,1.8364528545823171e-06,1,2.2780963315814773e-06,0,0
7956,historians,1,1.8364528545823171e-06,1,2.2780963315814773e-06,0,0
7955,discoveries,1,1.8364528545823171e-06,1,2.2780963315814773e-06,0,0
7976,deletes,1,1.8364528545823171e-06,1,2.2780963315814773e-06,0,0
7985,strongholds,1,1.8364528545823171e-06,1,2.2780963315814773e-06,0,0
7980,@rickallen,1,1.8364528545823171e-06,1,2.2780963315814773e-06,0,0
7991,inundated,1,1.8364528545823171e-06,1,2.2780963315814773e-06,0,0
8015,congressman-elect,1,1.8364528545823171e-06,1,2.2780963315814773e-06,0,0
8032,tabulations,1,1.8364528545823171e-06,1,2.2780963315814773e-06,0,0
8036,statehouse,1,1.8364528545823171e-06,1,2.2780963315814773e-06,0,0
8043,three-day,1,1.8364528545823171e-06,1,2.2780963315814773e-06,0,0
8048,lategreat,1,1.8364528545823171e-06,1,2.2780963315814773e-06,0,0
8054,@justinhart,1,1.8364528545823171e-06,1,2.2780963315814773e-06,0,0
8057,#happybirthdaymarines,1,1.8364528545823171e-06,1,2.2780963315814773e-06,0,0
8066,slaughtering,1,1.8364528545823171e-06,1,2.2780963315814773e-06,0,0
8074,decertify,1,1.8364528545823171e-06,1,2.2780963315814773e-06,0,0
8073,certifying,1,1.8364528545823171e-06,1,2.2780963315814773e-06,0,0
8078,coordinates,1,1.8364528545823171e-06,1,2.2780963315814773e-06,0,0
8099,mastriano,1,1.8364528545823171e-06,1,2.2780963315814773e-06,0,0
8101,uploaded,1,1.8364528545823171e-06,1,2.2780963315814773e-06,0,0
8100,upload,1,1.8364528545823171e-06,1,2.2780963315814773e-06,0,0
8114,scoundrels,1,1.8364528545823171e-06,1,2.2780963315814773e-06,0,0
8115,toying,1,1.8364528545823171e-06,1,2.2780963315814773e-06,0,0
8118,subversion,1,1.8364528545823171e-06,1,2.2780963315814773e-06,0,0
8121,fraudmultiple,1,1.8364528545823171e-06,1,2.2780963315814773e-06,0,0
8120,electioncall,1,1.8364528545823171e-06,1,2.2780963315814773e-06,0,0
8130,#voteearlyday,1,1.8364528545823171e-06,1,2.2780963315814773e-06,0,0
8138,turnshattering,1,1.8364528545823171e-06,1,2.2780963315814773e-06,0,0
8137,raked,1,1.8364528545823171e-06,1,2.2780963315814773e-06,0,0
8143,37th,1,1.8364528545823171e-06,1,2.2780963315814773e-06,0,0
8148,epidemics,1,1.8364528545823171e-06,1,2.2780963315814773e-06,0,0
8150,pandemics,1,1.8364528545823171e-06,1,2.2780963315814773e-06,0,0
8157,unceremoniously,1,1.8364528545823171e-06,1,2.2780963315814773e-06,0,0
8178,wreaths,1,1.8364528545823171e-06,1,2.2780963315814773e-06,0,0
8180,improprieties,1,1.8364528545823171e-06,1,2.2780963315814773e-06,0,0
8184,maga-gras,1,1.8364528545823171e-06,1,2.2780963315814773e-06,0,0
8186,dogged,1,1.8364528545823171e-06,1,2.2780963315814773e-06,0,0
8216,partnered,1,1.8364528545823171e-06,1,2.2780963315814773e-06,0,0
8219,incompetents,1,1.8364528545823171e-06,1,2.2780963315814773e-06,0,0
8229,unsolvable,1,1.8364528545823171e-06,1,2.2780963315814773e-06,0,0
8230,@abc@washingtonpost,1,1.8364528545823171e-06,1,2.2780963315814773e-06,0,0
8231,deplorable,1,1.8364528545823171e-06,1,2.2780963315814773e-06,0,0
8241,rabbis,1,1.8364528545823171e-06,1,2.2780963315814773e-06,0,0
8243,hopkins,1,1.8364528545823171e-06,1,2.2780963315814773e-06,0,0
8245,recants,1,1.8364528545823171e-06,1,2.2780963315814773e-06,0,0
8242,ballot-tampering,1,1.8364528545823171e-06,1,2.2780963315814773e-06,0,0
8253,armenian,1,1.8364528545823171e-06,1,2.2780963315814773e-06,0,0
8258,nikol,1,1.8364528545823171e-06,1,2.2780963315814773e-06,0,0
8259,pashinyan,1,1.8364528545823171e-06,1,2.2780963315814773e-06,0,0
8254,azerbaijani,1,1.8364528545823171e-06,1,2.2780963315814773e-06,0,0
8257,ilham,1,1.8364528545823171e-06,1,2.2780963315814773e-06,0,0
8252,aliyev,1,1.8364528545823171e-06,1,2.2780963315814773e-06,0,0
8251,adhere,1,1.8364528545823171e-06,1,2.2780963315814773e-06,0,0
8255,biegun,1,1.8364528545823171e-06,1,2.2780963315814773e-06,0,0
8269,@pastordscotts,1,1.8364528545823171e-06,1,2.2780963315814773e-06,0,0
8272,1126940,1,1.8364528545823171e-06,1,2.2780963315814773e-06,0,0
8280,breitbartnews,1,1.8364528545823171e-06,1,2.2780963315814773e-06,0,0
8292,81000,1,1.8364528545823171e-06,1,2.2780963315814773e-06,0,0
8302,ammar,1,1.8364528545823171e-06,1,2.2780963315814773e-06,0,0
8307,#1-,1,1.8364528545823171e-06,1,2.2780963315814773e-06,0,0
8310,139m,1,1.8364528545823171e-06,1,2.2780963315814773e-06,0,0
8311,@neworleansrta,1,1.8364528545823171e-06,1,2.2780963315814773e-06,0,0
8313,fleet,1,1.8364528545823171e-06,1,2.2780963315814773e-06,0,0
8323,satellite,1,1.8364528545823171e-06,1,2.2780963315814773e-06,0,0
8330,@jimoberweis,1,1.8364528545823171e-06,1,2.2780963315814773e-06,0,0
8329,#il14,1,1.8364528545823171e-06,1,2.2780963315814773e-06,0,0
8336,esshaki,1,1.8364528545823171e-06,1,2.2780963315814773e-06,0,0
8333,@esshakicongress,1,1.8364528545823171e-06,1,2.2780963315814773e-06,0,0
8334,chaldean,1,1.8364528545823171e-06,1,2.2780963315814773e-06,0,0
8332,#mi11,1,1.8364528545823171e-06,1,2.2780963315814773e-06,0,0
8343,drtony,1,1.8364528545823171e-06,1,2.2780963315814773e-06,0,0
8347,335,1,1.8364528545823171e-06,1,2.2780963315814773e-06,0,0
8348,deposited,1,1.8364528545823171e-06,1,2.2780963315814773e-06,0,0
8349,sponsors,1,1.8364528545823171e-06,1,2.2780963315814773e-06,0,0
8352,@maggienyt,1,1.8364528545823171e-06,1,2.2780963315814773e-06,0,0
8354,boffo,1,1.8364528545823171e-06,1,2.2780963315814773e-06,0,0
8360,industrythat,1,1.8364528545823171e-06,1,2.2780963315814773e-06,0,0
8368,prescott,1,1.8364528545823171e-06,1,2.2780963315814773e-06,0,0
8370,frivolous,1,1.8364528545823171e-06,1,2.2780963315814773e-06,0,0
8373,ghost,1,1.8364528545823171e-06,1,2.2780963315814773e-06,0,0
8374,luster,1,1.8364528545823171e-06,1,2.2780963315814773e-06,0,0
8380,sunk,1,1.8364528545823171e-06,1,2.2780963315814773e-06,0,0
8393,lahood,1,1.8364528545823171e-06,1,2.2780963315814773e-06,0,0
8388,@electlahood,1,1.8364528545823171e-06,1,2.2780963315814773e-06,0,0
8387,#il18,1,1.8364528545823171e-06,1,2.2780963315814773e-06,0,0
8398,buck,1,1.8364528545823171e-06,1,2.2780963315814773e-06,0,0
8396,@buckforcolorado,1,1.8364528545823171e-06,1,2.2780963315814773e-06,0,0
8395,#co04,1,1.8364528545823171e-06,1,2.2780963315814773e-06,0,0
8402,cindys,1,1.8364528545823171e-06,1,2.2780963315814773e-06,0,0
8403,espy,1,1.8364528545823171e-06,1,2.2780963315814773e-06,0,0
8399,#mssen,1,1.8364528545823171e-06,1,2.2780963315814773e-06,0,0
8407,championships,1,1.8364528545823171e-06,1,2.2780963315814773e-06,0,0
8410,litigations,1,1.8364528545823171e-06,1,2.2780963315814773e-06,0,0
8416,q3,1,1.8364528545823171e-06,1,2.2780963315814773e-06,0,0
8424,alter,1,1.8364528545823171e-06,1,2.2780963315814773e-06,0,0
8429,martinsburg,1,1.8364528545823171e-06,1,2.2780963315814773e-06,0,0
8435,numbersshould,1,1.8364528545823171e-06,1,2.2780963315814773e-06,0,0
8437,down-ballot,1,1.8364528545823171e-06,1,2.2780963315814773e-06,0,0
8438,statehouses,1,1.8364528545823171e-06,1,2.2780963315814773e-06,0,0
8451,religous,1,1.8364528545823171e-06,1,2.2780963315814773e-06,0,0
8458,riding,1,1.8364528545823171e-06,1,2.2780963315814773e-06,0,0
8461,74000000,1,1.8364528545823171e-06,1,2.2780963315814773e-06,0,0
8468,overrule,1,1.8364528545823171e-06,1,2.2780963315814773e-06,0,0
8467,obstinate,1,1.8364528545823171e-06,1,2.2780963315814773e-06,0,0
8465,goldmine,1,1.8364528545823171e-06,1,2.2780963315814773e-06,0,0
8473,pennsylvaniaa,1,1.8364528545823171e-06,1,2.2780963315814773e-06,0,0
8477,143379,1,1.8364528545823171e-06,1,2.2780963315814773e-06,0,0
8478,342am,1,1.8364528545823171e-06,1,2.2780963315814773e-06,0,0
8481,warp,1,1.8364528545823171e-06,1,2.2780963315814773e-06,0,0
8484,uncounted,1,1.8364528545823171e-06,1,2.2780963315814773e-06,0,0
8485,giancarlo,1,1.8364528545823171e-06,1,2.2780963315814773e-06,0,0
8486,lititz,1,1.8364528545823171e-06,1,2.2780963315814773e-06,0,0
8502,disenfranchised,1,1.8364528545823171e-06,1,2.2780963315814773e-06,0,0
8511,@eamonjavers,1,1.8364528545823171e-06,1,2.2780963315814773e-06,0,0
8513,awhile,1,1.8364528545823171e-06,1,2.2780963315814773e-06,0,0
8520,anti-globalism,1,1.8364528545823171e-06,1,2.2780963315814773e-06,0,0
8521,pro-police,1,1.8364528545823171e-06,1,2.2780963315814773e-06,0,0
8534,oblivion,1,1.8364528545823171e-06,1,2.2780963315814773e-06,0,0
8536,preliminarily,1,1.8364528545823171e-06,1,2.2780963315814773e-06,0,0
8537,collapsed,1,1.8364528545823171e-06,1,2.2780963315814773e-06,0,0
8542,221000,1,1.8364528545823171e-06,1,2.2780963315814773e-06,0,0
8545,941000,1,1.8364528545823171e-06,1,2.2780963315814773e-06,0,0
8544,435000,1,1.8364528545823171e-06,1,2.2780963315814773e-06,0,0
8551,pollwatchers,1,1.8364528545823171e-06,1,2.2780963315814773e-06,0,0
8555,inspection,1,1.8364528545823171e-06,1,2.2780963315814773e-06,0,0
8556,sealed,1,1.8364528545823171e-06,1,2.2780963315814773e-06,0,0
8553,containers,1,1.8364528545823171e-06,1,2.2780963315814773e-06,0,0
8562,stench,1,1.8364528545823171e-06,1,2.2780963315814773e-06,0,0
8565,second-class,1,1.8364528545823171e-06,1,2.2780963315814773e-06,0,0
8566,preaching,1,1.8364528545823171e-06,1,2.2780963315814773e-06,0,0
8568,120000and,1,1.8364528545823171e-06,1,2.2780963315814773e-06,0,0
8569,@victoensing,1,1.8364528545823171e-06,1,2.2780963315814773e-06,0,0
8573,heartwarming,1,1.8364528545823171e-06,1,2.2780963315814773e-06,0,0
8574,organic,1,1.8364528545823171e-06,1,2.2780963315814773e-06,0,0
8575,springing,1,1.8364528545823171e-06,1,2.2780963315814773e-06,0,0
8581,schoolnow,1,1.8364528545823171e-06,1,2.2780963315814773e-06,0,0
8580,datathe,1,1.8364528545823171e-06,1,2.2780963315814773e-06,0,0
8584,joecks,1,1.8364528545823171e-06,1,2.2780963315814773e-06,0,0
8586,coldcasejoe,1,1.8364528545823171e-06,1,2.2780963315814773e-06,0,0
8587,@senatorloeffler,1,1.8364528545823171e-06,1,2.2780963315814773e-06,0,0
8600,amistad,1,1.8364528545823171e-06,1,2.2780963315814773e-06,0,0
8602,190593,1,1.8364528545823171e-06,1,2.2780963315814773e-06,0,0
8605,989,1,1.8364528545823171e-06,1,2.2780963315814773e-06,0,0
8604,2181,1,1.8364528545823171e-06,1,2.2780963315814773e-06,0,0
8603,192774,1,1.8364528545823171e-06,1,2.2780963315814773e-06,0,0
8606,@gregkellyusa,1,1.8364528545823171e-06,1,2.2780963315814773e-06,0,0
8612,morgana,1,1.8364528545823171e-06,1,2.2780963315814773e-06,0,0
8613,subcontractor,1,1.8364528545823171e-06,1,2.2780963315814773e-06,0,0
8619,tenney,1,1.8364528545823171e-06,1,2.2780963315814773e-06,0,0
8623,jonesboro,1,1.8364528545823171e-06,1,2.2780963315814773e-06,0,0
8626,ferociously,1,1.8364528545823171e-06,1,2.2780963315814773e-06,0,0
8644,lansing,1,1.8364528545823171e-06,1,2.2780963315814773e-06,0,0
8647,salem,1,1.8364528545823171e-06,1,2.2780963315814773e-06,0,0
8650,unequivocally,1,1.8364528545823171e-06,1,2.2780963315814773e-06,0,0
8649,resolute,1,1.8364528545823171e-06,1,2.2780963315814773e-06,0,0
8662,statistician,1,1.8364528545823171e-06,1,2.2780963315814773e-06,0,0
8659,baris,1,1.8364528545823171e-06,1,2.2780963315814773e-06,0,0
8660,disputed,1,1.8364528545823171e-06,1,2.2780963315814773e-06,0,0
8664,wrongthink,1,1.8364528545823171e-06,1,2.2780963315814773e-06,0,0
8668,morano,1,1.8364528545823171e-06,1,2.2780963315814773e-06,0,0
8675,herald,1,1.8364528545823171e-06,1,2.2780963315814773e-06,0,0
8677,mcadams,1,1.8364528545823171e-06,1,2.2780963315814773e-06,0,0
8686,suckers,1,1.8364528545823171e-06,1,2.2780963315814773e-06,0,0
8683,fabricator,1,1.8364528545823171e-06,1,2.2780963315814773e-06,0,0
8687,muskegon,1,1.8364528545823171e-06,1,2.2780963315814773e-06,0,0
8689,fog,1,1.8364528545823171e-06,1,2.2780963315814773e-06,0,0
8692,gracefully,1,1.8364528545823171e-06,1,2.2780963315814773e-06,0,0
8697,inglorious,1,1.8364528545823171e-06,1,2.2780963315814773e-06,0,0
8708,michiganleaving,1,1.8364528545823171e-06,1,2.2780963315814773e-06,0,0
8726,confiding,1,1.8364528545823171e-06,1,2.2780963315814773e-06,0,0
8735,shuts,1,1.8364528545823171e-06,1,2.2780963315814773e-06,0,0
8732,@thebabylonbee,1,1.8364528545823171e-06,1,2.2780963315814773e-06,0,0
8737,lufkin,1,1.8364528545823171e-06,1,2.2780963315814773e-06,0,0
8736,climber,1,1.8364528545823171e-06,1,2.2780963315814773e-06,0,0
8740,@genflynn,1,1.8364528545823171e-06,1,2.2780963315814773e-06,0,0
8751,90000,1,1.8364528545823171e-06,1,2.2780963315814773e-06,0,0
8769,spearheading,1,1.8364528545823171e-06,1,2.2780963315814773e-06,0,0
8770,toensing,1,1.8364528545823171e-06,1,2.2780963315814773e-06,0,0
8777,wisconsinif,1,1.8364528545823171e-06,1,2.2780963315814773e-06,0,0
8780,pave,1,1.8364528545823171e-06,1,2.2780963315814773e-06,0,0
8784,eliminates,1,1.8364528545823171e-06,1,2.2780963315814773e-06,0,0
8789,rakes,1,1.8364528545823171e-06,1,2.2780963315814773e-06,0,0
8795,blockbuster,1,1.8364528545823171e-06,1,2.2780963315814773e-06,0,0
8800,organically,1,1.8364528545823171e-06,1,2.2780963315814773e-06,0,0
8802,@coachlouholtz88,1,1.8364528545823171e-06,1,2.2780963315814773e-06,0,0
8806,pro-biden,1,1.8364528545823171e-06,1,2.2780963315814773e-06,0,0
8803,25-500,1,1.8364528545823171e-06,1,2.2780963315814773e-06,0,0
8804,jewelry,1,1.8364528545823171e-06,1,2.2780963315814773e-06,0,0
8813,scanned,1,1.8364528545823171e-06,1,2.2780963315814773e-06,0,0
8814,42248,1,1.8364528545823171e-06,1,2.2780963315814773e-06,0,0
8817,@alfredenewman1,1,1.8364528545823171e-06,1,2.2780963315814773e-06,0,0
8821,deceased,1,1.8364528545823171e-06,1,2.2780963315814773e-06,0,0
8827,prohibited,1,1.8364528545823171e-06,1,2.2780963315814773e-06,0,0
8830,glimpse,1,1.8364528545823171e-06,1,2.2780963315814773e-06,0,0
8832,underwaylets,1,1.8364528545823171e-06,1,2.2780963315814773e-06,0,0
8836,strangulation,1,1.8364528545823171e-06,1,2.2780963315814773e-06,0,0
8833,@stevekalayjian,1,1.8364528545823171e-06,1,2.2780963315814773e-06,0,0
8848,bum,1,1.8364528545823171e-06,1,2.2780963315814773e-06,0,0
8852,mechanical,1,1.8364528545823171e-06,1,2.2780963315814773e-06,0,0
8854,#ndaa,1,1.8364528545823171e-06,1,2.2780963315814773e-06,0,0
8857,alyssa,1,1.8364528545823171e-06,1,2.2780963315814773e-06,0,0
8860,stronghold,1,1.8364528545823171e-06,1,2.2780963315814773e-06,0,0
8862,desecration,1,1.8364528545823171e-06,1,2.2780963315814773e-06,0,0
8872,bidenim,1,1.8364528545823171e-06,1,2.2780963315814773e-06,0,0
8876,wretched,1,1.8364528545823171e-06,1,2.2780963315814773e-06,0,0
8875,valuesget,1,1.8364528545823171e-06,1,2.2780963315814773e-06,0,0
8886,sullen,1,1.8364528545823171e-06,1,2.2780963315814773e-06,0,0
8882,dull,1,1.8364528545823171e-06,1,2.2780963315814773e-06,0,0
8892,fann,1,1.8364528545823171e-06,1,2.2780963315814773e-06,0,0
8894,russell,1,1.8364528545823171e-06,1,2.2780963315814773e-06,0,0
8891,bowers,1,1.8364528545823171e-06,1,2.2780963315814773e-06,0,0
8901,trump-supporters,1,1.8364528545823171e-06,1,2.2780963315814773e-06,0,0
8897,gauntlet,1,1.8364528545823171e-06,1,2.2780963315814773e-06,0,0
8900,stalked,1,1.8364528545823171e-06,1,2.2780963315814773e-06,0,0
8903,@sept11memorial,1,1.8364528545823171e-06,1,2.2780963315814773e-06,0,0
8909,valdosta,1,1.8364528545823171e-06,1,2.2780963315814773e-06,0,0
8910,sticks,1,1.8364528545823171e-06,1,2.2780963315814773e-06,0,0
8917,slashing,1,1.8364528545823171e-06,1,2.2780963315814773e-06,0,0
8914,offshoring,1,1.8364528545823171e-06,1,2.2780963315814773e-06,0,0
8916,shredding,1,1.8364528545823171e-06,1,2.2780963315814773e-06,0,0
8918,@davejoyceoh14,1,1.8364528545823171e-06,1,2.2780963315814773e-06,0,0
8919,notrend,1,1.8364528545823171e-06,1,2.2780963315814773e-06,0,0
8923,unconstitutionality,1,1.8364528545823171e-06,1,2.2780963315814773e-06,0,0
8930,screening,1,1.8364528545823171e-06,1,2.2780963315814773e-06,0,0
8928,boarding,1,1.8364528545823171e-06,1,2.2780963315814773e-06,0,0
8929,screened,1,1.8364528545823171e-06,1,2.2780963315814773e-06,0,0
8924,@cdcdirector,1,1.8364528545823171e-06,1,2.2780963315814773e-06,0,0
8934,safeguarding,1,1.8364528545823171e-06,1,2.2780963315814773e-06,0,0
8936,ascend,1,1.8364528545823171e-06,1,2.2780963315814773e-06,0,0
8942,joko,1,1.8364528545823171e-06,1,2.2780963315814773e-06,0,0
8945,widodo,1,1.8364528545823171e-06,1,2.2780963315814773e-06,0,0
8946,@donnashalala,1,1.8364528545823171e-06,1,2.2780963315814773e-06,0,0
8965,fuentes,1,1.8364528545823171e-06,1,2.2780963315814773e-06,0,0
8974,curate,1,1.8364528545823171e-06,1,2.2780963315814773e-06,0,0
8976,trus,1,1.8364528545823171e-06,1,2.2780963315814773e-06,0,0
8980,teachingunderstanding,1,1.8364528545823171e-06,1,2.2780963315814773e-06,0,0
8977,distasteful,1,1.8364528545823171e-06,1,2.2780963315814773e-06,0,0
8979,lest,1,1.8364528545823171e-06,1,2.2780963315814773e-06,0,0
8981,#transparency,1,1.8364528545823171e-06,1,2.2780963315814773e-06,0,0
8984,@gwkohn1,1,1.8364528545823171e-06,1,2.2780963315814773e-06,0,0
8985,@steverefresh,1,1.8364528545823171e-06,1,2.2780963315814773e-06,0,0
8986,creepy,1,1.8364528545823171e-06,1,2.2780963315814773e-06,0,0
8988,edward,1,1.8364528545823171e-06,1,2.2780963315814773e-06,0,0
8999,127,1,1.8364528545823171e-06,1,2.2780963315814773e-06,0,0
8998,1231,1,1.8364528545823171e-06,1,2.2780963315814773e-06,0,0
9000,@andersoncooper,1,1.8364528545823171e-06,1,2.2780963315814773e-06,0,0
9005,sens,1,1.8364528545823171e-06,1,2.2780963315814773e-06,0,0
9015,politicianif,1,1.8364528545823171e-06,1,2.2780963315814773e-06,0,0
9017,winsand,1,1.8364528545823171e-06,1,2.2780963315814773e-06,0,0
9019,melissa,1,1.8364528545823171e-06,1,2.2780963315814773e-06,0,0
9032,terror-compromised,1,1.8364528545823171e-06,1,2.2780963315814773e-06,0,0
9028,pennsylvaniaburdening,1,1.8364528545823171e-06,1,2.2780963315814773e-06,0,0
9036,robbers,1,1.8364528545823171e-06,1,2.2780963315814773e-06,0,0
9035,rapists,1,1.8364528545823171e-06,1,2.2780963315814773e-06,0,0
9062,restricts,1,1.8364528545823171e-06,1,2.2780963315814773e-06,0,0
9064,citiesthey,1,1.8364528545823171e-06,1,2.2780963315814773e-06,0,0
9066,suburb,1,1.8364528545823171e-06,1,2.2780963315814773e-06,0,0
9069,nicklaus,1,1.8364528545823171e-06,1,2.2780963315814773e-06,0,0
9068,darren,1,1.8364528545823171e-06,1,2.2780963315814773e-06,0,0
9071,rovell,1,1.8364528545823171e-06,1,2.2780963315814773e-06,0,0
9074,slack,1,1.8364528545823171e-06,1,2.2780963315814773e-06,0,0
9078,nevadas,1,1.8364528545823171e-06,1,2.2780963315814773e-06,0,0
9076,clubhouse,1,1.8364528545823171e-06,1,2.2780963315814773e-06,0,0
9082,@stephaniebice,1,1.8364528545823171e-06,1,2.2780963315814773e-06,0,0
9081,#ok05,1,1.8364528545823171e-06,1,2.2780963315814773e-06,0,0
9083,#bidencrimefamiily,1,1.8364528545823171e-06,1,2.2780963315814773e-06,0,0
9087,norm,1,1.8364528545823171e-06,1,2.2780963315814773e-06,0,0
9090,plus1,1,1.8364528545823171e-06,1,2.2780963315814773e-06,0,0
9091,relegated,1,1.8364528545823171e-06,1,2.2780963315814773e-06,0,0
9092,revolving,1,1.8364528545823171e-06,1,2.2780963315814773e-06,0,0
9093,planetand,1,1.8364528545823171e-06,1,2.2780963315814773e-06,0,0
9098,percentages,1,1.8364528545823171e-06,1,2.2780963315814773e-06,0,0
9111,usurping,1,1.8364528545823171e-06,1,2.2780963315814773e-06,0,0
9114,limitations,1,1.8364528545823171e-06,1,2.2780963315814773e-06,0,0
9117,rejection,1,1.8364528545823171e-06,1,2.2780963315814773e-06,0,0
9116,minuscule,1,1.8364528545823171e-06,1,2.2780963315814773e-06,0,0
9123,biden-backed,1,1.8364528545823171e-06,1,2.2780963315814773e-06,0,0
9130,georgian,1,1.8364528545823171e-06,1,2.2780963315814773e-06,0,0
9127,#specialsession,1,1.8364528545823171e-06,1,2.2780963315814773e-06,0,0
9136,politicianthe,1,1.8364528545823171e-06,1,2.2780963315814773e-06,0,0
9138,swampso,1,1.8364528545823171e-06,1,2.2780963315814773e-06,0,0
9141,troupe,1,1.8364528545823171e-06,1,2.2780963315814773e-06,0,0
9149,dreamget,1,1.8364528545823171e-06,1,2.2780963315814773e-06,0,0
9153,jihadists,1,1.8364528545823171e-06,1,2.2780963315814773e-06,0,0
9164,georgians,1,1.8364528545823171e-06,1,2.2780963315814773e-06,0,0
9168,diehard,1,1.8364528545823171e-06,1,2.2780963315814773e-06,0,0
9176,jody,1,1.8364528545823171e-06,1,2.2780963315814773e-06,0,0
9185,oneill,1,1.8364528545823171e-06,1,2.2780963315814773e-06,0,0
9184,@jimoneillnc,1,1.8364528545823171e-06,1,2.2780963315814773e-06,0,0
9189,equaled,1,1.8364528545823171e-06,1,2.2780963315814773e-06,0,0
9195,nighttime,1,1.8364528545823171e-06,1,2.2780963315814773e-06,0,0
9200,#supremecourt,1,1.8364528545823171e-06,1,2.2780963315814773e-06,0,0
9201,#overturn,1,1.8364528545823171e-06,1,2.2780963315814773e-06,0,0
9206,profited,1,1.8364528545823171e-06,1,2.2780963315814773e-06,0,0
9208,unleashed,1,1.8364528545823171e-06,1,2.2780963315814773e-06,0,0
9209,bookies,1,1.8364528545823171e-06,1,2.2780963315814773e-06,0,0
9210,plummeti,1,1.8364528545823171e-06,1,2.2780963315814773e-06,0,0
9214,devine,1,1.8364528545823171e-06,1,2.2780963315814773e-06,0,0
9222,@truethevote,1,1.8364528545823171e-06,1,2.2780963315814773e-06,0,0
9224,booths,1,1.8364528545823171e-06,1,2.2780963315814773e-06,0,0
9227,counterfeit,1,1.8364528545823171e-06,1,2.2780963315814773e-06,0,0
9231,dishonoring,1,1.8364528545823171e-06,1,2.2780963315814773e-06,0,0
9236,arrives,1,1.8364528545823171e-06,1,2.2780963315814773e-06,0,0
9237,sanitized,1,1.8364528545823171e-06,1,2.2780963315814773e-06,0,0
9242,verifying,1,1.8364528545823171e-06,1,2.2780963315814773e-06,0,0
9247,philly,1,1.8364528545823171e-06,1,2.2780963315814773e-06,0,0
9248,shipyard,1,1.8364528545823171e-06,1,2.2780963315814773e-06,0,0
9245,dealand,1,1.8364528545823171e-06,1,2.2780963315814773e-06,0,0
9251,@rjharriswhp580,1,1.8364528545823171e-06,1,2.2780963315814773e-06,0,0
9253,escalate,1,1.8364528545823171e-06,1,2.2780963315814773e-06,0,0
9255,butler,1,1.8364528545823171e-06,1,2.2780963315814773e-06,0,0
9259,@albertmohler,1,1.8364528545823171e-06,1,2.2780963315814773e-06,0,0
9258,#beliversandballots,1,1.8364528545823171e-06,1,2.2780963315814773e-06,0,0
9262,moroccan,1,1.8364528545823171e-06,1,2.2780963315814773e-06,0,0
9263,moroccos,1,1.8364528545823171e-06,1,2.2780963315814773e-06,0,0
9260,autonomy,1,1.8364528545823171e-06,1,2.2780963315814773e-06,0,0
9269,1777,1,1.8364528545823171e-06,1,2.2780963315814773e-06,0,0
9270,fitting,1,1.8364528545823171e-06,1,2.2780963315814773e-06,0,0
9275,americansi,1,1.8364528545823171e-06,1,2.2780963315814773e-06,0,0
9284,removals,1,1.8364528545823171e-06,1,2.2780963315814773e-06,0,0
9289,drenched,1,1.8364528545823171e-06,1,2.2780963315814773e-06,0,0
9291,turtle,1,1.8364528545823171e-06,1,2.2780963315814773e-06,0,0
9296,plagued,1,1.8364528545823171e-06,1,2.2780963315814773e-06,0,0
9297,rbg,1,1.8364528545823171e-06,1,2.2780963315814773e-06,0,0
9299,@esther4congress,1,1.8364528545823171e-06,1,2.2780963315814773e-06,0,0
9298,#il17,1,1.8364528545823171e-06,1,2.2780963315814773e-06,0,0
9302,@victoriaspartz,1,1.8364528545823171e-06,1,2.2780963315814773e-06,0,0
9301,#in05,1,1.8364528545823171e-06,1,2.2780963315814773e-06,0,0
9304,@scottfranklinfl,1,1.8364528545823171e-06,1,2.2780963315814773e-06,0,0
9303,#fl15,1,1.8364528545823171e-06,1,2.2780963315814773e-06,0,0
9309,mcclain,1,1.8364528545823171e-06,1,2.2780963315814773e-06,0,0
9307,@lisaforcongress,1,1.8364528545823171e-06,1,2.2780963315814773e-06,0,0
9306,#mi10,1,1.8364528545823171e-06,1,2.2780963315814773e-06,0,0
9313,@chelefarley,1,1.8364528545823171e-06,1,2.2780963315814773e-06,0,0
9315,chele,1,1.8364528545823171e-06,1,2.2780963315814773e-06,0,0
9312,#ny18,1,1.8364528545823171e-06,1,2.2780963315814773e-06,0,0
9318,@cliffbentz,1,1.8364528545823171e-06,1,2.2780963315814773e-06,0,0
9317,#or02,1,1.8364528545823171e-06,1,2.2780963315814773e-06,0,0
9321,#wvgov,1,1.8364528545823171e-06,1,2.2780963315814773e-06,0,0
9326,@derrickvanorden,1,1.8364528545823171e-06,1,2.2780963315814773e-06,0,0
9327,derrick,1,1.8364528545823171e-06,1,2.2780963315814773e-06,0,0
9325,#wi03,1,1.8364528545823171e-06,1,2.2780963315814773e-06,0,0
9330,@jakelaturner,1,1.8364528545823171e-06,1,2.2780963315814773e-06,0,0
9329,#ks02,1,1.8364528545823171e-06,1,2.2780963315814773e-06,0,0
9335,negron,1,1.8364528545823171e-06,1,2.2780963315814773e-06,0,0
9334,@stevenegronnh,1,1.8364528545823171e-06,1,2.2780963315814773e-06,0,0
9333,#nh02,1,1.8364528545823171e-06,1,2.2780963315814773e-06,0,0
9337,@gcforcongress,1,1.8364528545823171e-06,1,2.2780963315814773e-06,0,0
9336,#tx32,1,1.8364528545823171e-06,1,2.2780963315814773e-06,0,0
9350,swimmingly,1,1.8364528545823171e-06,1,2.2780963315814773e-06,0,0
9356,purportedly,1,1.8364528545823171e-06,1,2.2780963315814773e-06,0,0
9355,intervene,1,1.8364528545823171e-06,1,2.2780963315814773e-06,0,0
9357,007,1,1.8364528545823171e-06,1,2.2780963315814773e-06,0,0
9359,connery,1,1.8364528545823171e-06,1,2.2780963315814773e-06,0,0
9362,greener,1,1.8364528545823171e-06,1,2.2780963315814773e-06,0,0
9361,fairways,1,1.8364528545823171e-06,1,2.2780963315814773e-06,0,0
9364,shoutedlet,1,1.8364528545823171e-06,1,2.2780963315814773e-06,0,0
9360,damn,1,1.8364528545823171e-06,1,2.2780963315814773e-06,0,0
9366,@danpatrick,1,1.8364528545823171e-06,1,2.2780963315814773e-06,0,0
9370,trusting,1,1.8364528545823171e-06,1,2.2780963315814773e-06,0,0
9379,no-doubter,1,1.8364528545823171e-06,1,2.2780963315814773e-06,0,0
9380,floated,1,1.8364528545823171e-06,1,2.2780963315814773e-06,0,0
9383,fking,1,1.8364528545823171e-06,1,2.2780963315814773e-06,0,0
9382,empire,1,1.8364528545823171e-06,1,2.2780963315814773e-06,0,0
9385,134886,1,1.8364528545823171e-06,1,2.2780963315814773e-06,0,0
9386,631am,1,1.8364528545823171e-06,1,2.2780963315814773e-06,0,0
9388,freefall,1,1.8364528545823171e-06,1,2.2780963315814773e-06,0,0
9393,doa,1,1.8364528545823171e-06,1,2.2780963315814773e-06,0,0
9400,rejects,1,1.8364528545823171e-06,1,2.2780963315814773e-06,0,0
9398,exclusion,1,1.8364528545823171e-06,1,2.2780963315814773e-06,0,0
9410,caters,1,1.8364528545823171e-06,1,2.2780963315814773e-06,0,0
9412,hustle,1,1.8364528545823171e-06,1,2.2780963315814773e-06,0,0
9415,gun-grabbers,1,1.8364528545823171e-06,1,2.2780963315814773e-06,0,0
9421,vey,1,1.8364528545823171e-06,1,2.2780963315814773e-06,0,0
9422,haphazardly,1,1.8364528545823171e-06,1,2.2780963315814773e-06,0,0
9428,nehls,1,1.8364528545823171e-06,1,2.2780963315814773e-06,0,0
9427,@sherifftnehls,1,1.8364528545823171e-06,1,2.2780963315814773e-06,0,0
9426,#tx22,1,1.8364528545823171e-06,1,2.2780963315814773e-06,0,0
9431,chickened,1,1.8364528545823171e-06,1,2.2780963315814773e-06,0,0
9433,enumerated,1,1.8364528545823171e-06,1,2.2780963315814773e-06,0,0
9436,non-resident,1,1.8364528545823171e-06,1,2.2780963315814773e-06,0,0
9437,roughed,1,1.8364528545823171e-06,1,2.2780963315814773e-06,0,0
9439,@frankpallottanj,1,1.8364528545823171e-06,1,2.2780963315814773e-06,0,0
9438,#nj05,1,1.8364528545823171e-06,1,2.2780963315814773e-06,0,0
9453,texaspennsylvania,1,1.8364528545823171e-06,1,2.2780963315814773e-06,0,0
9457,rosen,1,1.8364528545823171e-06,1,2.2780963315814773e-06,0,0
9455,donoghue,1,1.8364528545823171e-06,1,2.2780963315814773e-06,0,0
9459,skyrocket,1,1.8364528545823171e-06,1,2.2780963315814773e-06,0,0
9465,tamper,1,1.8364528545823171e-06,1,2.2780963315814773e-06,0,0
9468,offshored,1,1.8364528545823171e-06,1,2.2780963315814773e-06,0,0
9472,demeaned,1,1.8364528545823171e-06,1,2.2780963315814773e-06,0,0
9477,@mailonline,1,1.8364528545823171e-06,1,2.2780963315814773e-06,0,0
9480,2-3,1,1.8364528545823171e-06,1,2.2780963315814773e-06,0,0
9483,dethrone,1,1.8364528545823171e-06,1,2.2780963315814773e-06,0,0
9484,bidding,1,1.8364528545823171e-06,1,2.2780963315814773e-06,0,0
9485,1776,1,1.8364528545823171e-06,1,2.2780963315814773e-06,0,0
9491,limboland,1,1.8364528545823171e-06,1,2.2780963315814773e-06,0,0
9488,@donnabraziie,1,1.8364528545823171e-06,1,2.2780963315814773e-06,0,0
9495,63000000,1,1.8364528545823171e-06,1,2.2780963315814773e-06,0,0
9505,signaturesand,1,1.8364528545823171e-06,1,2.2780963315814773e-06,0,0
9508,calamities,1,1.8364528545823171e-06,1,2.2780963315814773e-06,0,0
9510,post-gazette,1,1.8364528545823171e-06,1,2.2780963315814773e-06,0,0
9511,annihilated,1,1.8364528545823171e-06,1,2.2780963315814773e-06,0,0
9514,debunks,1,1.8364528545823171e-06,1,2.2780963315814773e-06,0,0
9516,statelocking,1,1.8364528545823171e-06,1,2.2780963315814773e-06,0,0
9524,unappreciative,1,1.8364528545823171e-06,1,2.2780963315814773e-06,0,0
9546,¡mi,1,1.8364528545823171e-06,1,2.2780963315814773e-06,0,0
9530,es,1,1.8364528545823171e-06,1,2.2780963315814773e-06,0,0
9540,promesa,1,1.8364528545823171e-06,1,2.2780963315814773e-06,0,0
9533,hispanoamericanos,1,1.8364528545823171e-06,1,2.2780963315814773e-06,0,0
9534,impulsar,1,1.8364528545823171e-06,1,2.2780963315814773e-06,0,0
9528,economía,1,1.8364528545823171e-06,1,2.2780963315814773e-06,0,0
9542,próspera,1,1.8364528545823171e-06,1,2.2780963315814773e-06,0,0
9541,proveer,1,1.8364528545823171e-06,1,2.2780963315814773e-06,0,0
9537,oportunidades,1,1.8364528545823171e-06,1,2.2780963315814773e-06,0,0
9529,educación,1,1.8364528545823171e-06,1,2.2780963315814773e-06,0,0
9543,todos,1,1.8364528545823171e-06,1,2.2780963315814773e-06,0,0
9539,preservar,1,1.8364528545823171e-06,1,2.2780963315814773e-06,0,0
9535,libertad,1,1.8364528545823171e-06,1,2.2780963315814773e-06,0,0
9525,apoyar,1,1.8364528545823171e-06,1,2.2780963315814773e-06,0,0
9531,familia,1,1.8364528545823171e-06,1,2.2780963315814773e-06,0,0
9526,comunidad,1,1.8364528545823171e-06,1,2.2780963315814773e-06,0,0
9548,noncitizens,1,1.8364528545823171e-06,1,2.2780963315814773e-06,0,0
9547,ineligible,1,1.8364528545823171e-06,1,2.2780963315814773e-06,0,0
9549,traverse,1,1.8364528545823171e-06,1,2.2780963315814773e-06,0,0
9550,swindled,1,1.8364528545823171e-06,1,2.2780963315814773e-06,0,0
9554,refugee,1,1.8364528545823171e-06,1,2.2780963315814773e-06,0,0
9555,decrepit,1,1.8364528545823171e-06,1,2.2780963315814773e-06,0,0
9559,flagand,1,1.8364528545823171e-06,1,2.2780963315814773e-06,0,0
9566,induce,1,1.8364528545823171e-06,1,2.2780963315814773e-06,0,0
9571,globalists,1,1.8364528545823171e-06,1,2.2780963315814773e-06,0,0
9575,scooter,1,1.8364528545823171e-06,1,2.2780963315814773e-06,0,0
9573,libby,1,1.8364528545823171e-06,1,2.2780963315814773e-06,0,0
9579,vienna,1,1.8364528545823171e-06,1,2.2780963315814773e-06,0,0
9577,austria,1,1.8364528545823171e-06,1,2.2780963315814773e-06,0,0
9584,doses,1,1.8364528545823171e-06,1,2.2780963315814773e-06,0,0
9586,36-page,1,1.8364528545823171e-06,1,2.2780963315814773e-06,0,0
9597,murtha,1,1.8364528545823171e-06,1,2.2780963315814773e-06,0,0
9596,johnstown-cambria,1,1.8364528545823171e-06,1,2.2780963315814773e-06,0,0
9599,discovering,1,1.8364528545823171e-06,1,2.2780963315814773e-06,0,0
9604,tonys,1,1.8364528545823171e-06,1,2.2780963315814773e-06,0,0
9603,prognostications,1,1.8364528545823171e-06,1,2.2780963315814773e-06,0,0
9608,@winred,1,1.8364528545823171e-06,1,2.2780963315814773e-06,0,0
9619,dementia,1,1.8364528545823171e-06,1,2.2780963315814773e-06,0,0
9625,disrupting,1,1.8364528545823171e-06,1,2.2780963315814773e-06,0,0
9627,weekso,1,1.8364528545823171e-06,1,2.2780963315814773e-06,0,0
9631,aliensdecimating,1,1.8364528545823171e-06,1,2.2780963315814773e-06,0,0
9638,dodges,1,1.8364528545823171e-06,1,2.2780963315814773e-06,0,0
9646,307000,1,1.8364528545823171e-06,1,2.2780963315814773e-06,0,0
9647,coughing,1,1.8364528545823171e-06,1,2.2780963315814773e-06,0,0
9651,baghdad,1,1.8364528545823171e-06,1,2.2780963315814773e-06,0,0
9652,chatter,1,1.8364528545823171e-06,1,2.2780963315814773e-06,0,0
9662,poles,1,1.8364528545823171e-06,1,2.2780963315814773e-06,0,0
9663,@wreathsacross,1,1.8364528545823171e-06,1,2.2780963315814773e-06,0,0
9666,marias,1,1.8364528545823171e-06,1,2.2780963315814773e-06,0,0
9667,bobb,1,1.8364528545823171e-06,1,2.2780963315814773e-06,0,0
9672,solidly,1,1.8364528545823171e-06,1,2.2780963315814773e-06,0,0
9671,magically,1,1.8364528545823171e-06,1,2.2780963315814773e-06,0,0
9678,foe,1,1.8364528545823171e-06,1,2.2780963315814773e-06,0,0
9680,@realpnavarro,1,1.8364528545823171e-06,1,2.2780963315814773e-06,0,0
9690,martial,1,1.8364528545823171e-06,1,2.2780963315814773e-06,0,0
9691,740,1,1.8364528545823171e-06,1,2.2780963315814773e-06,0,0
9694,internationally,1,1.8364528545823171e-06,1,2.2780963315814773e-06,0,0
9695,renames,1,1.8364528545823171e-06,1,2.2780963315814773e-06,0,0
9696,arise,1,1.8364528545823171e-06,1,2.2780963315814773e-06,0,0
9700,convincingly,1,1.8364528545823171e-06,1,2.2780963315814773e-06,0,0
9704,dip,1,1.8364528545823171e-06,1,2.2780963315814773e-06,0,0
9703,751000,1,1.8364528545823171e-06,1,2.2780963315814773e-06,0,0
9711,rotate,1,1.8364528545823171e-06,1,2.2780963315814773e-06,0,0
9712,arizonawe,1,1.8364528545823171e-06,1,2.2780963315814773e-06,0,0
9716,render,1,1.8364528545823171e-06,1,2.2780963315814773e-06,0,0
9718,outrageously,1,1.8364528545823171e-06,1,2.2780963315814773e-06,0,0
9719,sentinels,1,1.8364528545823171e-06,1,2.2780963315814773e-06,0,0
9722,pursues,1,1.8364528545823171e-06,1,2.2780963315814773e-06,0,0
9724,sanctioned,1,1.8364528545823171e-06,1,2.2780963315814773e-06,0,0
9733,vaccinated,1,1.8364528545823171e-06,1,2.2780963315814773e-06,0,0
9739,thune,1,1.8364528545823171e-06,1,2.2780963315814773e-06,0,0
9737,mitchs,1,1.8364528545823171e-06,1,2.2780963315814773e-06,0,0
9738,primaried,1,1.8364528545823171e-06,1,2.2780963315814773e-06,0,0
9742,crudely,1,1.8364528545823171e-06,1,2.2780963315814773e-06,0,0
9743,thick,1,1.8364528545823171e-06,1,2.2780963315814773e-06,0,0
9741,cardboard,1,1.8364528545823171e-06,1,2.2780963315814773e-06,0,0
9745,intervals,1,1.8364528545823171e-06,1,2.2780963315814773e-06,0,0
9746,admittance,1,1.8364528545823171e-06,1,2.2780963315814773e-06,0,0
9749,flips,1,1.8364528545823171e-06,1,2.2780963315814773e-06,0,0
9753,pens,1,1.8364528545823171e-06,1,2.2780963315814773e-06,0,0
9752,newt,1,1.8364528545823171e-06,1,2.2780963315814773e-06,0,0
9751,gingrich,1,1.8364528545823171e-06,1,2.2780963315814773e-06,0,0
9757,software,1,1.8364528545823171e-06,1,2.2780963315814773e-06,0,0
9761,@jonathanturley,1,1.8364528545823171e-06,1,2.2780963315814773e-06,0,0
9763,authenticated,1,1.8364528545823171e-06,1,2.2780963315814773e-06,0,0
9764,authentication,1,1.8364528545823171e-06,1,2.2780963315814773e-06,0,0
9765,cites,1,1.8364528545823171e-06,1,2.2780963315814773e-06,0,0
9768,philladelphia,1,1.8364528545823171e-06,1,2.2780963315814773e-06,0,0
9769,compel,1,1.8364528545823171e-06,1,2.2780963315814773e-06,0,0
9770,systemic,1,1.8364528545823171e-06,1,2.2780963315814773e-06,0,0
9774,outran,1,1.8364528545823171e-06,1,2.2780963315814773e-06,0,0
9777,morass,1,1.8364528545823171e-06,1,2.2780963315814773e-06,0,0
9778,vested,1,1.8364528545823171e-06,1,2.2780963315814773e-06,0,0
9780,discovers,1,1.8364528545823171e-06,1,2.2780963315814773e-06,0,0
9782,4-3,1,1.8364528545823171e-06,1,2.2780963315814773e-06,0,0
9791,congressmencongresswomen,1,1.8364528545823171e-06,1,2.2780963315814773e-06,0,0
9793,energetic,1,1.8364528545823171e-06,1,2.2780963315814773e-06,0,0
9794,troubling,1,1.8364528545823171e-06,1,2.2780963315814773e-06,0,0
9799,@electblakemoore,1,1.8364528545823171e-06,1,2.2780963315814773e-06,0,0
9798,#ut01,1,1.8364528545823171e-06,1,2.2780963315814773e-06,0,0
9805,miller-meeks,1,1.8364528545823171e-06,1,2.2780963315814773e-06,0,0
9803,@millermeeks,1,1.8364528545823171e-06,1,2.2780963315814773e-06,0,0
9802,#ia02,1,1.8364528545823171e-06,1,2.2780963315814773e-06,0,0
9814,mysteriously,1,1.8364528545823171e-06,1,2.2780963315814773e-06,0,0
9817,journals,1,1.8364528545823171e-06,1,2.2780963315814773e-06,0,0
9816,incoherent,1,1.8364528545823171e-06,1,2.2780963315814773e-06,0,0
9823,lott,1,1.8364528545823171e-06,1,2.2780963315814773e-06,0,0
9818,11350,1,1.8364528545823171e-06,1,2.2780963315814773e-06,0,0
9819,289000,1,1.8364528545823171e-06,1,2.2780963315814773e-06,0,0
9829,toppled,1,1.8364528545823171e-06,1,2.2780963315814773e-06,0,0
9830,@marksteynonline,1,1.8364528545823171e-06,1,2.2780963315814773e-06,0,0
9832,distributed,1,1.8364528545823171e-06,1,2.2780963315814773e-06,0,0
9831,administer,1,1.8364528545823171e-06,1,2.2780963315814773e-06,0,0
9837,verifications,1,1.8364528545823171e-06,1,2.2780963315814773e-06,0,0
9843,@kristinoem,1,1.8364528545823171e-06,1,2.2780963315814773e-06,0,0
9844,kristi,1,1.8364528545823171e-06,1,2.2780963315814773e-06,0,0
9849,switching,1,1.8364528545823171e-06,1,2.2780963315814773e-06,0,0
9855,publish,1,1.8364528545823171e-06,1,2.2780963315814773e-06,0,0
9856,inoculate,1,1.8364528545823171e-06,1,2.2780963315814773e-06,0,0
9860,invalidates,1,1.8364528545823171e-06,1,2.2780963315814773e-06,0,0
9862,hastily,1,1.8364528545823171e-06,1,2.2780963315814773e-06,0,0
9864,bitter,1,1.8364528545823171e-06,1,2.2780963315814773e-06,0,0
9869,staceys,1,1.8364528545823171e-06,1,2.2780963315814773e-06,0,0
9870,deducted,1,1.8364528545823171e-06,1,2.2780963315814773e-06,0,0
9876,post-election,1,1.8364528545823171e-06,1,2.2780963315814773e-06,0,0
9878,comeour,1,1.8364528545823171e-06,1,2.2780963315814773e-06,0,0
9879,objecting,1,1.8364528545823171e-06,1,2.2780963315814773e-06,0,0
9880,@cdcgovs,1,1.8364528545823171e-06,1,2.2780963315814773e-06,0,0
9888,decertifying,1,1.8364528545823171e-06,1,2.2780963315814773e-06,0,0
9889,dictates,1,1.8364528545823171e-06,1,2.2780963315814773e-06,0,0
9890,determinative,1,1.8364528545823171e-06,1,2.2780963315814773e-06,0,0
9893,@luisriveramarin,1,1.8364528545823171e-06,1,2.2780963315814773e-06,0,0
9895,shawn,1,1.8364528545823171e-06,1,2.2780963315814773e-06,0,0
9897,address-,1,1.8364528545823171e-06,1,2.2780963315814773e-06,0,0
9898,undoing,1,1.8364528545823171e-06,1,2.2780963315814773e-06,0,0
9899,@nycemergencymgt,1,1.8364528545823171e-06,1,2.2780963315814773e-06,0,0
9918,bengahzi,1,1.8364528545823171e-06,1,2.2780963315814773e-06,0,0
9919,175000,1,1.8364528545823171e-06,1,2.2780963315814773e-06,0,0
9927,@twytter14,1,1.8364528545823171e-06,1,2.2780963315814773e-06,0,0
9926,@tashlutsa,1,1.8364528545823171e-06,1,2.2780963315814773e-06,0,0
9933,gump-like,1,1.8364528545823171e-06,1,2.2780963315814773e-06,0,0
9938,dimensionns,1,1.8364528545823171e-06,1,2.2780963315814773e-06,0,0
9946,@jillianturner,1,1.8364528545823171e-06,1,2.2780963315814773e-06,0,0
9954,@carminezozzora,1,1.8364528545823171e-06,1,2.2780963315814773e-06,0,0
9955,campaigna,1,1.8364528545823171e-06,1,2.2780963315814773e-06,0,0
9958,mcenany,1,1.8364528545823171e-06,1,2.2780963315814773e-06,0,0
9961,junge,1,1.8364528545823171e-06,1,2.2780963315814773e-06,0,0
9960,@votepauljunge,1,1.8364528545823171e-06,1,2.2780963315814773e-06,0,0
9959,#mi08,1,1.8364528545823171e-06,1,2.2780963315814773e-06,0,0
9964,marchant,1,1.8364528545823171e-06,1,2.2780963315814773e-06,0,0
9963,@votejimmarchant,1,1.8364528545823171e-06,1,2.2780963315814773e-06,0,0
9962,#nv04,1,1.8364528545823171e-06,1,2.2780963315814773e-06,0,0
9966,@danrodimer,1,1.8364528545823171e-06,1,2.2780963315814773e-06,0,0
9967,wrestler,1,1.8364528545823171e-06,1,2.2780963315814773e-06,0,0
9965,#nv03,1,1.8364528545823171e-06,1,2.2780963315814773e-06,0,0
9968,#ny21,1,1.8364528545823171e-06,1,2.2780963315814773e-06,0,0
9973,@bryansteil,1,1.8364528545823171e-06,1,2.2780963315814773e-06,0,0
9975,wisconsins,1,1.8364528545823171e-06,1,2.2780963315814773e-06,0,0
9972,#wi01,1,1.8364528545823171e-06,1,2.2780963315814773e-06,0,0
9977,medicarea,1,1.8364528545823171e-06,1,2.2780963315814773e-06,0,0
9982,greenfield,1,1.8364528545823171e-06,1,2.2780963315814773e-06,0,0
9984,theresas,1,1.8364528545823171e-06,1,2.2780963315814773e-06,0,0
9980,ernst,1,1.8364528545823171e-06,1,2.2780963315814773e-06,0,0
9979,#iasen,1,1.8364528545823171e-06,1,2.2780963315814773e-06,0,0
9987,sabato,1,1.8364528545823171e-06,1,2.2780963315814773e-06,0,0
9994,nonwhite,1,1.8364528545823171e-06,1,2.2780963315814773e-06,0,0
9996,descended,1,1.8364528545823171e-06,1,2.2780963315814773e-06,0,0
10000,steep,1,1.8364528545823171e-06,1,2.2780963315814773e-06,0,0
9997,handrail,1,1.8364528545823171e-06,1,2.2780963315814773e-06,0,0
10001,mugged,1,1.8364528545823171e-06,1,2.2780963315814773e-06,0,0
10007,546,1,1.8364528545823171e-06,1,2.2780963315814773e-06,0,0
10010,admirer,1,1.8364528545823171e-06,1,2.2780963315814773e-06,0,0
10014,reside,1,1.8364528545823171e-06,1,2.2780963315814773e-06,0,0
10016,ode,1,1.8364528545823171e-06,1,2.2780963315814773e-06,0,0
10017,hospitalizations,1,1.8364528545823171e-06,1,2.2780963315814773e-06,0,0
10019,langone,1,1.8364528545823171e-06,1,2.2780963315814773e-06,0,0
10026,containment,1,1.8364528545823171e-06,1,2.2780963315814773e-06,0,0
10038,#momentofhonor,1,1.8364528545823171e-06,1,2.2780963315814773e-06,0,0
10040,valiantly,1,1.8364528545823171e-06,1,2.2780963315814773e-06,0,0
10045,revelations,1,1.8364528545823171e-06,1,2.2780963315814773e-06,0,0
10050,desjarlais,1,1.8364528545823171e-06,1,2.2780963315814773e-06,0,0
10049,@tndesjarlais,1,1.8364528545823171e-06,1,2.2780963315814773e-06,0,0
10048,#tn04,1,1.8364528545823171e-06,1,2.2780963315814773e-06,0,0
10055,#blackvoicesfortrump,1,1.8364528545823171e-06,1,2.2780963315814773e-06,0,0
10059,525000,1,1.8364528545823171e-06,1,2.2780963315814773e-06,0,0
10062,winschina,1,1.8364528545823171e-06,1,2.2780963315814773e-06,0,0
10065,dissolve,1,1.8364528545823171e-06,1,2.2780963315814773e-06,0,0
10067,biden-harris,1,1.8364528545823171e-06,1,2.2780963315814773e-06,0,0
10069,triggering,1,1.8364528545823171e-06,1,2.2780963315814773e-06,0,0
10068,exodus,1,1.8364528545823171e-06,1,2.2780963315814773e-06,0,0
10084,preview,1,1.8364528545823171e-06,1,2.2780963315814773e-06,0,0
10086,takeout,1,1.8364528545823171e-06,1,2.2780963315814773e-06,0,0
10083,magnificently,1,1.8364528545823171e-06,1,2.2780963315814773e-06,0,0
10089,iranwho,1,1.8364528545823171e-06,1,2.2780963315814773e-06,0,0
10088,americadeserve,1,1.8364528545823171e-06,1,2.2780963315814773e-06,0,0
10090,#prayfornashville,1,1.8364528545823171e-06,1,2.2780963315814773e-06,0,0
10093,costand,1,1.8364528545823171e-06,1,2.2780963315814773e-06,0,0
10096,paragraph,1,1.8364528545823171e-06,1,2.2780963315814773e-06,0,0
10097,untrusted,1,1.8364528545823171e-06,1,2.2780963315814773e-06,0,0
10109,scamming,1,1.8364528545823171e-06,1,2.2780963315814773e-06,0,0
10111,staging,1,1.8364528545823171e-06,1,2.2780963315814773e-06,0,0
10114,allocating,1,1.8364528545823171e-06,1,2.2780963315814773e-06,0,0
10112,296,1,1.8364528545823171e-06,1,2.2780963315814773e-06,0,0
10113,@secretarycarson,1,1.8364528545823171e-06,1,2.2780963315814773e-06,0,0
10139,شجاع,1,1.8364528545823171e-06,1,2.2780963315814773e-06,0,0
10137,رنج,1,1.8364528545823171e-06,1,2.2780963315814773e-06,0,0
10149,کشیده,1,1.8364528545823171e-06,1,2.2780963315814773e-06,0,0
10120,ابتدای,1,1.8364528545823171e-06,1,2.2780963315814773e-06,0,0
10134,دوره,1,1.8364528545823171e-06,1,2.2780963315814773e-06,0,0
10138,ریاست,1,1.8364528545823171e-06,1,2.2780963315814773e-06,0,0
10131,جمهوریم,1,1.8364528545823171e-06,1,2.2780963315814773e-06,0,0
10127,ایستاده‌ام,1,1.8364528545823171e-06,1,2.2780963315814773e-06,0,0
10147,همچنان,1,1.8364528545823171e-06,1,2.2780963315814773e-06,0,0
10126,ایستاد,1,1.8364528545823171e-06,1,2.2780963315814773e-06,0,0
10146,نزدیک,1,1.8364528545823171e-06,1,2.2780963315814773e-06,0,0
10133,دنبال,1,1.8364528545823171e-06,1,2.2780963315814773e-06,0,0
10150,کنیم,1,1.8364528545823171e-06,1,2.2780963315814773e-06,0,0
10140,شجاعت,1,1.8364528545823171e-06,1,2.2780963315814773e-06,0,0
10124,الهام,1,1.8364528545823171e-06,1,2.2780963315814773e-06,0,0
10129,بخش,1,1.8364528545823171e-06,1,2.2780963315814773e-06,0,0
10151,@bittyandbeaus,1,1.8364528545823171e-06,1,2.2780963315814773e-06,0,0
10153,18718m,1,1.8364528545823171e-06,1,2.2780963315814773e-06,0,0
10156,154,1,1.8364528545823171e-06,1,2.2780963315814773e-06,0,0
10157,adjourn,1,1.8364528545823171e-06,1,2.2780963315814773e-06,0,0
10159,objectively,1,1.8364528545823171e-06,1,2.2780963315814773e-06,0,0
10169,pumps,1,1.8364528545823171e-06,1,2.2780963315814773e-06,0,0
10167,blend,1,1.8364528545823171e-06,1,2.2780963315814773e-06,0,0
10165,@senatorrounds,1,1.8364528545823171e-06,1,2.2780963315814773e-06,0,0
10163,@kimreynoldsia,1,1.8364528545823171e-06,1,2.2780963315814773e-06,0,0
10161,@epaawheeler,1,1.8364528545823171e-06,1,2.2780963315814773e-06,0,0
10170,#promisesmadepromiseskept🇺🇸,1,1.8364528545823171e-06,1,2.2780963315814773e-06,0,0
10174,#keepamericagreat2020🇺🇸,1,1.8364528545823171e-06,1,2.2780963315814773e-06,0,0
10175,#champs,1,1.8364528545823171e-06,1,2.2780963315814773e-06,0,0
10179,ags,1,1.8364528545823171e-06,1,2.2780963315814773e-06,0,0
10181,nationwe,1,1.8364528545823171e-06,1,2.2780963315814773e-06,0,0
10185,profiles,1,1.8364528545823171e-06,1,2.2780963315814773e-06,0,0
10184,nonfiction,1,1.8364528545823171e-06,1,2.2780963315814773e-06,0,0
10196,mail-vote,1,1.8364528545823171e-06,1,2.2780963315814773e-06,0,0
10194,crackup,1,1.8364528545823171e-06,1,2.2780963315814773e-06,0,0
10193,brawl,1,1.8364528545823171e-06,1,2.2780963315814773e-06,0,0
10192,@governortomwolf,1,1.8364528545823171e-06,1,2.2780963315814773e-06,0,0
10197,@petebuttigieg,1,1.8364528545823171e-06,1,2.2780963315814773e-06,0,0
10199,quits,1,1.8364528545823171e-06,1,2.2780963315814773e-06,0,0
10198,depriving,1,1.8364528545823171e-06,1,2.2780963315814773e-06,0,0
10202,gills,1,1.8364528545823171e-06,1,2.2780963315814773e-06,0,0
10208,amash,1,1.8364528545823171e-06,1,2.2780963315814773e-06,0,0
10214,fop,1,1.8364528545823171e-06,1,2.2780963315814773e-06,0,0
10245,گروه‌های,1,1.8364528545823171e-06,1,2.2780963315814773e-06,0,0
10230,حقوق,1,1.8364528545823171e-06,1,2.2780963315814773e-06,0,0
10227,بشر,1,1.8364528545823171e-06,1,2.2780963315814773e-06,0,0
10225,بدهد,1,1.8364528545823171e-06,1,2.2780963315814773e-06,0,0
10231,حقیقت,1,1.8364528545823171e-06,1,2.2780963315814773e-06,0,0
10243,کنونی,1,1.8364528545823171e-06,1,2.2780963315814773e-06,0,0
10228,جریان,1,1.8364528545823171e-06,1,2.2780963315814773e-06,0,0
10239,نظارت,1,1.8364528545823171e-06,1,2.2780963315814773e-06,0,0
10241,کرده,1,1.8364528545823171e-06,1,2.2780963315814773e-06,0,0
10246,گزارش,1,1.8364528545823171e-06,1,2.2780963315814773e-06,0,0
10226,بدهند,1,1.8364528545823171e-06,1,2.2780963315814773e-06,0,0
10234,شاهد,1,1.8364528545823171e-06,1,2.2780963315814773e-06,0,0
10242,کشتار,1,1.8364528545823171e-06,1,2.2780963315814773e-06,0,0
10236,مسالمت,1,1.8364528545823171e-06,1,2.2780963315814773e-06,0,0
10218,آمیز,1,1.8364528545823171e-06,1,2.2780963315814773e-06,0,0
10235,قطع,1,1.8364528545823171e-06,1,2.2780963315814773e-06,0,0
10222,اینترنت,1,1.8364528545823171e-06,1,2.2780963315814773e-06,0,0
10223,باشیم,1,1.8364528545823171e-06,1,2.2780963315814773e-06,0,0
10219,اتفاقات,1,1.8364528545823171e-06,1,2.2780963315814773e-06,0,0
10265,under-served,1,1.8364528545823171e-06,1,2.2780963315814773e-06,0,0
10267,godsend,1,1.8364528545823171e-06,1,2.2780963315814773e-06,0,0
10272,#opportunitynow,1,1.8364528545823171e-06,1,2.2780963315814773e-06,0,0
10273,172,1,1.8364528545823171e-06,1,2.2780963315814773e-06,0,0
10282,installations,1,1.8364528545823171e-06,1,2.2780963315814773e-06,0,0
10285,tampered,1,1.8364528545823171e-06,1,2.2780963315814773e-06,0,0
10286,winred,1,1.8364528545823171e-06,1,2.2780963315814773e-06,0,0
10287,@kbsalsaud,1,1.8364528545823171e-06,1,2.2780963315814773e-06,0,0
10290,choker,1,1.8364528545823171e-06,1,2.2780963315814773e-06,0,0
10299,rename,1,1.8364528545823171e-06,1,2.2780963315814773e-06,0,0
10296,benning,1,1.8364528545823171e-06,1,2.2780963315814773e-06,0,0
10303,2199m,1,1.8364528545823171e-06,1,2.2780963315814773e-06,0,0
10304,@sdmts,1,1.8364528545823171e-06,1,2.2780963315814773e-06,0,0
10308,weaponization,1,1.8364528545823171e-06,1,2.2780963315814773e-06,0,0
10333,نجیب,1,1.8364528545823171e-06,1,2.2780963315814773e-06,0,0
10314,ایران،,1,1.8364528545823171e-06,1,2.2780963315814773e-06,0,0
10309,آمریکا,1,1.8364528545823171e-06,1,2.2780963315814773e-06,0,0
10327,دوست,1,1.8364528545823171e-06,1,2.2780963315814773e-06,0,0
10325,دارند،,1,1.8364528545823171e-06,1,2.2780963315814773e-06,0,0
10331,سزاوار,1,1.8364528545823171e-06,1,2.2780963315814773e-06,0,0
10328,دولتی,1,1.8364528545823171e-06,1,2.2780963315814773e-06,0,0
10319,بیش,1,1.8364528545823171e-06,1,2.2780963315814773e-06,0,0
10321,تمرکز,1,1.8364528545823171e-06,1,2.2780963315814773e-06,0,0
10316,بر,1,1.8364528545823171e-06,1,2.2780963315814773e-06,0,0
10337,کشتن,1,1.8364528545823171e-06,1,2.2780963315814773e-06,0,0
10323,جرم,1,1.8364528545823171e-06,1,2.2780963315814773e-06,0,0
10312,احترام,1,1.8364528545823171e-06,1,2.2780963315814773e-06,0,0
10324,خواهی،,1,1.8364528545823171e-06,1,2.2780963315814773e-06,0,0
10338,کمک,1,1.8364528545823171e-06,1,2.2780963315814773e-06,0,0
10340,کند,1,1.8364528545823171e-06,1,2.2780963315814773e-06,0,0
10320,تا,1,1.8364528545823171e-06,1,2.2780963315814773e-06,0,0
10329,رؤیاهایشان,1,1.8364528545823171e-06,1,2.2780963315814773e-06,0,0
10343,یابند,1,1.8364528545823171e-06,1,2.2780963315814773e-06,0,0
10322,جای,1,1.8364528545823171e-06,1,2.2780963315814773e-06,0,0
10310,آن,1,1.8364528545823171e-06,1,2.2780963315814773e-06,0,0
10332,سمت,1,1.8364528545823171e-06,1,2.2780963315814773e-06,0,0
10336,ویرانی,1,1.8364528545823171e-06,1,2.2780963315814773e-06,0,0
10318,بکشانند،,1,1.8364528545823171e-06,1,2.2780963315814773e-06,0,0
10334,هراس,1,1.8364528545823171e-06,1,2.2780963315814773e-06,0,0
10313,افکنی,1,1.8364528545823171e-06,1,2.2780963315814773e-06,0,0
10339,کنار,1,1.8364528545823171e-06,1,2.2780963315814773e-06,0,0
10317,بنهند,1,1.8364528545823171e-06,1,2.2780963315814773e-06,0,0
10315,باعظمت,1,1.8364528545823171e-06,1,2.2780963315814773e-06,0,0
10345,1417m,1,1.8364528545823171e-06,1,2.2780963315814773e-06,0,0
10354,cuting,1,1.8364528545823171e-06,1,2.2780963315814773e-06,0,0
10359,mccormick,1,1.8364528545823171e-06,1,2.2780963315814773e-06,0,0
10358,@richforga,1,1.8364528545823171e-06,1,2.2780963315814773e-06,0,0
10357,#ga07,1,1.8364528545823171e-06,1,2.2780963315814773e-06,0,0
10360,archbishop,1,1.8364528545823171e-06,1,2.2780963315814773e-06,0,0
10361,viganòs,1,1.8364528545823171e-06,1,2.2780963315814773e-06,0,0
10363,olympian,1,1.8364528545823171e-06,1,2.2780963315814773e-06,0,0
10371,169,1,1.8364528545823171e-06,1,2.2780963315814773e-06,0,0
10376,lwcf,1,1.8364528545823171e-06,1,2.2780963315814773e-06,0,0
10377,restores,1,1.8364528545823171e-06,1,2.2780963315814773e-06,0,0
10378,reno,1,1.8364528545823171e-06,1,2.2780963315814773e-06,0,0
10382,personas,1,1.8364528545823171e-06,1,2.2780963315814773e-06,0,0
10387,wooden,1,1.8364528545823171e-06,1,2.2780963315814773e-06,0,0
10384,forehead,1,1.8364528545823171e-06,1,2.2780963315814773e-06,0,0
10388,@nih,1,1.8364528545823171e-06,1,2.2780963315814773e-06,0,0
10393,lick,1,1.8364528545823171e-06,1,2.2780963315814773e-06,0,0
10394,unsanitary,1,1.8364528545823171e-06,1,2.2780963315814773e-06,0,0
10400,stooped,1,1.8364528545823171e-06,1,2.2780963315814773e-06,0,0
10402,anchorman,1,1.8364528545823171e-06,1,2.2780963315814773e-06,0,0
10405,girlfriend,1,1.8364528545823171e-06,1,2.2780963315814773e-06,0,0
10414,impulsively,1,1.8364528545823171e-06,1,2.2780963315814773e-06,0,0
10416,830ame,1,1.8364528545823171e-06,1,2.2780963315814773e-06,0,0
10426,sterilization,1,1.8364528545823171e-06,1,2.2780963315814773e-06,0,0
10425,@battelle,1,1.8364528545823171e-06,1,2.2780963315814773e-06,0,0
10427,sterilize,1,1.8364528545823171e-06,1,2.2780963315814773e-06,0,0
10430,2462,1,1.8364528545823171e-06,1,2.2780963315814773e-06,0,0
10434,neighboring,1,1.8364528545823171e-06,1,2.2780963315814773e-06,0,0
10429,207,1,1.8364528545823171e-06,1,2.2780963315814773e-06,0,0
10428,206,1,1.8364528545823171e-06,1,2.2780963315814773e-06,0,0
10431,443,1,1.8364528545823171e-06,1,2.2780963315814773e-06,0,0
10436,eviction,1,1.8364528545823171e-06,1,2.2780963315814773e-06,0,0
10437,extensions,1,1.8364528545823171e-06,1,2.2780963315814773e-06,0,0
10439,repayment,1,1.8364528545823171e-06,1,2.2780963315814773e-06,0,0
10440,maniacs,1,1.8364528545823171e-06,1,2.2780963315814773e-06,0,0
10441,decried,1,1.8364528545823171e-06,1,2.2780963315814773e-06,0,0
10446,sinful,1,1.8364528545823171e-06,1,2.2780963315814773e-06,0,0
10444,doom,1,1.8364528545823171e-06,1,2.2780963315814773e-06,0,0
10456,toting,1,1.8364528545823171e-06,1,2.2780963315814773e-06,0,0
10455,toe,1,1.8364528545823171e-06,1,2.2780963315814773e-06,0,0
10454,scammers,1,1.8364528545823171e-06,1,2.2780963315814773e-06,0,0
10460,ss,1,1.8364528545823171e-06,1,2.2780963315814773e-06,0,0
10469,americanot,1,1.8364528545823171e-06,1,2.2780963315814773e-06,0,0
10471,semi-considerable,1,1.8364528545823171e-06,1,2.2780963315814773e-06,0,0
10472,surgeon,1,1.8364528545823171e-06,1,2.2780963315814773e-06,0,0
10478,therapeuticscure,1,1.8364528545823171e-06,1,2.2780963315814773e-06,0,0
10479,singlehandedly,1,1.8364528545823171e-06,1,2.2780963315814773e-06,0,0
10480,stripping,1,1.8364528545823171e-06,1,2.2780963315814773e-06,0,0
10482,adhering,1,1.8364528545823171e-06,1,2.2780963315814773e-06,0,0
10494,trounces,1,1.8364528545823171e-06,1,2.2780963315814773e-06,0,0
10496,tedros,1,1.8364528545823171e-06,1,2.2780963315814773e-06,0,0
10495,self-explanatory,1,1.8364528545823171e-06,1,2.2780963315814773e-06,0,0
10500,outmastered,1,1.8364528545823171e-06,1,2.2780963315814773e-06,0,0
10502,macdonald,1,1.8364528545823171e-06,1,2.2780963315814773e-06,0,0
10507,mend,1,1.8364528545823171e-06,1,2.2780963315814773e-06,0,0
10512,disapproval,1,1.8364528545823171e-06,1,2.2780963315814773e-06,0,0
10519,unfriendly,1,1.8364528545823171e-06,1,2.2780963315814773e-06,0,0
10517,mops,1,1.8364528545823171e-06,1,2.2780963315814773e-06,0,0
10514,buckets,1,1.8364528545823171e-06,1,2.2780963315814773e-06,0,0
10520,@leesmithdc,1,1.8364528545823171e-06,1,2.2780963315814773e-06,0,0
10532,citadel,1,1.8364528545823171e-06,1,2.2780963315814773e-06,0,0
10534,carpet,1,1.8364528545823171e-06,1,2.2780963315814773e-06,0,0
10536,impeachmen,1,1.8364528545823171e-06,1,2.2780963315814773e-06,0,0
10540,prime-time,1,1.8364528545823171e-06,1,2.2780963315814773e-06,0,0
10541,sitcom,1,1.8364528545823171e-06,1,2.2780963315814773e-06,0,0
10552,ossof,1,1.8364528545823171e-06,1,2.2780963315814773e-06,0,0
10553,grynbaum,1,1.8364528545823171e-06,1,2.2780963315814773e-06,0,0
10554,touching,1,1.8364528545823171e-06,1,2.2780963315814773e-06,0,0
10555,punching,1,1.8364528545823171e-06,1,2.2780963315814773e-06,0,0
10557,#gasen,1,1.8364528545823171e-06,1,2.2780963315814773e-06,0,0
10560,reviving,1,1.8364528545823171e-06,1,2.2780963315814773e-06,0,0
10567,184m,1,1.8364528545823171e-06,1,2.2780963315814773e-06,0,0
10570,700m,1,1.8364528545823171e-06,1,2.2780963315814773e-06,0,0
10571,@flysfo,1,1.8364528545823171e-06,1,2.2780963315814773e-06,0,0
10573,@sfmtamuni,1,1.8364528545823171e-06,1,2.2780963315814773e-06,0,0
10572,@sfbart,1,1.8364528545823171e-06,1,2.2780963315814773e-06,0,0
10579,dcs,1,1.8364528545823171e-06,1,2.2780963315814773e-06,0,0
10577,@wmata,1,1.8364528545823171e-06,1,2.2780963315814773e-06,0,0
10575,876m,1,1.8364528545823171e-06,1,2.2780963315814773e-06,0,0
10584,#nh01,1,1.8364528545823171e-06,1,2.2780963315814773e-06,0,0
10586,@guestcongress,1,1.8364528545823171e-06,1,2.2780963315814773e-06,0,0
10588,@foxnetworks,1,1.8364528545823171e-06,1,2.2780963315814773e-06,0,0
10593,hospitalsbeds,1,1.8364528545823171e-06,1,2.2780963315814773e-06,0,0
10595,@stevenpalazzo,1,1.8364528545823171e-06,1,2.2780963315814773e-06,0,0
10597,paydirt,1,1.8364528545823171e-06,1,2.2780963315814773e-06,0,0
10600,politicization,1,1.8364528545823171e-06,1,2.2780963315814773e-06,0,0
10601,88022,1,1.8364528545823171e-06,1,2.2780963315814773e-06,0,0
10616,freeriding,1,1.8364528545823171e-06,1,2.2780963315814773e-06,0,0
10617,middlemen,1,1.8364528545823171e-06,1,2.2780963315814773e-06,0,0
10618,@repchiproy,1,1.8364528545823171e-06,1,2.2780963315814773e-06,0,0
10620,tiff,1,1.8364528545823171e-06,1,2.2780963315814773e-06,0,0
10622,#buildingthewall,1,1.8364528545823171e-06,1,2.2780963315814773e-06,0,0
10630,re-rememberthey,1,1.8364528545823171e-06,1,2.2780963315814773e-06,0,0
10632,#afbf2020,1,1.8364528545823171e-06,1,2.2780963315814773e-06,0,0
10637,1963-1986,1,1.8364528545823171e-06,1,2.2780963315814773e-06,0,0
10638,4256,1,1.8364528545823171e-06,1,2.2780963315814773e-06,0,0
10639,gambled,1,1.8364528545823171e-06,1,2.2780963315814773e-06,0,0
10643,@richlowry,1,1.8364528545823171e-06,1,2.2780963315814773e-06,0,0
10646,@soundtransit,1,1.8364528545823171e-06,1,2.2780963315814773e-06,0,0
10645,166m,1,1.8364528545823171e-06,1,2.2780963315814773e-06,0,0
10651,roadside,1,1.8364528545823171e-06,1,2.2780963315814773e-06,0,0
10654,hypocrisy,1,1.8364528545823171e-06,1,2.2780963315814773e-06,0,0
10655,exporters,1,1.8364528545823171e-06,1,2.2780963315814773e-06,0,0
10661,theatrics,1,1.8364528545823171e-06,1,2.2780963315814773e-06,0,0
10669,goa,1,1.8364528545823171e-06,1,2.2780963315814773e-06,0,0
10670,helpstimulus,1,1.8364528545823171e-06,1,2.2780963315814773e-06,0,0
10671,junk,1,1.8364528545823171e-06,1,2.2780963315814773e-06,0,0
10673,@lasdhq,1,1.8364528545823171e-06,1,2.2780963315814773e-06,0,0
10683,replied,1,1.8364528545823171e-06,1,2.2780963315814773e-06,0,0
10681,furthermore,1,1.8364528545823171e-06,1,2.2780963315814773e-06,0,0
10686,apologizes,1,1.8364528545823171e-06,1,2.2780963315814773e-06,0,0
10687,coincidence,1,1.8364528545823171e-06,1,2.2780963315814773e-06,0,0
10691,precinct,1,1.8364528545823171e-06,1,2.2780963315814773e-06,0,0
10690,courthouses,1,1.8364528545823171e-06,1,2.2780963315814773e-06,0,0
10697,loyally,1,1.8364528545823171e-06,1,2.2780963315814773e-06,0,0
10698,recuses,1,1.8364528545823171e-06,1,2.2780963315814773e-06,0,0
10699,120m,1,1.8364528545823171e-06,1,2.2780963315814773e-06,0,0
10702,gilcrease,1,1.8364528545823171e-06,1,2.2780963315814773e-06,0,0
10701,expressway,1,1.8364528545823171e-06,1,2.2780963315814773e-06,0,0
10706,#nationaldoctorsday,1,1.8364528545823171e-06,1,2.2780963315814773e-06,0,0
10708,diseases,1,1.8364528545823171e-06,1,2.2780963315814773e-06,0,0
10711,waver,1,1.8364528545823171e-06,1,2.2780963315814773e-06,0,0
10713,velocity,1,1.8364528545823171e-06,1,2.2780963315814773e-06,0,0
10719,#openjoecoldcase,1,1.8364528545823171e-06,1,2.2780963315814773e-06,0,0
10729,spoiler,1,1.8364528545823171e-06,1,2.2780963315814773e-06,0,0
10733,spokesman,1,1.8364528545823171e-06,1,2.2780963315814773e-06,0,0
10731,deflect,1,1.8364528545823171e-06,1,2.2780963315814773e-06,0,0
10734,follower,1,1.8364528545823171e-06,1,2.2780963315814773e-06,0,0
10735,@ericgarcetti,1,1.8364528545823171e-06,1,2.2780963315814773e-06,0,0
10741,fabricates,1,1.8364528545823171e-06,1,2.2780963315814773e-06,0,0
10746,#rollingtoremember,1,1.8364528545823171e-06,1,2.2780963315814773e-06,0,0
10748,lifeand,1,1.8364528545823171e-06,1,2.2780963315814773e-06,0,0
10765,reagans,1,1.8364528545823171e-06,1,2.2780963315814773e-06,0,0
10771,@mdaviation,1,1.8364528545823171e-06,1,2.2780963315814773e-06,0,0
10770,878m,1,1.8364528545823171e-06,1,2.2780963315814773e-06,0,0
10774,@latinocoalition,1,1.8364528545823171e-06,1,2.2780963315814773e-06,0,0
10777,@rogermarshallmd,1,1.8364528545823171e-06,1,2.2780963315814773e-06,0,0
10783,transitioning,1,1.8364528545823171e-06,1,2.2780963315814773e-06,0,0
10784,498m,1,1.8364528545823171e-06,1,2.2780963315814773e-06,0,0
10785,@dallaslovefield,1,1.8364528545823171e-06,1,2.2780963315814773e-06,0,0
10787,hub,1,1.8364528545823171e-06,1,2.2780963315814773e-06,0,0
10795,dart,1,1.8364528545823171e-06,1,2.2780963315814773e-06,0,0
10792,229m,1,1.8364528545823171e-06,1,2.2780963315814773e-06,0,0
10793,@dartmedia,1,1.8364528545823171e-06,1,2.2780963315814773e-06,0,0
10799,@serenawilliams,1,1.8364528545823171e-06,1,2.2780963315814773e-06,0,0
10800,@cdc,1,1.8364528545823171e-06,1,2.2780963315814773e-06,0,0
10804,hesitate,1,1.8364528545823171e-06,1,2.2780963315814773e-06,0,0
10807,laughs,1,1.8364528545823171e-06,1,2.2780963315814773e-06,0,0
10811,@deanbaquet,1,1.8364528545823171e-06,1,2.2780963315814773e-06,0,0
10812,figuring,1,1.8364528545823171e-06,1,2.2780963315814773e-06,0,0
10838,exacty,1,1.8364528545823171e-06,1,2.2780963315814773e-06,0,0
10840,nycs,1,1.8364528545823171e-06,1,2.2780963315814773e-06,0,0
10843,niel,1,1.8364528545823171e-06,1,2.2780963315814773e-06,0,0
10841,cavuto,1,1.8364528545823171e-06,1,2.2780963315814773e-06,0,0
10844,nullified,1,1.8364528545823171e-06,1,2.2780963315814773e-06,0,0
10846,littered,1,1.8364528545823171e-06,1,2.2780963315814773e-06,0,0
10847,schumerite,1,1.8364528545823171e-06,1,2.2780963315814773e-06,0,0
10850,scheller,1,1.8364528545823171e-06,1,2.2780963315814773e-06,0,0
10849,@schellerforpa,1,1.8364528545823171e-06,1,2.2780963315814773e-06,0,0
10848,#pa07,1,1.8364528545823171e-06,1,2.2780963315814773e-06,0,0
10851,automobils,1,1.8364528545823171e-06,1,2.2780963315814773e-06,0,0
10859,themand,1,1.8364528545823171e-06,1,2.2780963315814773e-06,0,0
10856,droned,1,1.8364528545823171e-06,1,2.2780963315814773e-06,0,0
10858,soleimaniplainly,1,1.8364528545823171e-06,1,2.2780963315814773e-06,0,0
10861,warmonger,1,1.8364528545823171e-06,1,2.2780963315814773e-06,0,0
10865,@youngforiowa,1,1.8364528545823171e-06,1,2.2780963315814773e-06,0,0
10864,#ia03,1,1.8364528545823171e-06,1,2.2780963315814773e-06,0,0
10871,incurred,1,1.8364528545823171e-06,1,2.2780963315814773e-06,0,0
10882,procedural,1,1.8364528545823171e-06,1,2.2780963315814773e-06,0,0
10883,thirds,1,1.8364528545823171e-06,1,2.2780963315814773e-06,0,0
10885,disbursed,1,1.8364528545823171e-06,1,2.2780963315814773e-06,0,0
10891,meuser,1,1.8364528545823171e-06,1,2.2780963315814773e-06,0,0
10890,@meuser4congress,1,1.8364528545823171e-06,1,2.2780963315814773e-06,0,0
10889,#pa09,1,1.8364528545823171e-06,1,2.2780963315814773e-06,0,0
10896,relation,1,1.8364528545823171e-06,1,2.2780963315814773e-06,0,0
10897,signatories,1,1.8364528545823171e-06,1,2.2780963315814773e-06,0,0
10894,malign,1,1.8364528545823171e-06,1,2.2780963315814773e-06,0,0
10895,overlooked,1,1.8364528545823171e-06,1,2.2780963315814773e-06,0,0
10900,#pa11,1,1.8364528545823171e-06,1,2.2780963315814773e-06,0,0
10905,extort,1,1.8364528545823171e-06,1,2.2780963315814773e-06,0,0
10910,@patriotsperry,1,1.8364528545823171e-06,1,2.2780963315814773e-06,0,0
10909,#pa10,1,1.8364528545823171e-06,1,2.2780963315814773e-06,0,0
10914,@votefredkeller,1,1.8364528545823171e-06,1,2.2780963315814773e-06,0,0
10913,#pa12,1,1.8364528545823171e-06,1,2.2780963315814773e-06,0,0
10921,thompson,1,1.8364528545823171e-06,1,2.2780963315814773e-06,0,0
10917,@gtteamgt,1,1.8364528545823171e-06,1,2.2780963315814773e-06,0,0
10916,#pa15,1,1.8364528545823171e-06,1,2.2780963315814773e-06,0,0
10928,abiding,1,1.8364528545823171e-06,1,2.2780963315814773e-06,0,0
10931,vehicles,1,1.8364528545823171e-06,1,2.2780963315814773e-06,0,0
10930,clunkers,1,1.8364528545823171e-06,1,2.2780963315814773e-06,0,0
10933,auburn,1,1.8364528545823171e-06,1,2.2780963315814773e-06,0,0
10935,298m,1,1.8364528545823171e-06,1,2.2780963315814773e-06,0,0
10938,@mta,1,1.8364528545823171e-06,1,2.2780963315814773e-06,0,0
10936,2b,1,1.8364528545823171e-06,1,2.2780963315814773e-06,0,0
10939,aiding,1,1.8364528545823171e-06,1,2.2780963315814773e-06,0,0
10941,@mikekellyforpa,1,1.8364528545823171e-06,1,2.2780963315814773e-06,0,0
10940,#pa16,1,1.8364528545823171e-06,1,2.2780963315814773e-06,0,0
10943,outnumbered,1,1.8364528545823171e-06,1,2.2780963315814773e-06,0,0
10946,#navy245,1,1.8364528545823171e-06,1,2.2780963315814773e-06,0,0
10953,#pa17,1,1.8364528545823171e-06,1,2.2780963315814773e-06,0,0
10954,pillage,1,1.8364528545823171e-06,1,2.2780963315814773e-06,0,0
10957,hose,1,1.8364528545823171e-06,1,2.2780963315814773e-06,0,0
10959,@reprwilliams,1,1.8364528545823171e-06,1,2.2780963315814773e-06,0,0
10960,convicts,1,1.8364528545823171e-06,1,2.2780963315814773e-06,0,0
10963,reschenthaler,1,1.8364528545823171e-06,1,2.2780963315814773e-06,0,0
10962,@reschenthaler,1,1.8364528545823171e-06,1,2.2780963315814773e-06,0,0
10961,#pa14,1,1.8364528545823171e-06,1,2.2780963315814773e-06,0,0
10966,joyce,1,1.8364528545823171e-06,1,2.2780963315814773e-06,0,0
10965,@johnjoyceforpa,1,1.8364528545823171e-06,1,2.2780963315814773e-06,0,0
10964,#pa13,1,1.8364528545823171e-06,1,2.2780963315814773e-06,0,0
10967,3500,1,1.8364528545823171e-06,1,2.2780963315814773e-06,0,0
10970,#nhsen,1,1.8364528545823171e-06,1,2.2780963315814773e-06,0,0
10977,@judgejohncarter,1,1.8364528545823171e-06,1,2.2780963315814773e-06,0,0
10980,newark,1,1.8364528545823171e-06,1,2.2780963315814773e-06,0,0
10981,portal,1,1.8364528545823171e-06,1,2.2780963315814773e-06,0,0
10983,@govmurphy,1,1.8364528545823171e-06,1,2.2780963315814773e-06,0,0
10999,خطاب,1,1.8364528545823171e-06,1,2.2780963315814773e-06,0,0
11011,نكشيد,1,1.8364528545823171e-06,1,2.2780963315814773e-06,0,0
11012,هزاران,1,1.8364528545823171e-06,1,2.2780963315814773e-06,0,0
10996,تن,1,1.8364528545823171e-06,1,2.2780963315814773e-06,0,0
10995,تاكنون,1,1.8364528545823171e-06,1,2.2780963315814773e-06,0,0
11005,كشته,1,1.8364528545823171e-06,1,2.2780963315814773e-06,0,0
11014,يا,1,1.8364528545823171e-06,1,2.2780963315814773e-06,0,0
11002,زنداني,1,1.8364528545823171e-06,1,2.2780963315814773e-06,0,0
10990,اند،,1,1.8364528545823171e-06,1,2.2780963315814773e-06,0,0
11010,مهمتر,1,1.8364528545823171e-06,1,2.2780963315814773e-06,0,0
10989,ان،,1,1.8364528545823171e-06,1,2.2780963315814773e-06,0,0
10991,ايالات,1,1.8364528545823171e-06,1,2.2780963315814773e-06,0,0
10993,اينترنت,1,1.8364528545823171e-06,1,2.2780963315814773e-06,0,0
11013,وصل,1,1.8364528545823171e-06,1,2.2780963315814773e-06,0,0
10998,خبرنگاران,1,1.8364528545823171e-06,1,2.2780963315814773e-06,0,0
11001,دهيد,1,1.8364528545823171e-06,1,2.2780963315814773e-06,0,0
10988,ازادانه,1,1.8364528545823171e-06,1,2.2780963315814773e-06,0,0
10997,حركت,1,1.8364528545823171e-06,1,2.2780963315814773e-06,0,0
11006,كنند,1,1.8364528545823171e-06,1,2.2780963315814773e-06,0,0
11004,كشتار,1,1.8364528545823171e-06,1,2.2780963315814773e-06,0,0
10994,بزرگ,1,1.8364528545823171e-06,1,2.2780963315814773e-06,0,0
11009,متوقف,1,1.8364528545823171e-06,1,2.2780963315814773e-06,0,0
11015,@txrandy14,1,1.8364528545823171e-06,1,2.2780963315814773e-06,0,0
11020,@atlasairww,1,1.8364528545823171e-06,1,2.2780963315814773e-06,0,0
11021,observance,1,1.8364528545823171e-06,1,2.2780963315814773e-06,0,0
11027,fuse,1,1.8364528545823171e-06,1,2.2780963315814773e-06,0,0
11031,problem-didnt,1,1.8364528545823171e-06,1,2.2780963315814773e-06,0,0
11036,non-sanctuary,1,1.8364528545823171e-06,1,2.2780963315814773e-06,0,0
11041,oversee,1,1.8364528545823171e-06,1,2.2780963315814773e-06,0,0
11044,@scaramucci,1,1.8364528545823171e-06,1,2.2780963315814773e-06,0,0
11048,#cincodemayo,1,1.8364528545823171e-06,1,2.2780963315814773e-06,0,0
11053,hardliners,1,1.8364528545823171e-06,1,2.2780963315814773e-06,0,0
11062,proxies,1,1.8364528545823171e-06,1,2.2780963315814773e-06,0,0
11063,sneak,1,1.8364528545823171e-06,1,2.2780963315814773e-06,0,0
11067,502,1,1.8364528545823171e-06,1,2.2780963315814773e-06,0,0
11066,455,1,1.8364528545823171e-06,1,2.2780963315814773e-06,0,0
11069,percentthis,1,1.8364528545823171e-06,1,2.2780963315814773e-06,0,0
11075,indemnification,1,1.8364528545823171e-06,1,2.2780963315814773e-06,0,0
11074,ent,1,1.8364528545823171e-06,1,2.2780963315814773e-06,0,0
11078,distributing,1,1.8364528545823171e-06,1,2.2780963315814773e-06,0,0
11079,credence,1,1.8364528545823171e-06,1,2.2780963315814773e-06,0,0
11080,dismissal,1,1.8364528545823171e-06,1,2.2780963315814773e-06,0,0
11084,capito,1,1.8364528545823171e-06,1,2.2780963315814773e-06,0,0
11083,@capitoforwv,1,1.8364528545823171e-06,1,2.2780963315814773e-06,0,0
11086,primarythree,1,1.8364528545823171e-06,1,2.2780963315814773e-06,0,0
11088,gutfeld,1,1.8364528545823171e-06,1,2.2780963315814773e-06,0,0
11087,colbert,1,1.8364528545823171e-06,1,2.2780963315814773e-06,0,0
11091,placer,1,1.8364528545823171e-06,1,2.2780963315814773e-06,0,0
11090,kimmel,1,1.8364528545823171e-06,1,2.2780963315814773e-06,0,0
11092,scratch,1,1.8364528545823171e-06,1,2.2780963315814773e-06,0,0
11098,stocked,1,1.8364528545823171e-06,1,2.2780963315814773e-06,0,0
11102,insatiable,1,1.8364528545823171e-06,1,2.2780963315814773e-06,0,0
11099,appetites,1,1.8364528545823171e-06,1,2.2780963315814773e-06,0,0
11104,narrowed,1,1.8364528545823171e-06,1,2.2780963315814773e-06,0,0
11103,gettysburg,1,1.8364528545823171e-06,1,2.2780963315814773e-06,0,0
11112,ar,1,1.8364528545823171e-06,1,2.2780963315814773e-06,0,0
11113,@katrinapierson,1,1.8364528545823171e-06,1,2.2780963315814773e-06,0,0
11117,ststement,1,1.8364528545823171e-06,1,2.2780963315814773e-06,0,0
11129,ricketts,1,1.8364528545823171e-06,1,2.2780963315814773e-06,0,0
11125,businessmen,1,1.8364528545823171e-06,1,2.2780963315814773e-06,0,0
11127,luckier,1,1.8364528545823171e-06,1,2.2780963315814773e-06,0,0
11132,rabid,1,1.8364528545823171e-06,1,2.2780963315814773e-06,0,0
11150,holdover,1,1.8364528545823171e-06,1,2.2780963315814773e-06,0,0
11148,claen,1,1.8364528545823171e-06,1,2.2780963315814773e-06,0,0
11154,paramountly,1,1.8364528545823171e-06,1,2.2780963315814773e-06,0,0
11153,kent,1,1.8364528545823171e-06,1,2.2780963315814773e-06,0,0
11160,#newhoaxsameswamp,1,1.8364528545823171e-06,1,2.2780963315814773e-06,0,0
11187,مشاور,1,1.8364528545823171e-06,1,2.2780963315814773e-06,0,0
11167,امنیت,1,1.8364528545823171e-06,1,2.2780963315814773e-06,0,0
11188,ملی,1,1.8364528545823171e-06,1,2.2780963315814773e-06,0,0
11166,امروز,1,1.8364528545823171e-06,1,2.2780963315814773e-06,0,0
11179,عنوان,1,1.8364528545823171e-06,1,2.2780963315814773e-06,0,0
11197,کرد,1,1.8364528545823171e-06,1,2.2780963315814773e-06,0,0
11183,كه,1,1.8364528545823171e-06,1,2.2780963315814773e-06,0,0
11164,اعتراضات،,1,1.8364528545823171e-06,1,2.2780963315814773e-06,0,0
11176,را«به,1,1.8364528545823171e-06,1,2.2780963315814773e-06,0,0
11178,شدت,1,1.8364528545823171e-06,1,2.2780963315814773e-06,0,0
11172,تحت,1,1.8364528545823171e-06,1,2.2780963315814773e-06,0,0
11181,فشار»قرار,1,1.8364528545823171e-06,1,2.2780963315814773e-06,0,0
11175,داده,1,1.8364528545823171e-06,1,2.2780963315814773e-06,0,0
11184,مجبور,1,1.8364528545823171e-06,1,2.2780963315814773e-06,0,0
11185,مذاكره,1,1.8364528545823171e-06,1,2.2780963315814773e-06,0,0
11182,كنددر,1,1.8364528545823171e-06,1,2.2780963315814773e-06,0,0
11195,واقع،,1,1.8364528545823171e-06,1,2.2780963315814773e-06,0,0
11163,اصلا,1,1.8364528545823171e-06,1,2.2780963315814773e-06,0,0
11171,برایم,1,1.8364528545823171e-06,1,2.2780963315814773e-06,0,0
11168,اهمیتی,1,1.8364528545823171e-06,1,2.2780963315814773e-06,0,0
11189,نداردکه,1,1.8364528545823171e-06,1,2.2780963315814773e-06,0,0
11161,آیا,1,1.8364528545823171e-06,1,2.2780963315814773e-06,0,0
11191,نهاین,1,1.8364528545823171e-06,1,2.2780963315814773e-06,0,0
11196,کاملاً,1,1.8364528545823171e-06,1,2.2780963315814773e-06,0,0
11180,عهده,1,1.8364528545823171e-06,1,2.2780963315814773e-06,0,0
11174,خودشان,1,1.8364528545823171e-06,1,2.2780963315814773e-06,0,0
11162,است،,1,1.8364528545823171e-06,1,2.2780963315814773e-06,0,0
11177,سلاح,1,1.8364528545823171e-06,1,2.2780963315814773e-06,0,0
11194,هسته,1,1.8364528545823171e-06,1,2.2780963315814773e-06,0,0
11169,ای,1,1.8364528545823171e-06,1,2.2780963315814773e-06,0,0
11190,نداشته,1,1.8364528545823171e-06,1,2.2780963315814773e-06,0,0
11170,باشیدو«معترضان,1,1.8364528545823171e-06,1,2.2780963315814773e-06,0,0
11192,نکشید»,1,1.8364528545823171e-06,1,2.2780963315814773e-06,0,0
11198,3280,1,1.8364528545823171e-06,1,2.2780963315814773e-06,0,0
11201,student-athletes,1,1.8364528545823171e-06,1,2.2780963315814773e-06,0,0
11199,#wewanttoplay,1,1.8364528545823171e-06,1,2.2780963315814773e-06,0,0
11202,#nationalteacherday,1,1.8364528545823171e-06,1,2.2780963315814773e-06,0,0
11205,instilling,1,1.8364528545823171e-06,1,2.2780963315814773e-06,0,0
11209,unmitigated,1,1.8364528545823171e-06,1,2.2780963315814773e-06,0,0
11212,bath,1,1.8364528545823171e-06,1,2.2780963315814773e-06,0,0
11217,s6,1,1.8364528545823171e-06,1,2.2780963315814773e-06,0,0
11218,tentative,1,1.8364528545823171e-06,1,2.2780963315814773e-06,0,0
11215,gd,1,1.8364528545823171e-06,1,2.2780963315814773e-06,0,0
11211,arleigh-burke,1,1.8364528545823171e-06,1,2.2780963315814773e-06,0,0
11213,destroyers,1,1.8364528545823171e-06,1,2.2780963315814773e-06,0,0
11223,munchkin,1,1.8364528545823171e-06,1,2.2780963315814773e-06,0,0
11225,2009-10,1,1.8364528545823171e-06,1,2.2780963315814773e-06,0,0
11224,13000,1,1.8364528545823171e-06,1,2.2780963315814773e-06,0,0
11226,@ronaldklain,1,1.8364528545823171e-06,1,2.2780963315814773e-06,0,0
11229,nan,1,1.8364528545823171e-06,1,2.2780963315814773e-06,0,0
11237,mbs,1,1.8364528545823171e-06,1,2.2780963315814773e-06,0,0
11241,adriana,1,1.8364528545823171e-06,1,2.2780963315814773e-06,0,0
11245,competence,1,1.8364528545823171e-06,1,2.2780963315814773e-06,0,0
11247,30-day,1,1.8364528545823171e-06,1,2.2780963315814773e-06,0,0
11258,s216spokane,1,1.8364528545823171e-06,1,2.2780963315814773e-06,0,0
11259,s256native,1,1.8364528545823171e-06,1,2.2780963315814773e-06,0,0
11257,languages,1,1.8364528545823171e-06,1,2.2780963315814773e-06,0,0
11255,2870,1,1.8364528545823171e-06,1,2.2780963315814773e-06,0,0
11260,shell,1,1.8364528545823171e-06,1,2.2780963315814773e-06,0,0
11256,chippewa,1,1.8364528545823171e-06,1,2.2780963315814773e-06,0,0
11267,schumers,1,1.8364528545823171e-06,1,2.2780963315814773e-06,0,0
11266,misplaced,1,1.8364528545823171e-06,1,2.2780963315814773e-06,0,0
11265,mcginley,1,1.8364528545823171e-06,1,2.2780963315814773e-06,0,0
11268,kristy,1,1.8364528545823171e-06,1,2.2780963315814773e-06,0,0
11271,@howardkurtz,1,1.8364528545823171e-06,1,2.2780963315814773e-06,0,0
11276,mvp,1,1.8364528545823171e-06,1,2.2780963315814773e-06,0,0
11275,heckler,1,1.8364528545823171e-06,1,2.2780963315814773e-06,0,0
11277,@larrysabato,1,1.8364528545823171e-06,1,2.2780963315814773e-06,0,0
11283,monahan,1,1.8364528545823171e-06,1,2.2780963315814773e-06,0,0
11289,pocahontus,1,1.8364528545823171e-06,1,2.2780963315814773e-06,0,0
11288,feud,1,1.8364528545823171e-06,1,2.2780963315814773e-06,0,0
11287,brewing,1,1.8364528545823171e-06,1,2.2780963315814773e-06,0,0
11291,3m,1,1.8364528545823171e-06,1,2.2780963315814773e-06,0,0
11294,survailence,1,1.8364528545823171e-06,1,2.2780963315814773e-06,0,0
11297,audrey,1,1.8364528545823171e-06,1,2.2780963315814773e-06,0,0
11299,eminent,1,1.8364528545823171e-06,1,2.2780963315814773e-06,0,0
11300,heals,1,1.8364528545823171e-06,1,2.2780963315814773e-06,0,0
11301,rafical,1,1.8364528545823171e-06,1,2.2780963315814773e-06,0,0
11308,reluctance,1,1.8364528545823171e-06,1,2.2780963315814773e-06,0,0
11310,@drudge,1,1.8364528545823171e-06,1,2.2780963315814773e-06,0,0
11312,revolver,1,1.8364528545823171e-06,1,2.2780963315814773e-06,0,0
11316,trample,1,1.8364528545823171e-06,1,2.2780963315814773e-06,0,0
11322,forensic,1,1.8364528545823171e-06,1,2.2780963315814773e-06,0,0
11327,abcs,1,1.8364528545823171e-06,1,2.2780963315814773e-06,0,0
11328,surveyed,1,1.8364528545823171e-06,1,2.2780963315814773e-06,0,0
11325,533,1,1.8364528545823171e-06,1,2.2780963315814773e-06,0,0
11326,@thenatpulse,1,1.8364528545823171e-06,1,2.2780963315814773e-06,0,0
11336,#sotu2020,1,1.8364528545823171e-06,1,2.2780963315814773e-06,0,0
11339,bernalillo,1,1.8364528545823171e-06,1,2.2780963315814773e-06,0,0
11343,derecho,1,1.8364528545823171e-06,1,2.2780963315814773e-06,0,0
11344,midway,1,1.8364528545823171e-06,1,2.2780963315814773e-06,0,0
11351,publics,1,1.8364528545823171e-06,1,2.2780963315814773e-06,0,0
11349,deafness,1,1.8364528545823171e-06,1,2.2780963315814773e-06,0,0
11350,intolerable,1,1.8364528545823171e-06,1,2.2780963315814773e-06,0,0
11355,trajectory,1,1.8364528545823171e-06,1,2.2780963315814773e-06,0,0
11353,griff,1,1.8364528545823171e-06,1,2.2780963315814773e-06,0,0
11359,urgently,1,1.8364528545823171e-06,1,2.2780963315814773e-06,0,0
11365,uptick,1,1.8364528545823171e-06,1,2.2780963315814773e-06,0,0
11371,@bradyfortexas,1,1.8364528545823171e-06,1,2.2780963315814773e-06,0,0
11378,socialistcommunist,1,1.8364528545823171e-06,1,2.2780963315814773e-06,0,0
11383,purchaes,1,1.8364528545823171e-06,1,2.2780963315814773e-06,0,0
11390,nonbeliever,1,1.8364528545823171e-06,1,2.2780963315814773e-06,0,0
11395,rena,1,1.8364528545823171e-06,1,2.2780963315814773e-06,0,0
11397,anne,1,1.8364528545823171e-06,1,2.2780963315814773e-06,0,0
11398,gohmert,1,1.8364528545823171e-06,1,2.2780963315814773e-06,0,0
11399,uncle,1,1.8364528545823171e-06,1,2.2780963315814773e-06,0,0
11401,defeatedtrump,1,1.8364528545823171e-06,1,2.2780963315814773e-06,0,0
11402,villazon,1,1.8364528545823171e-06,1,2.2780963315814773e-06,0,0
11407,emotion,1,1.8364528545823171e-06,1,2.2780963315814773e-06,0,0
11414,lucrative,1,1.8364528545823171e-06,1,2.2780963315814773e-06,0,0
11417,abusive,1,1.8364528545823171e-06,1,2.2780963315814773e-06,0,0
11423,surreal,1,1.8364528545823171e-06,1,2.2780963315814773e-06,0,0
11422,electronically,1,1.8364528545823171e-06,1,2.2780963315814773e-06,0,0
11421,ceased,1,1.8364528545823171e-06,1,2.2780963315814773e-06,0,0
11425,@jimpressoffice,1,1.8364528545823171e-06,1,2.2780963315814773e-06,0,0
11431,veronica,1,1.8364528545823171e-06,1,2.2780963315814773e-06,0,0
11428,escobar,1,1.8364528545823171e-06,1,2.2780963315814773e-06,0,0
11434,bryce,1,1.8364528545823171e-06,1,2.2780963315814773e-06,0,0
11432,@colbycovmma,1,1.8364528545823171e-06,1,2.2780963315814773e-06,0,0
11435,#throwbackthursday🇺🇸,1,1.8364528545823171e-06,1,2.2780963315814773e-06,0,0
11438,philip,1,1.8364528545823171e-06,1,2.2780963315814773e-06,0,0
11439,non-threatening,1,1.8364528545823171e-06,1,2.2780963315814773e-06,0,0
11441,housewife,1,1.8364528545823171e-06,1,2.2780963315814773e-06,0,0
11442,reinstall,1,1.8364528545823171e-06,1,2.2780963315814773e-06,0,0
11443,innocence,1,1.8364528545823171e-06,1,2.2780963315814773e-06,0,0
11444,@govchristie,1,1.8364528545823171e-06,1,2.2780963315814773e-06,0,0
11446,establishments,1,1.8364528545823171e-06,1,2.2780963315814773e-06,0,0
11447,@greglaurie,1,1.8364528545823171e-06,1,2.2780963315814773e-06,0,0
11448,@harvestorg,1,1.8364528545823171e-06,1,2.2780963315814773e-06,0,0
11450,riverside,1,1.8364528545823171e-06,1,2.2780963315814773e-06,0,0
11455,worldincluding,1,1.8364528545823171e-06,1,2.2780963315814773e-06,0,0
11456,@billmaher,1,1.8364528545823171e-06,1,2.2780963315814773e-06,0,0
11458,gaunt,1,1.8364528545823171e-06,1,2.2780963315814773e-06,0,0
11459,faculty,1,1.8364528545823171e-06,1,2.2780963315814773e-06,0,0
11460,108,1,1.8364528545823171e-06,1,2.2780963315814773e-06,0,0
11461,scrutinized,1,1.8364528545823171e-06,1,2.2780963315814773e-06,0,0
11463,sidelined,1,1.8364528545823171e-06,1,2.2780963315814773e-06,0,0
11464,greene,1,1.8364528545823171e-06,1,2.2780963315814773e-06,0,0
11468,quarantined,1,1.8364528545823171e-06,1,2.2780963315814773e-06,0,0
11467,kits,1,1.8364528545823171e-06,1,2.2780963315814773e-06,0,0
11475,clyde,1,1.8364528545823171e-06,1,2.2780963315814773e-06,0,0
11474,#ga09,1,1.8364528545823171e-06,1,2.2780963315814773e-06,0,0
11477,bridgegate,1,1.8364528545823171e-06,1,2.2780963315814773e-06,0,0
11480,gloves,1,1.8364528545823171e-06,1,2.2780963315814773e-06,0,0
11481,gowns,1,1.8364528545823171e-06,1,2.2780963315814773e-06,0,0
11482,plentiful,1,1.8364528545823171e-06,1,2.2780963315814773e-06,0,0
11483,subtract,1,1.8364528545823171e-06,1,2.2780963315814773e-06,0,0
11485,shields,1,1.8364528545823171e-06,1,2.2780963315814773e-06,0,0
11488,evan,1,1.8364528545823171e-06,1,2.2780963315814773e-06,0,0
11491,mcmuffin,1,1.8364528545823171e-06,1,2.2780963315814773e-06,0,0
11492,mcmullin,1,1.8364528545823171e-06,1,2.2780963315814773e-06,0,0
11489,galvin,1,1.8364528545823171e-06,1,2.2780963315814773e-06,0,0
11490,horn,1,1.8364528545823171e-06,1,2.2780963315814773e-06,0,0
11496,moonface,1,1.8364528545823171e-06,1,2.2780963315814773e-06,0,0
11497,weaver,1,1.8364528545823171e-06,1,2.2780963315814773e-06,0,0
11505,timer,1,1.8364528545823171e-06,1,2.2780963315814773e-06,0,0
11504,copied,1,1.8364528545823171e-06,1,2.2780963315814773e-06,0,0
11506,@dancrenshawtx,1,1.8364528545823171e-06,1,2.2780963315814773e-06,0,0
11507,13m,1,1.8364528545823171e-06,1,2.2780963315814773e-06,0,0
11508,@martaservice,1,1.8364528545823171e-06,1,2.2780963315814773e-06,0,0
11510,militant,1,1.8364528545823171e-06,1,2.2780963315814773e-06,0,0
11512,wimpier,1,1.8364528545823171e-06,1,2.2780963315814773e-06,0,0
11524,torches,1,1.8364528545823171e-06,1,2.2780963315814773e-06,0,0
11525,@marialeetn,1,1.8364528545823171e-06,1,2.2780963315814773e-06,0,0
11526,@ppploan,1,1.8364528545823171e-06,1,2.2780963315814773e-06,0,0
11530,juneteenth,1,1.8364528545823171e-06,1,2.2780963315814773e-06,0,0
11534,straightened,1,1.8364528545823171e-06,1,2.2780963315814773e-06,0,0
11540,suspects,1,1.8364528545823171e-06,1,2.2780963315814773e-06,0,0
11541,congregants,1,1.8364528545823171e-06,1,2.2780963315814773e-06,0,0
11542,proficient,1,1.8364528545823171e-06,1,2.2780963315814773e-06,0,0
11547,sheryl,1,1.8364528545823171e-06,1,2.2780963315814773e-06,0,0
11551,mailboxes,1,1.8364528545823171e-06,1,2.2780963315814773e-06,0,0
11550,forgeries,1,1.8364528545823171e-06,1,2.2780963315814773e-06,0,0
11549,forge,1,1.8364528545823171e-06,1,2.2780963315814773e-06,0,0
11558,inadequate,1,1.8364528545823171e-06,1,2.2780963315814773e-06,0,0
11561,brownouts,1,1.8364528545823171e-06,1,2.2780963315814773e-06,0,0
11563,propped,1,1.8364528545823171e-06,1,2.2780963315814773e-06,0,0
11566,1200pm,1,1.8364528545823171e-06,1,2.2780963315814773e-06,0,0
11570,runner,1,1.8364528545823171e-06,1,2.2780963315814773e-06,0,0
11572,130b,1,1.8364528545823171e-06,1,2.2780963315814773e-06,0,0
11577,scrubbed,1,1.8364528545823171e-06,1,2.2780963315814773e-06,0,0
11578,@doksart,1,1.8364528545823171e-06,1,2.2780963315814773e-06,0,0
11580,depressed,1,1.8364528545823171e-06,1,2.2780963315814773e-06,0,0
11581,@cline4virginia,1,1.8364528545823171e-06,1,2.2780963315814773e-06,0,0
11585,enforcers,1,1.8364528545823171e-06,1,2.2780963315814773e-06,0,0
11584,breakers,1,1.8364528545823171e-06,1,2.2780963315814773e-06,0,0
11590,interactions,1,1.8364528545823171e-06,1,2.2780963315814773e-06,0,0
11595,outperformed,1,1.8364528545823171e-06,1,2.2780963315814773e-06,0,0
11594,mohamed,1,1.8364528545823171e-06,1,2.2780963315814773e-06,0,0
11593,el-erian,1,1.8364528545823171e-06,1,2.2780963315814773e-06,0,0
11592,allianz,1,1.8364528545823171e-06,1,2.2780963315814773e-06,0,0
11598,312018,1,1.8364528545823171e-06,1,2.2780963315814773e-06,0,0
11602,manufactures,1,1.8364528545823171e-06,1,2.2780963315814773e-06,0,0
11613,day-by-day,1,1.8364528545823171e-06,1,2.2780963315814773e-06,0,0
11615,comparable,1,1.8364528545823171e-06,1,2.2780963315814773e-06,0,0
11616,physiological,1,1.8364528545823171e-06,1,2.2780963315814773e-06,0,0
11617,@danjohnstonnd,1,1.8364528545823171e-06,1,2.2780963315814773e-06,0,0
11619,edged,1,1.8364528545823171e-06,1,2.2780963315814773e-06,0,0
11625,v-shaped,1,1.8364528545823171e-06,1,2.2780963315814773e-06,0,0
11623,surprises,1,1.8364528545823171e-06,1,2.2780963315814773e-06,0,0
11622,chetan,1,1.8364528545823171e-06,1,2.2780963315814773e-06,0,0
11621,ahya,1,1.8364528545823171e-06,1,2.2780963315814773e-06,0,0
11628,100pme,1,1.8364528545823171e-06,1,2.2780963315814773e-06,0,0
11630,pitt-greenville,1,1.8364528545823171e-06,1,2.2780963315814773e-06,0,0
11633,faltering,1,1.8364528545823171e-06,1,2.2780963315814773e-06,0,0
11634,sanctimoniously,1,1.8364528545823171e-06,1,2.2780963315814773e-06,0,0
11640,one-month,1,1.8364528545823171e-06,1,2.2780963315814773e-06,0,0
11639,177,1,1.8364528545823171e-06,1,2.2780963315814773e-06,0,0
11641,knowledgeable,1,1.8364528545823171e-06,1,2.2780963315814773e-06,0,0
11642,#mn06,1,1.8364528545823171e-06,1,2.2780963315814773e-06,0,0
11649,carnival,1,1.8364528545823171e-06,1,2.2780963315814773e-06,0,0
11651,msc,1,1.8364528545823171e-06,1,2.2780963315814773e-06,0,0
11652,outbound,1,1.8364528545823171e-06,1,2.2780963315814773e-06,0,0
11650,cruises,1,1.8364528545823171e-06,1,2.2780963315814773e-06,0,0
11654,thirty,1,1.8364528545823171e-06,1,2.2780963315814773e-06,0,0
11655,humanly,1,1.8364528545823171e-06,1,2.2780963315814773e-06,0,0
11657,hitter,1,1.8364528545823171e-06,1,2.2780963315814773e-06,0,0
11661,yucca,1,1.8364528545823171e-06,1,2.2780963315814773e-06,0,0
11660,exploring,1,1.8364528545823171e-06,1,2.2780963315814773e-06,0,0
11664,drifted,1,1.8364528545823171e-06,1,2.2780963315814773e-06,0,0
11662,-15,1,1.8364528545823171e-06,1,2.2780963315814773e-06,0,0
11669,@astrochristina,1,1.8364528545823171e-06,1,2.2780963315814773e-06,0,0
11670,@astrojessica,1,1.8364528545823171e-06,1,2.2780963315814773e-06,0,0
11671,all-female,1,1.8364528545823171e-06,1,2.2780963315814773e-06,0,0
11672,spacewalk,1,1.8364528545823171e-06,1,2.2780963315814773e-06,0,0
11673,136m,1,1.8364528545823171e-06,1,2.2780963315814773e-06,0,0
11674,125m,1,1.8364528545823171e-06,1,2.2780963315814773e-06,0,0
11675,@huntsvillecity,1,1.8364528545823171e-06,1,2.2780963315814773e-06,0,0
11676,earthwe,1,1.8364528545823171e-06,1,2.2780963315814773e-06,0,0
11682,processors,1,1.8364528545823171e-06,1,2.2780963315814773e-06,0,0
11680,@johnboozman,1,1.8364528545823171e-06,1,2.2780963315814773e-06,0,0
11685,well-being,1,1.8364528545823171e-06,1,2.2780963315814773e-06,0,0
11687,nonprofits,1,1.8364528545823171e-06,1,2.2780963315814773e-06,0,0
11690,@leezeldin,1,1.8364528545823171e-06,1,2.2780963315814773e-06,0,0
11693,aoun,1,1.8364528545823171e-06,1,2.2780963315814773e-06,0,0
11694,technicians,1,1.8364528545823171e-06,1,2.2780963315814773e-06,0,0
11695,6201,1,1.8364528545823171e-06,1,2.2780963315814773e-06,0,0
11700,swinging,1,1.8364528545823171e-06,1,2.2780963315814773e-06,0,0
11698,@littleleagueceo,1,1.8364528545823171e-06,1,2.2780963315814773e-06,0,0
11701,@littleleague,1,1.8364528545823171e-06,1,2.2780963315814773e-06,0,0
11706,lopsided,1,1.8364528545823171e-06,1,2.2780963315814773e-06,0,0
11716,vacationing,1,1.8364528545823171e-06,1,2.2780963315814773e-06,0,0
11708,fume,1,1.8364528545823171e-06,1,2.2780963315814773e-06,0,0
11714,teeing,1,1.8364528545823171e-06,1,2.2780963315814773e-06,0,0
11722,cache,1,1.8364528545823171e-06,1,2.2780963315814773e-06,0,0
11724,depiction,1,1.8364528545823171e-06,1,2.2780963315814773e-06,0,0
11730,83m,1,1.8364528545823171e-06,1,2.2780963315814773e-06,0,0
11731,asheville,1,1.8364528545823171e-06,1,2.2780963315814773e-06,0,0
11732,chapel,1,1.8364528545823171e-06,1,2.2780963315814773e-06,0,0
11733,unravel,1,1.8364528545823171e-06,1,2.2780963315814773e-06,0,0
11734,acquitted,1,1.8364528545823171e-06,1,2.2780963315814773e-06,0,0
11736,bismarck,1,1.8364528545823171e-06,1,2.2780963315814773e-06,0,0
11737,forks,1,1.8364528545823171e-06,1,2.2780963315814773e-06,0,0
11738,149m,1,1.8364528545823171e-06,1,2.2780963315814773e-06,0,0
11739,259,1,1.8364528545823171e-06,1,2.2780963315814773e-06,0,0
11746,mobster,1,1.8364528545823171e-06,1,2.2780963315814773e-06,0,0
11748,822k,1,1.8364528545823171e-06,1,2.2780963315814773e-06,0,0
11749,@ridebigblue,1,1.8364528545823171e-06,1,2.2780963315814773e-06,0,0
11751,115m,1,1.8364528545823171e-06,1,2.2780963315814773e-06,0,0
11753,hazleton,1,1.8364528545823171e-06,1,2.2780963315814773e-06,0,0
11754,189m,1,1.8364528545823171e-06,1,2.2780963315814773e-06,0,0
11756,@connecttransit,1,1.8364528545823171e-06,1,2.2780963315814773e-06,0,0
11755,@citylinkpeoria,1,1.8364528545823171e-06,1,2.2780963315814773e-06,0,0
11757,@pacesuburbanbus,1,1.8364528545823171e-06,1,2.2780963315814773e-06,0,0
11761,147m,1,1.8364528545823171e-06,1,2.2780963315814773e-06,0,0
11762,@passaiccounty,1,1.8364528545823171e-06,1,2.2780963315814773e-06,0,0
11765,podestas,1,1.8364528545823171e-06,1,2.2780963315814773e-06,0,0
11766,discipline,1,1.8364528545823171e-06,1,2.2780963315814773e-06,0,0
11768,counterattack,1,1.8364528545823171e-06,1,2.2780963315814773e-06,0,0
11771,@gayletrotter,1,1.8364528545823171e-06,1,2.2780963315814773e-06,0,0
11779,specialty,1,1.8364528545823171e-06,1,2.2780963315814773e-06,0,0
11773,crop,1,1.8364528545823171e-06,1,2.2780963315814773e-06,0,0
11775,growers,1,1.8364528545823171e-06,1,2.2780963315814773e-06,0,0
11777,meat,1,1.8364528545823171e-06,1,2.2780963315814773e-06,0,0
11776,kitchens,1,1.8364528545823171e-06,1,2.2780963315814773e-06,0,0
11772,@zippyduvall,1,1.8364528545823171e-06,1,2.2780963315814773e-06,0,0
11785,stricken,1,1.8364528545823171e-06,1,2.2780963315814773e-06,0,0
11781,disembark,1,1.8364528545823171e-06,1,2.2780963315814773e-06,0,0
11782,dock,1,1.8364528545823171e-06,1,2.2780963315814773e-06,0,0
11788,witch-hunts,1,1.8364528545823171e-06,1,2.2780963315814773e-06,0,0
11793,msdncs,1,1.8364528545823171e-06,1,2.2780963315814773e-06,0,0
11791,ditzy,1,1.8364528545823171e-06,1,2.2780963315814773e-06,0,0
11790,airhead,1,1.8364528545823171e-06,1,2.2780963315814773e-06,0,0
11794,unknowns,1,1.8364528545823171e-06,1,2.2780963315814773e-06,0,0
11796,dropouts,1,1.8364528545823171e-06,1,2.2780963315814773e-06,0,0
11799,meaner,1,1.8364528545823171e-06,1,2.2780963315814773e-06,0,0
11797,condescending,1,1.8364528545823171e-06,1,2.2780963315814773e-06,0,0
11798,evaporated,1,1.8364528545823171e-06,1,2.2780963315814773e-06,0,0
11800,occupied,1,1.8364528545823171e-06,1,2.2780963315814773e-06,0,0
11801,reluctantly,1,1.8364528545823171e-06,1,2.2780963315814773e-06,0,0
11810,primiums,1,1.8364528545823171e-06,1,2.2780963315814773e-06,0,0
11811,mop,1,1.8364528545823171e-06,1,2.2780963315814773e-06,0,0
11812,bootedgeedge,1,1.8364528545823171e-06,1,2.2780963315814773e-06,0,0
11814,bungled,1,1.8364528545823171e-06,1,2.2780963315814773e-06,0,0
11821,latter,1,1.8364528545823171e-06,1,2.2780963315814773e-06,0,0
11824,insignificant,1,1.8364528545823171e-06,1,2.2780963315814773e-06,0,0
11826,mortal,1,1.8364528545823171e-06,1,2.2780963315814773e-06,0,0
11833,tediousnew,1,1.8364528545823171e-06,1,2.2780963315814773e-06,0,0
11832,ostracized,1,1.8364528545823171e-06,1,2.2780963315814773e-06,0,0
11836,grades,1,1.8364528545823171e-06,1,2.2780963315814773e-06,0,0
11840,blitz,1,1.8364528545823171e-06,1,2.2780963315814773e-06,0,0
11838,800-691-0022,1,1.8364528545823171e-06,1,2.2780963315814773e-06,0,0
11842,@dagenmcdowell,1,1.8364528545823171e-06,1,2.2780963315814773e-06,0,0
11844,ethnicity,1,1.8364528545823171e-06,1,2.2780963315814773e-06,0,0
11843,dagen,1,1.8364528545823171e-06,1,2.2780963315814773e-06,0,0
11845,whitsett,1,1.8364528545823171e-06,1,2.2780963315814773e-06,0,0
11846,@cynthiamlummis,1,1.8364528545823171e-06,1,2.2780963315814773e-06,0,0
11847,cynthia,1,1.8364528545823171e-06,1,2.2780963315814773e-06,0,0
11849,succes,1,1.8364528545823171e-06,1,2.2780963315814773e-06,0,0
11850,ballroom,1,1.8364528545823171e-06,1,2.2780963315814773e-06,0,0
11854,@donyoungak,1,1.8364528545823171e-06,1,2.2780963315814773e-06,0,0
11856,disband,1,1.8364528545823171e-06,1,2.2780963315814773e-06,0,0
11860,connor,1,1.8364528545823171e-06,1,2.2780963315814773e-06,0,0
11861,lamm,1,1.8364528545823171e-06,1,2.2780963315814773e-06,0,0
11864,seattles,1,1.8364528545823171e-06,1,2.2780963315814773e-06,0,0
11862,caving,1,1.8364528545823171e-06,1,2.2780963315814773e-06,0,0
11868,sophie,1,1.8364528545823171e-06,1,2.2780963315814773e-06,0,0
11869,44000,1,1.8364528545823171e-06,1,2.2780963315814773e-06,0,0
11871,@jayobernolte,1,1.8364528545823171e-06,1,2.2780963315814773e-06,0,0
11873,staring,1,1.8364528545823171e-06,1,2.2780963315814773e-06,0,0
11874,enable,1,1.8364528545823171e-06,1,2.2780963315814773e-06,0,0
11876,@augustpfluger,1,1.8364528545823171e-06,1,2.2780963315814773e-06,0,0
11877,oilgas,1,1.8364528545823171e-06,1,2.2780963315814773e-06,0,0
11878,attributes,1,1.8364528545823171e-06,1,2.2780963315814773e-06,0,0
11883,asleep,1,1.8364528545823171e-06,1,2.2780963315814773e-06,0,0
11884,@freechapel,1,1.8364528545823171e-06,1,2.2780963315814773e-06,0,0
11887,gainesville,1,1.8364528545823171e-06,1,2.2780963315814773e-06,0,0
11886,edt,1,1.8364528545823171e-06,1,2.2780963315814773e-06,0,0
11888,saphier,1,1.8364528545823171e-06,1,2.2780963315814773e-06,0,0
11897,@nmalliotakis,1,1.8364528545823171e-06,1,2.2780963315814773e-06,0,0
11901,shotgun,1,1.8364528545823171e-06,1,2.2780963315814773e-06,0,0
11904,centric,1,1.8364528545823171e-06,1,2.2780963315814773e-06,0,0
11907,conor,1,1.8364528545823171e-06,1,2.2780963315814773e-06,0,0
11910,anti-benghazi,1,1.8364528545823171e-06,1,2.2780963315814773e-06,0,0
11911,admirals,1,1.8364528545823171e-06,1,2.2780963315814773e-06,0,0
11915,alienating,1,1.8364528545823171e-06,1,2.2780963315814773e-06,0,0
11918,fore,1,1.8364528545823171e-06,1,2.2780963315814773e-06,0,0
11920,sohrab,1,1.8364528545823171e-06,1,2.2780963315814773e-06,0,0
11919,ahmari,1,1.8364528545823171e-06,1,2.2780963315814773e-06,0,0
11921,deven,1,1.8364528545823171e-06,1,2.2780963315814773e-06,0,0
11927,conf,1,1.8364528545823171e-06,1,2.2780963315814773e-06,0,0
11925,#americaworkstogether,1,1.8364528545823171e-06,1,2.2780963315814773e-06,0,0
11930,unanswered,1,1.8364528545823171e-06,1,2.2780963315814773e-06,0,0
11933,ex-wife,1,1.8364528545823171e-06,1,2.2780963315814773e-06,0,0
11936,crosses,1,1.8364528545823171e-06,1,2.2780963315814773e-06,0,0
11939,stockpiles,1,1.8364528545823171e-06,1,2.2780963315814773e-06,0,0
11940,corroborating,1,1.8364528545823171e-06,1,2.2780963315814773e-06,0,0
11944,paratus,1,1.8364528545823171e-06,1,2.2780963315814773e-06,0,0
11945,vessels,1,1.8364528545823171e-06,1,2.2780963315814773e-06,0,0
11943,mariners,1,1.8364528545823171e-06,1,2.2780963315814773e-06,0,0
11948,jentezen,1,1.8364528545823171e-06,1,2.2780963315814773e-06,0,0
11953,whimper,1,1.8364528545823171e-06,1,2.2780963315814773e-06,0,0
11957,disrespects,1,1.8364528545823171e-06,1,2.2780963315814773e-06,0,0
11954,affixed,1,1.8364528545823171e-06,1,2.2780963315814773e-06,0,0
11962,@lgutwein9931,1,1.8364528545823171e-06,1,2.2780963315814773e-06,0,0
11967,lighthizers,1,1.8364528545823171e-06,1,2.2780963315814773e-06,0,0
11966,decoupling,1,1.8364528545823171e-06,1,2.2780963315814773e-06,0,0
11970,harrassment,1,1.8364528545823171e-06,1,2.2780963315814773e-06,0,0
11974,denigrating,1,1.8364528545823171e-06,1,2.2780963315814773e-06,0,0
11973,antagonize,1,1.8364528545823171e-06,1,2.2780963315814773e-06,0,0
11981,@michigandot,1,1.8364528545823171e-06,1,2.2780963315814773e-06,0,0
11982,@porthuron,1,1.8364528545823171e-06,1,2.2780963315814773e-06,0,0
11984,critcal,1,1.8364528545823171e-06,1,2.2780963315814773e-06,0,0
11983,busiest,1,1.8364528545823171e-06,1,2.2780963315814773e-06,0,0
11986,us-canada,1,1.8364528545823171e-06,1,2.2780963315814773e-06,0,0
11988,pebble,1,1.8364528545823171e-06,1,2.2780963315814773e-06,0,0
11992,@unitedwarvets,1,1.8364528545823171e-06,1,2.2780963315814773e-06,0,0
11990,@gruccifireworks,1,1.8364528545823171e-06,1,2.2780963315814773e-06,0,0
11991,@scottsmgro,1,1.8364528545823171e-06,1,2.2780963315814773e-06,0,0
11989,#salute2america,1,1.8364528545823171e-06,1,2.2780963315814773e-06,0,0
11993,fridaybig,1,1.8364528545823171e-06,1,2.2780963315814773e-06,0,0
11995,135m,1,1.8364528545823171e-06,1,2.2780963315814773e-06,0,0
11996,@ladotd,1,1.8364528545823171e-06,1,2.2780963315814773e-06,0,0
11998,leeville,1,1.8364528545823171e-06,1,2.2780963315814773e-06,0,0
12003,@wvdot,1,1.8364528545823171e-06,1,2.2780963315814773e-06,0,0
12006,kerens,1,1.8364528545823171e-06,1,2.2780963315814773e-06,0,0
12007,parsons,1,1.8364528545823171e-06,1,2.2780963315814773e-06,0,0
12008,@wisconsindot,1,1.8364528545823171e-06,1,2.2780963315814773e-06,0,0
12009,merrimac,1,1.8364528545823171e-06,1,2.2780963315814773e-06,0,0
12010,rehabilitation,1,1.8364528545823171e-06,1,2.2780963315814773e-06,0,0
12011,clamoring,1,1.8364528545823171e-06,1,2.2780963315814773e-06,0,0
12013,#trumpmilwaukeerally,1,1.8364528545823171e-06,1,2.2780963315814773e-06,0,0
12014,limp,1,1.8364528545823171e-06,1,2.2780963315814773e-06,0,0
12020,@scdotpress,1,1.8364528545823171e-06,1,2.2780963315814773e-06,0,0
12017,346m,1,1.8364528545823171e-06,1,2.2780963315814773e-06,0,0
12025,i-77,1,1.8364528545823171e-06,1,2.2780963315814773e-06,0,0
12016,234-acre,1,1.8364528545823171e-06,1,2.2780963315814773e-06,0,0
12019,@rockhillsccity,1,1.8364528545823171e-06,1,2.2780963315814773e-06,0,0
12021,@yorkcountysc,1,1.8364528545823171e-06,1,2.2780963315814773e-06,0,0
12022,@yorkcountyscgov,1,1.8364528545823171e-06,1,2.2780963315814773e-06,0,0
12027,112m,1,1.8364528545823171e-06,1,2.2780963315814773e-06,0,0
12028,@mytdot,1,1.8364528545823171e-06,1,2.2780963315814773e-06,0,0
12032,install,1,1.8364528545823171e-06,1,2.2780963315814773e-06,0,0
12034,optic,1,1.8364528545823171e-06,1,2.2780963315814773e-06,0,0
12031,i-40,1,1.8364528545823171e-06,1,2.2780963315814773e-06,0,0
12033,memphis,1,1.8364528545823171e-06,1,2.2780963315814773e-06,0,0
12035,199,1,1.8364528545823171e-06,1,2.2780963315814773e-06,0,0
12037,hookers,1,1.8364528545823171e-06,1,2.2780963315814773e-06,0,0
12040,@tulsaport,1,1.8364528545823171e-06,1,2.2780963315814773e-06,0,0
12039,62m,1,1.8364528545823171e-06,1,2.2780963315814773e-06,0,0
12044,follows,1,1.8364528545823171e-06,1,2.2780963315814773e-06,0,0
12047,ungifted,1,1.8364528545823171e-06,1,2.2780963315814773e-06,0,0
12048,@ridotnews,1,1.8364528545823171e-06,1,2.2780963315814773e-06,0,0
12049,repairs,1,1.8364528545823171e-06,1,2.2780963315814773e-06,0,0
12050,ri-246,1,1.8364528545823171e-06,1,2.2780963315814773e-06,0,0
12052,@porthouston,1,1.8364528545823171e-06,1,2.2780963315814773e-06,0,0
12051,795m,1,1.8364528545823171e-06,1,2.2780963315814773e-06,0,0
12053,barbours,1,1.8364528545823171e-06,1,2.2780963315814773e-06,0,0
12056,737m,1,1.8364528545823171e-06,1,2.2780963315814773e-06,0,0
12057,@wsdot,1,1.8364528545823171e-06,1,2.2780963315814773e-06,0,0
12059,puget,1,1.8364528545823171e-06,1,2.2780963315814773e-06,0,0
12058,links,1,1.8364528545823171e-06,1,2.2780963315814773e-06,0,0
12068,@simonschuster,1,1.8364528545823171e-06,1,2.2780963315814773e-06,0,0
12073,publication,1,1.8364528545823171e-06,1,2.2780963315814773e-06,0,0
12072,defenders,1,1.8364528545823171e-06,1,2.2780963315814773e-06,0,0
12074,winston,1,1.8364528545823171e-06,1,2.2780963315814773e-06,0,0
12067,@nickadamsinusa,1,1.8364528545823171e-06,1,2.2780963315814773e-06,0,0
12075,50m,1,1.8364528545823171e-06,1,2.2780963315814773e-06,0,0
12076,@nevadadot,1,1.8364528545823171e-06,1,2.2780963315814773e-06,0,0
12079,tropicana,1,1.8364528545823171e-06,1,2.2780963315814773e-06,0,0
12077,avenuei-15,1,1.8364528545823171e-06,1,2.2780963315814773e-06,0,0
12080,@ncdot,1,1.8364528545823171e-06,1,2.2780963315814773e-06,0,0
12081,robeson,1,1.8364528545823171e-06,1,2.2780963315814773e-06,0,0
12082,@kenblackwell,1,1.8364528545823171e-06,1,2.2780963315814773e-06,0,0
12083,#geauxtigers,1,1.8364528545823171e-06,1,2.2780963315814773e-06,0,0
12084,counyry,1,1.8364528545823171e-06,1,2.2780963315814773e-06,0,0
12087,infectious,1,1.8364528545823171e-06,1,2.2780963315814773e-06,0,0
12092,@myfdots,1,1.8364528545823171e-06,1,2.2780963315814773e-06,0,0
12093,i-4,1,1.8364528545823171e-06,1,2.2780963315814773e-06,0,0
12094,715m,1,1.8364528545823171e-06,1,2.2780963315814773e-06,0,0
12095,@mississippidot,1,1.8364528545823171e-06,1,2.2780963315814773e-06,0,0
12096,bypass,1,1.8364528545823171e-06,1,2.2780963315814773e-06,0,0
12097,1479,1,1.8364528545823171e-06,1,2.2780963315814773e-06,0,0
12101,cambodia,1,1.8364528545823171e-06,1,2.2780963315814773e-06,0,0
12098,@carnivalcruise,1,1.8364528545823171e-06,1,2.2780963315814773e-06,0,0
12103,westerdam,1,1.8364528545823171e-06,1,2.2780963315814773e-06,0,0
12099,@mickyarison,1,1.8364528545823171e-06,1,2.2780963315814773e-06,0,0
12104,568m,1,1.8364528545823171e-06,1,2.2780963315814773e-06,0,0
12106,@delawaredot,1,1.8364528545823171e-06,1,2.2780963315814773e-06,0,0
12108,construct,1,1.8364528545823171e-06,1,2.2780963315814773e-06,0,0
12111,redesigned,1,1.8364528545823171e-06,1,2.2780963315814773e-06,0,0
12110,i-95,1,1.8364528545823171e-06,1,2.2780963315814773e-06,0,0
12112,sr,1,1.8364528545823171e-06,1,2.2780963315814773e-06,0,0
12105,896,1,1.8364528545823171e-06,1,2.2780963315814773e-06,0,0
12107,castle,1,1.8364528545823171e-06,1,2.2780963315814773e-06,0,0
12114,flattening,1,1.8364528545823171e-06,1,2.2780963315814773e-06,0,0
12125,@eaglecounty,1,1.8364528545823171e-06,1,2.2780963315814773e-06,0,0
12123,607m,1,1.8364528545823171e-06,1,2.2780963315814773e-06,0,0
12124,@coloradodot,1,1.8364528545823171e-06,1,2.2780963315814773e-06,0,0
12128,vail,1,1.8364528545823171e-06,1,2.2780963315814773e-06,0,0
12127,i-70,1,1.8364528545823171e-06,1,2.2780963315814773e-06,0,0
12122,180-190,1,1.8364528545823171e-06,1,2.2780963315814773e-06,0,0
12129,fiasco,1,1.8364528545823171e-06,1,2.2780963315814773e-06,0,0
12130,@mchenrycampaign,1,1.8364528545823171e-06,1,2.2780963315814773e-06,0,0
12131,381,1,1.8364528545823171e-06,1,2.2780963315814773e-06,0,0
12132,@mainedot1,1,1.8364528545823171e-06,1,2.2780963315814773e-06,0,0
12133,kennebec,1,1.8364528545823171e-06,1,2.2780963315814773e-06,0,0
12134,oxford,1,1.8364528545823171e-06,1,2.2780963315814773e-06,0,0
12135,penobscot,1,1.8364528545823171e-06,1,2.2780963315814773e-06,0,0
12136,somerset,1,1.8364528545823171e-06,1,2.2780963315814773e-06,0,0
12139,5515m,1,1.8364528545823171e-06,1,2.2780963315814773e-06,0,0
12140,@kytc,1,1.8364528545823171e-06,1,2.2780963315814773e-06,0,0
12141,@mtnparkway,1,1.8364528545823171e-06,1,2.2780963315814773e-06,0,0
12143,overpass,1,1.8364528545823171e-06,1,2.2780963315814773e-06,0,0
12145,@mointhehouse,1,1.8364528545823171e-06,1,2.2780963315814773e-06,0,0
12147,@jodeyarrington,1,1.8364528545823171e-06,1,2.2780963315814773e-06,0,0
12149,asst,1,1.8364528545823171e-06,1,2.2780963315814773e-06,0,0
12150,secy,1,1.8364528545823171e-06,1,2.2780963315814773e-06,0,0
12153,@myardot,1,1.8364528545823171e-06,1,2.2780963315814773e-06,0,0
12154,@pulaskiar,1,1.8364528545823171e-06,1,2.2780963315814773e-06,0,0
12155,lonoke,1,1.8364528545823171e-06,1,2.2780963315814773e-06,0,0
12157,@anokacounty,1,1.8364528545823171e-06,1,2.2780963315814773e-06,0,0
12158,ramsey,1,1.8364528545823171e-06,1,2.2780963315814773e-06,0,0
12156,10169,1,1.8364528545823171e-06,1,2.2780963315814773e-06,0,0
12162,hcq,1,1.8364528545823171e-06,1,2.2780963315814773e-06,0,0
12164,becsuse,1,1.8364528545823171e-06,1,2.2780963315814773e-06,0,0
12166,weaponizes,1,1.8364528545823171e-06,1,2.2780963315814773e-06,0,0
12165,initiated,1,1.8364528545823171e-06,1,2.2780963315814773e-06,0,0
12167,@louisgohmerttx1,1,1.8364528545823171e-06,1,2.2780963315814773e-06,0,0
12171,gaps,1,1.8364528545823171e-06,1,2.2780963315814773e-06,0,0
12174,presumptions,1,1.8364528545823171e-06,1,2.2780963315814773e-06,0,0
12172,indulgent,1,1.8364528545823171e-06,1,2.2780963315814773e-06,0,0
12178,resubmit,1,1.8364528545823171e-06,1,2.2780963315814773e-06,0,0
12177,punted,1,1.8364528545823171e-06,1,2.2780963315814773e-06,0,0
12179,submitting,1,1.8364528545823171e-06,1,2.2780963315814773e-06,0,0
12176,fulfil,1,1.8364528545823171e-06,1,2.2780963315814773e-06,0,0
12180,americanfirst,1,1.8364528545823171e-06,1,2.2780963315814773e-06,0,0
12184,wwii,1,1.8364528545823171e-06,1,2.2780963315814773e-06,0,0
12185,nationss,1,1.8364528545823171e-06,1,2.2780963315814773e-06,0,0
12189,forgery,1,1.8364528545823171e-06,1,2.2780963315814773e-06,0,0
12196,@repmichaelwaltz,1,1.8364528545823171e-06,1,2.2780963315814773e-06,0,0
12193,#fl6,1,1.8364528545823171e-06,1,2.2780963315814773e-06,0,0
12209,poker,1,1.8364528545823171e-06,1,2.2780963315814773e-06,0,0
12208,foolhardy,1,1.8364528545823171e-06,1,2.2780963315814773e-06,0,0
12213,hoarding,1,1.8364528545823171e-06,1,2.2780963315814773e-06,0,0
12212,essentials,1,1.8364528545823171e-06,1,2.2780963315814773e-06,0,0
12215,grocers,1,1.8364528545823171e-06,1,2.2780963315814773e-06,0,0
12214,beacons,1,1.8364528545823171e-06,1,2.2780963315814773e-06,0,0
12216,arbitrate,1,1.8364528545823171e-06,1,2.2780963315814773e-06,0,0
12219,@louiegohmerttx1,1,1.8364528545823171e-06,1,2.2780963315814773e-06,0,0
12221,@mikecrapo,1,1.8364528545823171e-06,1,2.2780963315814773e-06,0,0
12222,@ronwyden,1,1.8364528545823171e-06,1,2.2780963315814773e-06,0,0
12223,@senatedems,1,1.8364528545823171e-06,1,2.2780963315814773e-06,0,0
12225,companiesdupont,1,1.8364528545823171e-06,1,2.2780963315814773e-06,0,0
12226,fedexand,1,1.8364528545823171e-06,1,2.2780963315814773e-06,0,0
12224,@dupontnews,1,1.8364528545823171e-06,1,2.2780963315814773e-06,0,0
12230,squelch,1,1.8364528545823171e-06,1,2.2780963315814773e-06,0,0
12231,feared,1,1.8364528545823171e-06,1,2.2780963315814773e-06,0,0
12233,ripe,1,1.8364528545823171e-06,1,2.2780963315814773e-06,0,0
12236,hr473,1,1.8364528545823171e-06,1,2.2780963315814773e-06,0,0
12242,15000000,1,1.8364528545823171e-06,1,2.2780963315814773e-06,0,0
12243,cs,1,1.8364528545823171e-06,1,2.2780963315814773e-06,0,0
12251,warmongers,1,1.8364528545823171e-06,1,2.2780963315814773e-06,0,0
12248,pretenders,1,1.8364528545823171e-06,1,2.2780963315814773e-06,0,0
12249,shunned,1,1.8364528545823171e-06,1,2.2780963315814773e-06,0,0
12253,undermining,1,1.8364528545823171e-06,1,2.2780963315814773e-06,0,0
12252,peek,1,1.8364528545823171e-06,1,2.2780963315814773e-06,0,0
12258,rattled,1,1.8364528545823171e-06,1,2.2780963315814773e-06,0,0
12259,@sba,1,1.8364528545823171e-06,1,2.2780963315814773e-06,0,0
12264,ritchie,1,1.8364528545823171e-06,1,2.2780963315814773e-06,0,0
12266,stats,1,1.8364528545823171e-06,1,2.2780963315814773e-06,0,0
12269,usurp,1,1.8364528545823171e-06,1,2.2780963315814773e-06,0,0
12268,petty,1,1.8364528545823171e-06,1,2.2780963315814773e-06,0,0
12274,newsom,1,1.8364528545823171e-06,1,2.2780963315814773e-06,0,0
12276,that-there,1,1.8364528545823171e-06,1,2.2780963315814773e-06,0,0
12280,terroristist,1,1.8364528545823171e-06,1,2.2780963315814773e-06,0,0
12282,whistleblower&,1,1.8364528545823171e-06,1,2.2780963315814773e-06,0,0
12281,vanished,1,1.8364528545823171e-06,1,2.2780963315814773e-06,0,0
12283,reacting,1,1.8364528545823171e-06,1,2.2780963315814773e-06,0,0
12285,@gantzbe,1,1.8364528545823171e-06,1,2.2780963315814773e-06,0,0
12287,closely-held,1,1.8364528545823171e-06,1,2.2780963315814773e-06,0,0
12289,speculative,1,1.8364528545823171e-06,1,2.2780963315814773e-06,0,0
12291,grievance,1,1.8364528545823171e-06,1,2.2780963315814773e-06,0,0
12292,resentment,1,1.8364528545823171e-06,1,2.2780963315814773e-06,0,0
12301,waldo,1,1.8364528545823171e-06,1,2.2780963315814773e-06,0,0
12297,foresee,1,1.8364528545823171e-06,1,2.2780963315814773e-06,0,0
12298,mrtrump,1,1.8364528545823171e-06,1,2.2780963315814773e-06,0,0
12304,@gtbynum,1,1.8364528545823171e-06,1,2.2780963315814773e-06,0,0
12307,compatriots,1,1.8364528545823171e-06,1,2.2780963315814773e-06,0,0
12308,campaigninin,1,1.8364528545823171e-06,1,2.2780963315814773e-06,0,0
12309,@femapete,1,1.8364528545823171e-06,1,2.2780963315814773e-06,0,0
12311,disclosurelacked,1,1.8364528545823171e-06,1,2.2780963315814773e-06,0,0
12310,candor,1,1.8364528545823171e-06,1,2.2780963315814773e-06,0,0
12316,occasionsauthotized,1,1.8364528545823171e-06,1,2.2780963315814773e-06,0,0
12312,interestsig,1,1.8364528545823171e-06,1,2.2780963315814773e-06,0,0
12320,@jamescomer,1,1.8364528545823171e-06,1,2.2780963315814773e-06,0,0
12319,#ky01,1,1.8364528545823171e-06,1,2.2780963315814773e-06,0,0
12324,@brettguthrie,1,1.8364528545823171e-06,1,2.2780963315814773e-06,0,0
12323,#ky02,1,1.8364528545823171e-06,1,2.2780963315814773e-06,0,0
12328,trrrible,1,1.8364528545823171e-06,1,2.2780963315814773e-06,0,0
12330,electability,1,1.8364528545823171e-06,1,2.2780963315814773e-06,0,0
12331,cattlemen,1,1.8364528545823171e-06,1,2.2780963315814773e-06,0,0
12334,purdue,1,1.8364528545823171e-06,1,2.2780963315814773e-06,0,0
12335,105b,1,1.8364528545823171e-06,1,2.2780963315814773e-06,0,0
12336,ppe,1,1.8364528545823171e-06,1,2.2780963315814773e-06,0,0
12338,@teammitch,1,1.8364528545823171e-06,1,2.2780963315814773e-06,0,0
12337,#kysen,1,1.8364528545823171e-06,1,2.2780963315814773e-06,0,0
12339,texas-13,1,1.8364528545823171e-06,1,2.2780963315814773e-06,0,0
12340,warrantless,1,1.8364528545823171e-06,1,2.2780963315814773e-06,0,0
12341,kimmels,1,1.8364528545823171e-06,1,2.2780963315814773e-06,0,0
12344,life-changing,1,1.8364528545823171e-06,1,2.2780963315814773e-06,0,0
12343,#schoolchoicenow,1,1.8364528545823171e-06,1,2.2780963315814773e-06,0,0
12346,rental,1,1.8364528545823171e-06,1,2.2780963315814773e-06,0,0
12347,@danforestnc,1,1.8364528545823171e-06,1,2.2780963315814773e-06,0,0
12349,stumble,1,1.8364528545823171e-06,1,2.2780963315814773e-06,0,0
12353,tours,1,1.8364528545823171e-06,1,2.2780963315814773e-06,0,0
12354,arguably,1,1.8364528545823171e-06,1,2.2780963315814773e-06,0,0
12355,accosted,1,1.8364528545823171e-06,1,2.2780963315814773e-06,0,0
12356,able@tuckercarlson,1,1.8364528545823171e-06,1,2.2780963315814773e-06,0,0
12361,#killthevirus,1,1.8364528545823171e-06,1,2.2780963315814773e-06,0,0
12362,hotspot,1,1.8364528545823171e-06,1,2.2780963315814773e-06,0,0
12363,affirmed,1,1.8364528545823171e-06,1,2.2780963315814773e-06,0,0
12372,yoshihide,1,1.8364528545823171e-06,1,2.2780963315814773e-06,0,0
12371,suga,1,1.8364528545823171e-06,1,2.2780963315814773e-06,0,0
12369,@kantei,1,1.8364528545823171e-06,1,2.2780963315814773e-06,0,0
12370,@sugawitter,1,1.8364528545823171e-06,1,2.2780963315814773e-06,0,0
12374,carlos,1,1.8364528545823171e-06,1,2.2780963315814773e-06,0,0
12377,descend,1,1.8364528545823171e-06,1,2.2780963315814773e-06,0,0
12379,@brianstelter,1,1.8364528545823171e-06,1,2.2780963315814773e-06,0,0
12381,mancini,1,1.8364528545823171e-06,1,2.2780963315814773e-06,0,0
12383,260,1,1.8364528545823171e-06,1,2.2780963315814773e-06,0,0
12386,scjs,1,1.8364528545823171e-06,1,2.2780963315814773e-06,0,0
12384,erick,1,1.8364528545823171e-06,1,2.2780963315814773e-06,0,0
12388,denouncing,1,1.8364528545823171e-06,1,2.2780963315814773e-06,0,0
12389,#mtsen,1,1.8364528545823171e-06,1,2.2780963315814773e-06,0,0
12396,longerthe,1,1.8364528545823171e-06,1,2.2780963315814773e-06,0,0
12398,distressed,1,1.8364528545823171e-06,1,2.2780963315814773e-06,0,0
12400,consultant,1,1.8364528545823171e-06,1,2.2780963315814773e-06,0,0
12404,aced,1,1.8364528545823171e-06,1,2.2780963315814773e-06,0,0
12405,classification,1,1.8364528545823171e-06,1,2.2780963315814773e-06,0,0
12408,younger,1,1.8364528545823171e-06,1,2.2780963315814773e-06,0,0
12409,@govsisolak,1,1.8364528545823171e-06,1,2.2780963315814773e-06,0,0
12412,thier,1,1.8364528545823171e-06,1,2.2780963315814773e-06,0,0
12415,educationlabor,1,1.8364528545823171e-06,1,2.2780963315814773e-06,0,0
12416,ripoffs,1,1.8364528545823171e-06,1,2.2780963315814773e-06,0,0
12417,@bethvanduyne,1,1.8364528545823171e-06,1,2.2780963315814773e-06,0,0
12419,irving,1,1.8364528545823171e-06,1,2.2780963315814773e-06,0,0
12418,beth,1,1.8364528545823171e-06,1,2.2780963315814773e-06,0,0
12420,@wesleyhunttx,1,1.8364528545823171e-06,1,2.2780963315814773e-06,0,0
12423,exchanges,1,1.8364528545823171e-06,1,2.2780963315814773e-06,0,0
12426,@burgessowens,1,1.8364528545823171e-06,1,2.2780963315814773e-06,0,0
12425,#ut04,1,1.8364528545823171e-06,1,2.2780963315814773e-06,0,0
12429,soaking,1,1.8364528545823171e-06,1,2.2780963315814773e-06,0,0
12432,#daytona500,1,1.8364528545823171e-06,1,2.2780963315814773e-06,0,0
12436,summed,1,1.8364528545823171e-06,1,2.2780963315814773e-06,0,0
12435,calamity,1,1.8364528545823171e-06,1,2.2780963315814773e-06,0,0
12437,#az04,1,1.8364528545823171e-06,1,2.2780963315814773e-06,0,0
12439,@tonygonzales4tx,1,1.8364528545823171e-06,1,2.2780963315814773e-06,0,0
12438,#tx23,1,1.8364528545823171e-06,1,2.2780963315814773e-06,0,0
12440,#oh13,1,1.8364528545823171e-06,1,2.2780963315814773e-06,0,0
12443,@rephagan,1,1.8364528545823171e-06,1,2.2780963315814773e-06,0,0
12445,fist,1,1.8364528545823171e-06,1,2.2780963315814773e-06,0,0
12448,uae,1,1.8364528545823171e-06,1,2.2780963315814773e-06,0,0
12449,magnitude,1,1.8364528545823171e-06,1,2.2780963315814773e-06,0,0
12451,murdering,1,1.8364528545823171e-06,1,2.2780963315814773e-06,0,0
12453,nowproblem,1,1.8364528545823171e-06,1,2.2780963315814773e-06,0,0
12454,@usattyhuber,1,1.8364528545823171e-06,1,2.2780963315814773e-06,0,0
12458,nm,1,1.8364528545823171e-06,1,2.2780963315814773e-06,0,0
12456,@govmlg,1,1.8364528545823171e-06,1,2.2780963315814773e-06,0,0
12466,1974,1,1.8364528545823171e-06,1,2.2780963315814773e-06,0,0
12471,viewpoints,1,1.8364528545823171e-06,1,2.2780963315814773e-06,0,0
12472,clubs,1,1.8364528545823171e-06,1,2.2780963315814773e-06,0,0
12473,entertaiment,1,1.8364528545823171e-06,1,2.2780963315814773e-06,0,0
12476,proportionally,1,1.8364528545823171e-06,1,2.2780963315814773e-06,0,0
12478,clandestine,1,1.8364528545823171e-06,1,2.2780963315814773e-06,0,0
12480,rifle,1,1.8364528545823171e-06,1,2.2780963315814773e-06,0,0
12483,frances,1,1.8364528545823171e-06,1,2.2780963315814773e-06,0,0
12484,hakes,1,1.8364528545823171e-06,1,2.2780963315814773e-06,0,0
12482,debunked,1,1.8364528545823171e-06,1,2.2780963315814773e-06,0,0
12490,differing,1,1.8364528545823171e-06,1,2.2780963315814773e-06,0,0
12492,#prayingforryan,1,1.8364528545823171e-06,1,2.2780963315814773e-06,0,0
12498,mediaand,1,1.8364528545823171e-06,1,2.2780963315814773e-06,0,0
12503,survives,1,1.8364528545823171e-06,1,2.2780963315814773e-06,0,0
12508,clint,1,1.8364528545823171e-06,1,2.2780963315814773e-06,0,0
12510,misprinted,1,1.8364528545823171e-06,1,2.2780963315814773e-06,0,0
12509,listing,1,1.8364528545823171e-06,1,2.2780963315814773e-06,0,0
12513,blockage,1,1.8364528545823171e-06,1,2.2780963315814773e-06,0,0
12516,woodwards,1,1.8364528545823171e-06,1,2.2780963315814773e-06,0,0
12518,non-essential,1,1.8364528545823171e-06,1,2.2780963315814773e-06,0,0
12519,mid-august,1,1.8364528545823171e-06,1,2.2780963315814773e-06,0,0
12524,laughingstock,1,1.8364528545823171e-06,1,2.2780963315814773e-06,0,0
12523,@yoyoel,1,1.8364528545823171e-06,1,2.2780963315814773e-06,0,0
12528,heartless,1,1.8364528545823171e-06,1,2.2780963315814773e-06,0,0
12531,hern,1,1.8364528545823171e-06,1,2.2780963315814773e-06,0,0
12530,@krhern,1,1.8364528545823171e-06,1,2.2780963315814773e-06,0,0
12529,#ok01,1,1.8364528545823171e-06,1,2.2780963315814773e-06,0,0
12532,cratered,1,1.8364528545823171e-06,1,2.2780963315814773e-06,0,0
12543,organizationblack,1,1.8364528545823171e-06,1,2.2780963315814773e-06,0,0
12542,#theplatinumplan,1,1.8364528545823171e-06,1,2.2780963315814773e-06,0,0
12544,#ok02,1,1.8364528545823171e-06,1,2.2780963315814773e-06,0,0
12551,#ok04,1,1.8364528545823171e-06,1,2.2780963315814773e-06,0,0
12553,comeymueller,1,1.8364528545823171e-06,1,2.2780963315814773e-06,0,0
12556,area@usdot,1,1.8364528545823171e-06,1,2.2780963315814773e-06,0,0
12555,@valleymetro,1,1.8364528545823171e-06,1,2.2780963315814773e-06,0,0
12554,55-mile,1,1.8364528545823171e-06,1,2.2780963315814773e-06,0,0
12558,connecting,1,1.8364528545823171e-06,1,2.2780963315814773e-06,0,0
12559,218m,1,1.8364528545823171e-06,1,2.2780963315814773e-06,0,0
12564,@frankdlucas,1,1.8364528545823171e-06,1,2.2780963315814773e-06,0,0
12563,#ok03,1,1.8364528545823171e-06,1,2.2780963315814773e-06,0,0
12565,775m,1,1.8364528545823171e-06,1,2.2780963315814773e-06,0,0
12566,game-changing,1,1.8364528545823171e-06,1,2.2780963315814773e-06,0,0
12568,@miamidadecounty,1,1.8364528545823171e-06,1,2.2780963315814773e-06,0,0
12569,fast-growing,1,1.8364528545823171e-06,1,2.2780963315814773e-06,0,0
12571,@inhofeforsenate,1,1.8364528545823171e-06,1,2.2780963315814773e-06,0,0
12570,#oksen,1,1.8364528545823171e-06,1,2.2780963315814773e-06,0,0
12574,@smithsonian,1,1.8364528545823171e-06,1,2.2780963315814773e-06,0,0
12575,reopened,1,1.8364528545823171e-06,1,2.2780963315814773e-06,0,0
12573,@amhistorymuseum,1,1.8364528545823171e-06,1,2.2780963315814773e-06,0,0
12576,thugsclean,1,1.8364528545823171e-06,1,2.2780963315814773e-06,0,0
12578,entails,1,1.8364528545823171e-06,1,2.2780963315814773e-06,0,0
12579,609m,1,1.8364528545823171e-06,1,2.2780963315814773e-06,0,0
12581,albany,1,1.8364528545823171e-06,1,2.2780963315814773e-06,0,0
12582,areamore,1,1.8364528545823171e-06,1,2.2780963315814773e-06,0,0
12580,@cdta,1,1.8364528545823171e-06,1,2.2780963315814773e-06,0,0
12584,@southshoreline,1,1.8364528545823171e-06,1,2.2780963315814773e-06,0,0
12585,chicago-area,1,1.8364528545823171e-06,1,2.2780963315814773e-06,0,0
12583,@govholcomb,1,1.8364528545823171e-06,1,2.2780963315814773e-06,0,0
12593,ogden,1,1.8364528545823171e-06,1,2.2780963315814773e-06,0,0
12590,645m,1,1.8364528545823171e-06,1,2.2780963315814773e-06,0,0
12592,mckay-dee,1,1.8364528545823171e-06,1,2.2780963315814773e-06,0,0
12591,hospitalvery,1,1.8364528545823171e-06,1,2.2780963315814773e-06,0,0
12594,utahans,1,1.8364528545823171e-06,1,2.2780963315814773e-06,0,0
12595,9995m,1,1.8364528545823171e-06,1,2.2780963315814773e-06,0,0
12596,pittsburghers,1,1.8364528545823171e-06,1,2.2780963315814773e-06,0,0
12597,9999m,1,1.8364528545823171e-06,1,2.2780963315814773e-06,0,0
12600,409m,1,1.8364528545823171e-06,1,2.2780963315814773e-06,0,0
12603,milwaukees,1,1.8364528545823171e-06,1,2.2780963315814773e-06,0,0
12602,east-west,1,1.8364528545823171e-06,1,2.2780963315814773e-06,0,0
12604,regions,1,1.8364528545823171e-06,1,2.2780963315814773e-06,0,0
12605,spur,1,1.8364528545823171e-06,1,2.2780963315814773e-06,0,0
12601,@ridemcts,1,1.8364528545823171e-06,1,2.2780963315814773e-06,0,0
12607,#ky05,1,1.8364528545823171e-06,1,2.2780963315814773e-06,0,0
12612,philosophies,1,1.8364528545823171e-06,1,2.2780963315814773e-06,0,0
12611,agendas,1,1.8364528545823171e-06,1,2.2780963315814773e-06,0,0
12614,vilified,1,1.8364528545823171e-06,1,2.2780963315814773e-06,0,0
12616,mckelway,1,1.8364528545823171e-06,1,2.2780963315814773e-06,0,0
12615,212th,1,1.8364528545823171e-06,1,2.2780963315814773e-06,0,0
12617,blowoutnot,1,1.8364528545823171e-06,1,2.2780963315814773e-06,0,0
12618,financed,1,1.8364528545823171e-06,1,2.2780963315814773e-06,0,0
12621,hustory,1,1.8364528545823171e-06,1,2.2780963315814773e-06,0,0
12620,feat,1,1.8364528545823171e-06,1,2.2780963315814773e-06,0,0
12623,distillers,1,1.8364528545823171e-06,1,2.2780963315814773e-06,0,0
12624,sanitizer,1,1.8364528545823171e-06,1,2.2780963315814773e-06,0,0
12622,#covid19,1,1.8364528545823171e-06,1,2.2780963315814773e-06,0,0
12626,gutted,1,1.8364528545823171e-06,1,2.2780963315814773e-06,0,0
12625,cheered,1,1.8364528545823171e-06,1,2.2780963315814773e-06,0,0
12629,arbiter,1,1.8364528545823171e-06,1,2.2780963315814773e-06,0,0
12631,befall,1,1.8364528545823171e-06,1,2.2780963315814773e-06,0,0
12637,logo,1,1.8364528545823171e-06,1,2.2780963315814773e-06,0,0
12641,unsettling,1,1.8364528545823171e-06,1,2.2780963315814773e-06,0,0
12640,mclarty,1,1.8364528545823171e-06,1,2.2780963315814773e-06,0,0
12642,whiplash,1,1.8364528545823171e-06,1,2.2780963315814773e-06,0,0
12645,fortenberry,1,1.8364528545823171e-06,1,2.2780963315814773e-06,0,0
12644,@supportfortne,1,1.8364528545823171e-06,1,2.2780963315814773e-06,0,0
12643,#ne01,1,1.8364528545823171e-06,1,2.2780963315814773e-06,0,0
12647,@donjbacon,1,1.8364528545823171e-06,1,2.2780963315814773e-06,0,0
12646,#ne02,1,1.8364528545823171e-06,1,2.2780963315814773e-06,0,0
12648,regulated,1,1.8364528545823171e-06,1,2.2780963315814773e-06,0,0
12651,starrand,1,1.8364528545823171e-06,1,2.2780963315814773e-06,0,0
12653,#ne03,1,1.8364528545823171e-06,1,2.2780963315814773e-06,0,0
12656,intact,1,1.8364528545823171e-06,1,2.2780963315814773e-06,0,0
12658,dial,1,1.8364528545823171e-06,1,2.2780963315814773e-06,0,0
12659,accounting,1,1.8364528545823171e-06,1,2.2780963315814773e-06,0,0
12662,#thankatrucker,1,1.8364528545823171e-06,1,2.2780963315814773e-06,0,0
12663,endangers,1,1.8364528545823171e-06,1,2.2780963315814773e-06,0,0
12666,stones,1,1.8364528545823171e-06,1,2.2780963315814773e-06,0,0
12665,purification,1,1.8364528545823171e-06,1,2.2780963315814773e-06,0,0
12667,regulating,1,1.8364528545823171e-06,1,2.2780963315814773e-06,0,0
12668,#usaf73🇺🇸,1,1.8364528545823171e-06,1,2.2780963315814773e-06,0,0
12669,ems,1,1.8364528545823171e-06,1,2.2780963315814773e-06,0,0
12670,428,1,1.8364528545823171e-06,1,2.2780963315814773e-06,0,0
12673,@sendansullivan,1,1.8364528545823171e-06,1,2.2780963315814773e-06,0,0
12672,@repdonyoung,1,1.8364528545823171e-06,1,2.2780963315814773e-06,0,0
12674,a2a,1,1.8364528545823171e-06,1,2.2780963315814773e-06,0,0
12675,cross-border,1,1.8364528545823171e-06,1,2.2780963315814773e-06,0,0
12681,exterior,1,1.8364528545823171e-06,1,2.2780963315814773e-06,0,0
12680,defacing,1,1.8364528545823171e-06,1,2.2780963315814773e-06,0,0
12688,toll,1,1.8364528545823171e-06,1,2.2780963315814773e-06,0,0
12692,freitas,1,1.8364528545823171e-06,1,2.2780963315814773e-06,0,0
12690,@nickforva,1,1.8364528545823171e-06,1,2.2780963315814773e-06,0,0
12689,#va07,1,1.8364528545823171e-06,1,2.2780963315814773e-06,0,0
12694,revoke,1,1.8364528545823171e-06,1,2.2780963315814773e-06,0,0
12696,@goodforcongress,1,1.8364528545823171e-06,1,2.2780963315814773e-06,0,0
12695,#va05,1,1.8364528545823171e-06,1,2.2780963315814773e-06,0,0
12700,expression,1,1.8364528545823171e-06,1,2.2780963315814773e-06,0,0
12702,creepster,1,1.8364528545823171e-06,1,2.2780963315814773e-06,0,0
12703,disseminating,1,1.8364528545823171e-06,1,2.2780963315814773e-06,0,0
12710,kistner,1,1.8364528545823171e-06,1,2.2780963315814773e-06,0,0
12709,@kistnercongress,1,1.8364528545823171e-06,1,2.2780963315814773e-06,0,0
12708,#mn02,1,1.8364528545823171e-06,1,2.2780963315814773e-06,0,0
12717,vandalizes,1,1.8364528545823171e-06,1,2.2780963315814773e-06,0,0
12716,pertinent,1,1.8364528545823171e-06,1,2.2780963315814773e-06,0,0
12720,interestingly,1,1.8364528545823171e-06,1,2.2780963315814773e-06,0,0
12723,debartolo,1,1.8364528545823171e-06,1,2.2780963315814773e-06,0,0
12726,gidley,1,1.8364528545823171e-06,1,2.2780963315814773e-06,0,0
12725,@jhogangidley,1,1.8364528545823171e-06,1,2.2780963315814773e-06,0,0
12728,cryinchuck,1,1.8364528545823171e-06,1,2.2780963315814773e-06,0,0
12731,convicting,1,1.8364528545823171e-06,1,2.2780963315814773e-06,0,0
12732,innuendo,1,1.8364528545823171e-06,1,2.2780963315814773e-06,0,0
12733,democrsts,1,1.8364528545823171e-06,1,2.2780963315814773e-06,0,0
12735,vague,1,1.8364528545823171e-06,1,2.2780963315814773e-06,0,0
12736,trivial,1,1.8364528545823171e-06,1,2.2780963315814773e-06,0,0
12739,denials,1,1.8364528545823171e-06,1,2.2780963315814773e-06,0,0
12743,severly,1,1.8364528545823171e-06,1,2.2780963315814773e-06,0,0
12740,chastised,1,1.8364528545823171e-06,1,2.2780963315814773e-06,0,0
12747,buddys,1,1.8364528545823171e-06,1,2.2780963315814773e-06,0,0
12748,pro-wall,1,1.8364528545823171e-06,1,2.2780963315814773e-06,0,0
12750,riggleman,1,1.8364528545823171e-06,1,2.2780963315814773e-06,0,0
12754,@jeanineanez,1,1.8364528545823171e-06,1,2.2780963315814773e-06,0,0
12755,afar,1,1.8364528545823171e-06,1,2.2780963315814773e-06,0,0
12761,r-mo,1,1.8364528545823171e-06,1,2.2780963315814773e-06,0,0
12762,@murielbowser,1,1.8364528545823171e-06,1,2.2780963315814773e-06,0,0
12764,sellout,1,1.8364528545823171e-06,1,2.2780963315814773e-06,0,0
12765,squatters,1,1.8364528545823171e-06,1,2.2780963315814773e-06,0,0
12768,gifted,1,1.8364528545823171e-06,1,2.2780963315814773e-06,0,0
12775,faraway,1,1.8364528545823171e-06,1,2.2780963315814773e-06,0,0
12782,contenders,1,1.8364528545823171e-06,1,2.2780963315814773e-06,0,0
12785,133,1,1.8364528545823171e-06,1,2.2780963315814773e-06,0,0
12786,replaceable,1,1.8364528545823171e-06,1,2.2780963315814773e-06,0,0
12787,bored,1,1.8364528545823171e-06,1,2.2780963315814773e-06,0,0
12789,frisky,1,1.8364528545823171e-06,1,2.2780963315814773e-06,0,0
12788,breaching,1,1.8364528545823171e-06,1,2.2780963315814773e-06,0,0
12794,puddles,1,1.8364528545823171e-06,1,2.2780963315814773e-06,0,0
12798,associate,1,1.8364528545823171e-06,1,2.2780963315814773e-06,0,0
12809,secondly,1,1.8364528545823171e-06,1,2.2780963315814773e-06,0,0
12806,@foxbus,1,1.8364528545823171e-06,1,2.2780963315814773e-06,0,0
12817,mistaken,1,1.8364528545823171e-06,1,2.2780963315814773e-06,0,0
12816,mcarthur,1,1.8364528545823171e-06,1,2.2780963315814773e-06,0,0
12818,patton,1,1.8364528545823171e-06,1,2.2780963315814773e-06,0,0
12819,#justiceact,1,1.8364528545823171e-06,1,2.2780963315814773e-06,0,0
12820,418,1,1.8364528545823171e-06,1,2.2780963315814773e-06,0,0
12822,respiratory,1,1.8364528545823171e-06,1,2.2780963315814773e-06,0,0
12823,therapists,1,1.8364528545823171e-06,1,2.2780963315814773e-06,0,0
12824,listings,1,1.8364528545823171e-06,1,2.2780963315814773e-06,0,0
12826,payoffs,1,1.8364528545823171e-06,1,2.2780963315814773e-06,0,0
12828,sucks,1,1.8364528545823171e-06,1,2.2780963315814773e-06,0,0
12830,minded,1,1.8364528545823171e-06,1,2.2780963315814773e-06,0,0
12842,uneven,1,1.8364528545823171e-06,1,2.2780963315814773e-06,0,0
12844,rood,1,1.8364528545823171e-06,1,2.2780963315814773e-06,0,0
12843,endeavors,1,1.8364528545823171e-06,1,2.2780963315814773e-06,0,0
12848,collect,1,1.8364528545823171e-06,1,2.2780963315814773e-06,0,0
12851,incite,1,1.8364528545823171e-06,1,2.2780963315814773e-06,0,0
12852,#salutetoamerica,1,1.8364528545823171e-06,1,2.2780963315814773e-06,0,0
12853,@uspostoffice911,1,1.8364528545823171e-06,1,2.2780963315814773e-06,0,0
12856,bribing,1,1.8364528545823171e-06,1,2.2780963315814773e-06,0,0
12857,ex-prisoners,1,1.8364528545823171e-06,1,2.2780963315814773e-06,0,0
12858,graces,1,1.8364528545823171e-06,1,2.2780963315814773e-06,0,0
12868,mankato,1,1.8364528545823171e-06,1,2.2780963315814773e-06,0,0
12875,wannabe,1,1.8364528545823171e-06,1,2.2780963315814773e-06,0,0
12874,pressplease,1,1.8364528545823171e-06,1,2.2780963315814773e-06,0,0
12877,lobstering,1,1.8364528545823171e-06,1,2.2780963315814773e-06,0,0
12882,turbulent,1,1.8364528545823171e-06,1,2.2780963315814773e-06,0,0
12885,perfected,1,1.8364528545823171e-06,1,2.2780963315814773e-06,0,0
12887,azithromycin,1,1.8364528545823171e-06,1,2.2780963315814773e-06,0,0
12888,changers,1,1.8364528545823171e-06,1,2.2780963315814773e-06,0,0
12886,antimicrobial,1,1.8364528545823171e-06,1,2.2780963315814773e-06,0,0
12892,misdeeds,1,1.8364528545823171e-06,1,2.2780963315814773e-06,0,0
12895,frederick,1,1.8364528545823171e-06,1,2.2780963315814773e-06,0,0
12894,douglass,1,1.8364528545823171e-06,1,2.2780963315814773e-06,0,0
12897,advancement,1,1.8364528545823171e-06,1,2.2780963315814773e-06,0,0
12899,horace,1,1.8364528545823171e-06,1,2.2780963315814773e-06,0,0
12900,280,1,1.8364528545823171e-06,1,2.2780963315814773e-06,0,0
12901,disintegrate,1,1.8364528545823171e-06,1,2.2780963315814773e-06,0,0
12903,@bubbawallace,1,1.8364528545823171e-06,1,2.2780963315814773e-06,0,0
12905,debts,1,1.8364528545823171e-06,1,2.2780963315814773e-06,0,0
12907,leveraged,1,1.8364528545823171e-06,1,2.2780963315814773e-06,0,0
12909,commentator,1,1.8364528545823171e-06,1,2.2780963315814773e-06,0,0
12914,persists,1,1.8364528545823171e-06,1,2.2780963315814773e-06,0,0
12921,redskins,1,1.8364528545823171e-06,1,2.2780963315814773e-06,0,0
12920,franchises,1,1.8364528545823171e-06,1,2.2780963315814773e-06,0,0
12924,foment,1,1.8364528545823171e-06,1,2.2780963315814773e-06,0,0
12928,bumbling,1,1.8364528545823171e-06,1,2.2780963315814773e-06,0,0
12930,2541,1,1.8364528545823171e-06,1,2.2780963315814773e-06,0,0
12931,264,1,1.8364528545823171e-06,1,2.2780963315814773e-06,0,0
12932,@henryfordnews,1,1.8364528545823171e-06,1,2.2780963315814773e-06,0,0
12934,heart-related,1,1.8364528545823171e-06,1,2.2780963315814773e-06,0,0
12937,side-effects,1,1.8364528545823171e-06,1,2.2780963315814773e-06,0,0
12935,large-scale,1,1.8364528545823171e-06,1,2.2780963315814773e-06,0,0
12936,retrospective,1,1.8364528545823171e-06,1,2.2780963315814773e-06,0,0
12939,sedition,1,1.8364528545823171e-06,1,2.2780963315814773e-06,0,0
12938,insurrection,1,1.8364528545823171e-06,1,2.2780963315814773e-06,0,0
12940,@jrubinblogger,1,1.8364528545823171e-06,1,2.2780963315814773e-06,0,0
12942,icon,1,1.8364528545823171e-06,1,2.2780963315814773e-06,0,0
12945,towertiffany,1,1.8364528545823171e-06,1,2.2780963315814773e-06,0,0
12948,@jennpellegrino,1,1.8364528545823171e-06,1,2.2780963315814773e-06,0,0
12951,#truckers4trump,1,1.8364528545823171e-06,1,2.2780963315814773e-06,0,0
12953,elder,1,1.8364528545823171e-06,1,2.2780963315814773e-06,0,0
12956,mortifyingly,1,1.8364528545823171e-06,1,2.2780963315814773e-06,0,0
12960,vacated,1,1.8364528545823171e-06,1,2.2780963315814773e-06,0,0
12962,marinette,1,1.8364528545823171e-06,1,2.2780963315814773e-06,0,0
12963,@peternavarrousa,1,1.8364528545823171e-06,1,2.2780963315814773e-06,0,0
12967,disparaged,1,1.8364528545823171e-06,1,2.2780963315814773e-06,0,0
12976,وزیر,1,1.8364528545823171e-06,1,2.2780963315814773e-06,0,0
12968,امور,1,1.8364528545823171e-06,1,2.2780963315814773e-06,0,0
12971,خارجه,1,1.8364528545823171e-06,1,2.2780963315814773e-06,0,0
12977,گوید,1,1.8364528545823171e-06,1,2.2780963315814773e-06,0,0
12972,خواستار,1,1.8364528545823171e-06,1,2.2780963315814773e-06,0,0
12969,ایالات,1,1.8364528545823171e-06,1,2.2780963315814773e-06,0,0
12970,برداشته,1,1.8364528545823171e-06,1,2.2780963315814773e-06,0,0
12975,نه،,1,1.8364528545823171e-06,1,2.2780963315814773e-06,0,0
12974,مرسی,1,1.8364528545823171e-06,1,2.2780963315814773e-06,0,0
12978,afterthought,1,1.8364528545823171e-06,1,2.2780963315814773e-06,0,0
12980,unenthusiastic,1,1.8364528545823171e-06,1,2.2780963315814773e-06,0,0
12981,embers,1,1.8364528545823171e-06,1,2.2780963315814773e-06,0,0
12986,supremest,1,1.8364528545823171e-06,1,2.2780963315814773e-06,0,0
12989,trashed,1,1.8364528545823171e-06,1,2.2780963315814773e-06,0,0
12991,plunges,1,1.8364528545823171e-06,1,2.2780963315814773e-06,0,0
12990,peak,1,1.8364528545823171e-06,1,2.2780963315814773e-06,0,0
12993,nominationbut,1,1.8364528545823171e-06,1,2.2780963315814773e-06,0,0
12997,utterly,1,1.8364528545823171e-06,1,2.2780963315814773e-06,0,0
12995,inexplicable,1,1.8364528545823171e-06,1,2.2780963315814773e-06,0,0
13002,vandalization,1,1.8364528545823171e-06,1,2.2780963315814773e-06,0,0
13000,@fbiwfo,1,1.8364528545823171e-06,1,2.2780963315814773e-06,0,0
13005,frieda,1,1.8364528545823171e-06,1,2.2780963315814773e-06,0,0
13006,manhattans,1,1.8364528545823171e-06,1,2.2780963315814773e-06,0,0
13015,rocker,1,1.8364528545823171e-06,1,2.2780963315814773e-06,0,0
13014,hermitage,1,1.8364528545823171e-06,1,2.2780963315814773e-06,0,0
13013,hazel,1,1.8364528545823171e-06,1,2.2780963315814773e-06,0,0
13011,#ripcharliedaniels,1,1.8364528545823171e-06,1,2.2780963315814773e-06,0,0
13016,enforced,1,1.8364528545823171e-06,1,2.2780963315814773e-06,0,0
13017,@lvmpds,1,1.8364528545823171e-06,1,2.2780963315814773e-06,0,0
13018,reaffirmed,1,1.8364528545823171e-06,1,2.2780963315814773e-06,0,0
13022,ab,1,1.8364528545823171e-06,1,2.2780963315814773e-06,0,0
13023,stoddard,1,1.8364528545823171e-06,1,2.2780963315814773e-06,0,0
13024,impractical,1,1.8364528545823171e-06,1,2.2780963315814773e-06,0,0
13027,#confirmacb,1,1.8364528545823171e-06,1,2.2780963315814773e-06,0,0
13031,brief,1,1.8364528545823171e-06,1,2.2780963315814773e-06,0,0
13033,tiffanys,1,1.8364528545823171e-06,1,2.2780963315814773e-06,0,0
13032,bustling,1,1.8364528545823171e-06,1,2.2780963315814773e-06,0,0
13034,beneath,1,1.8364528545823171e-06,1,2.2780963315814773e-06,0,0
13036,peaks,1,1.8364528545823171e-06,1,2.2780963315814773e-06,0,0
13038,berniebidenaoc,1,1.8364528545823171e-06,1,2.2780963315814773e-06,0,0
13041,swore,1,1.8364528545823171e-06,1,2.2780963315814773e-06,0,0
13040,do…,1,1.8364528545823171e-06,1,2.2780963315814773e-06,0,0
13046,deceit,1,1.8364528545823171e-06,1,2.2780963315814773e-06,0,0
13048,haven,1,1.8364528545823171e-06,1,2.2780963315814773e-06,0,0
13049,22-o,1,1.8364528545823171e-06,1,2.2780963315814773e-06,0,0
13052,repressed,1,1.8364528545823171e-06,1,2.2780963315814773e-06,0,0
13050,hungry,1,1.8364528545823171e-06,1,2.2780963315814773e-06,0,0
13056,disregarding,1,1.8364528545823171e-06,1,2.2780963315814773e-06,0,0
13058,passwords,1,1.8364528545823171e-06,1,2.2780963315814773e-06,0,0
13064,intentionally,1,1.8364528545823171e-06,1,2.2780963315814773e-06,0,0
13065,pressures,1,1.8364528545823171e-06,1,2.2780963315814773e-06,0,0
13067,adolph,1,1.8364528545823171e-06,1,2.2780963315814773e-06,0,0
13070,ochs,1,1.8364528545823171e-06,1,2.2780963315814773e-06,0,0
13069,impartially,1,1.8364528545823171e-06,1,2.2780963315814773e-06,0,0
13071,sect,1,1.8364528545823171e-06,1,2.2780963315814773e-06,0,0
13073,impartial,1,1.8364528545823171e-06,1,2.2780963315814773e-06,0,0
13074,readers,1,1.8364528545823171e-06,1,2.2780963315814773e-06,0,0
13072,gl,1,1.8364528545823171e-06,1,2.2780963315814773e-06,0,0
13075,replenish,1,1.8364528545823171e-06,1,2.2780963315814773e-06,0,0
13076,activate,1,1.8364528545823171e-06,1,2.2780963315814773e-06,0,0
13085,orrin,1,1.8364528545823171e-06,1,2.2780963315814773e-06,0,0
13084,hatch,1,1.8364528545823171e-06,1,2.2780963315814773e-06,0,0
13091,starved,1,1.8364528545823171e-06,1,2.2780963315814773e-06,0,0
13096,showdavid,1,1.8364528545823171e-06,1,2.2780963315814773e-06,0,0
13099,@amazon,1,1.8364528545823171e-06,1,2.2780963315814773e-06,0,0
13104,monson,1,1.8364528545823171e-06,1,2.2780963315814773e-06,0,0
13102,latter-day,1,1.8364528545823171e-06,1,2.2780963315814773e-06,0,0
13111,doexcept,1,1.8364528545823171e-06,1,2.2780963315814773e-06,0,0
13113,weighing,1,1.8364528545823171e-06,1,2.2780963315814773e-06,0,0
13114,beautifulshow,1,1.8364528545823171e-06,1,2.2780963315814773e-06,0,0
13116,crashes,1,1.8364528545823171e-06,1,2.2780963315814773e-06,0,0
13117,stinks,1,1.8364528545823171e-06,1,2.2780963315814773e-06,0,0
13119,oc,1,1.8364528545823171e-06,1,2.2780963315814773e-06,0,0
13118,alwaysalways,1,1.8364528545823171e-06,1,2.2780963315814773e-06,0,0
13120,500m,1,1.8364528545823171e-06,1,2.2780963315814773e-06,0,0
13125,boomingbut,1,1.8364528545823171e-06,1,2.2780963315814773e-06,0,0
13126,18589,1,1.8364528545823171e-06,1,2.2780963315814773e-06,0,0
13127,25075,1,1.8364528545823171e-06,1,2.2780963315814773e-06,0,0
13129,fbirussia,1,1.8364528545823171e-06,1,2.2780963315814773e-06,0,0
13130,imaginable,1,1.8364528545823171e-06,1,2.2780963315814773e-06,0,0
13133,mercer,1,1.8364528545823171e-06,1,2.2780963315814773e-06,0,0
13135,wolff,1,1.8364528545823171e-06,1,2.2780963315814773e-06,0,0
13137,newscast,1,1.8364528545823171e-06,1,2.2780963315814773e-06,0,0
13140,invigorating,1,1.8364528545823171e-06,1,2.2780963315814773e-06,0,0
13141,mutineers,1,1.8364528545823171e-06,1,2.2780963315814773e-06,0,0
13143,plunging,1,1.8364528545823171e-06,1,2.2780963315814773e-06,0,0
13145,lapdogs,1,1.8364528545823171e-06,1,2.2780963315814773e-06,0,0
13148,geniusand,1,1.8364528545823171e-06,1,2.2780963315814773e-06,0,0
13151,tapper,1,1.8364528545823171e-06,1,2.2780963315814773e-06,0,0
13155,enormously,1,1.8364528545823171e-06,1,2.2780963315814773e-06,0,0
13153,accumulate,1,1.8364528545823171e-06,1,2.2780963315814773e-06,0,0
13161,narco-terrorists,1,1.8364528545823171e-06,1,2.2780963315814773e-06,0,0
13159,deployments,1,1.8364528545823171e-06,1,2.2780963315814773e-06,0,0
13164,shredded,1,1.8364528545823171e-06,1,2.2780963315814773e-06,0,0
13166,far-reaching,1,1.8364528545823171e-06,1,2.2780963315814773e-06,0,0
13169,@farmbureau,1,1.8364528545823171e-06,1,2.2780963315814773e-06,0,0
13170,federations,1,1.8364528545823171e-06,1,2.2780963315814773e-06,0,0
13167,#afbf18on,1,1.8364528545823171e-06,1,2.2780963315814773e-06,0,0
13171,#afbf18,1,1.8364528545823171e-06,1,2.2780963315814773e-06,0,0
13173,stagnant,1,1.8364528545823171e-06,1,2.2780963315814773e-06,0,0
13174,1100th,1,1.8364528545823171e-06,1,2.2780963315814773e-06,0,0
13178,267,1,1.8364528545823171e-06,1,2.2780963315814773e-06,0,0
13179,junior,1,1.8364528545823171e-06,1,2.2780963315814773e-06,0,0
13183,knockout,1,1.8364528545823171e-06,1,2.2780963315814773e-06,0,0
13184,misinformation,1,1.8364528545823171e-06,1,2.2780963315814773e-06,0,0
13185,prefers,1,1.8364528545823171e-06,1,2.2780963315814773e-06,0,0
13186,caughtbut,1,1.8364528545823171e-06,1,2.2780963315814773e-06,0,0
13188,compton,1,1.8364528545823171e-06,1,2.2780963315814773e-06,0,0
13190,thinker,1,1.8364528545823171e-06,1,2.2780963315814773e-06,0,0
13189,pocketbooks,1,1.8364528545823171e-06,1,2.2780963315814773e-06,0,0
13191,196,1,1.8364528545823171e-06,1,2.2780963315814773e-06,0,0
13193,notification,1,1.8364528545823171e-06,1,2.2780963315814773e-06,0,0
13201,morebut,1,1.8364528545823171e-06,1,2.2780963315814773e-06,0,0
13203,sputtering,1,1.8364528545823171e-06,1,2.2780963315814773e-06,0,0
13206,deference,1,1.8364528545823171e-06,1,2.2780963315814773e-06,0,0
13207,#thanksfordelivering,1,1.8364528545823171e-06,1,2.2780963315814773e-06,0,0
13208,caightand,1,1.8364528545823171e-06,1,2.2780963315814773e-06,0,0
13211,hank,1,1.8364528545823171e-06,1,2.2780963315814773e-06,0,0
13215,pranab,1,1.8364528545823171e-06,1,2.2780963315814773e-06,0,0
13214,mukherjee,1,1.8364528545823171e-06,1,2.2780963315814773e-06,0,0
13217,crist,1,1.8364528545823171e-06,1,2.2780963315814773e-06,0,0
13220,all-in,1,1.8364528545823171e-06,1,2.2780963315814773e-06,0,0
13221,nissan,1,1.8364528545823171e-06,1,2.2780963315814773e-06,0,0
13223,vassal,1,1.8364528545823171e-06,1,2.2780963315814773e-06,0,0
13222,repudiate,1,1.8364528545823171e-06,1,2.2780963315814773e-06,0,0
13224,caughtand,1,1.8364528545823171e-06,1,2.2780963315814773e-06,0,0
13226,tba,1,1.8364528545823171e-06,1,2.2780963315814773e-06,0,0
13229,metal,1,1.8364528545823171e-06,1,2.2780963315814773e-06,0,0
13230,@owensminor,1,1.8364528545823171e-06,1,2.2780963315814773e-06,0,0
13234,moolenaar,1,1.8364528545823171e-06,1,2.2780963315814773e-06,0,0
13236,nimble,1,1.8364528545823171e-06,1,2.2780963315814773e-06,0,0
13238,#teamwork,1,1.8364528545823171e-06,1,2.2780963315814773e-06,0,0
13240,refilling,1,1.8364528545823171e-06,1,2.2780963315814773e-06,0,0
13241,#nationalvoterregistrationday,1,1.8364528545823171e-06,1,2.2780963315814773e-06,0,0
13242,abstoddard,1,1.8364528545823171e-06,1,2.2780963315814773e-06,0,0
13243,shepherd,1,1.8364528545823171e-06,1,2.2780963315814773e-06,0,0
13246,scarboroughs,1,1.8364528545823171e-06,1,2.2780963315814773e-06,0,0
13244,battlegrounds,1,1.8364528545823171e-06,1,2.2780963315814773e-06,0,0
13249,@jbpritzker,1,1.8364528545823171e-06,1,2.2780963315814773e-06,0,0
13250,shortcomings,1,1.8364528545823171e-06,1,2.2780963315814773e-06,0,0
13252,g-8,1,1.8364528545823171e-06,1,2.2780963315814773e-06,0,0
13254,third-rate,1,1.8364528545823171e-06,1,2.2780963315814773e-06,0,0
13259,pre-order,1,1.8364528545823171e-06,1,2.2780963315814773e-06,0,0
13263,richter,1,1.8364528545823171e-06,1,2.2780963315814773e-06,0,0
13262,@davidrichternj,1,1.8364528545823171e-06,1,2.2780963315814773e-06,0,0
13264,boundless,1,1.8364528545823171e-06,1,2.2780963315814773e-06,0,0
13267,persuasions,1,1.8364528545823171e-06,1,2.2780963315814773e-06,0,0
13271,@ericschmitt,1,1.8364528545823171e-06,1,2.2780963315814773e-06,0,0
13270,#moag,1,1.8364528545823171e-06,1,2.2780963315814773e-06,0,0
13272,@tulsigabbard,1,1.8364528545823171e-06,1,2.2780963315814773e-06,0,0
13281,lanhee,1,1.8364528545823171e-06,1,2.2780963315814773e-06,0,0
13276,chen,1,1.8364528545823171e-06,1,2.2780963315814773e-06,0,0
13280,institution,1,1.8364528545823171e-06,1,2.2780963315814773e-06,0,0
13283,vanessa,1,1.8364528545823171e-06,1,2.2780963315814773e-06,0,0
13284,gianna,1,1.8364528545823171e-06,1,2.2780963315814773e-06,0,0
13288,taiwanese,1,1.8364528545823171e-06,1,2.2780963315814773e-06,0,0
13285,alerting,1,1.8364528545823171e-06,1,2.2780963315814773e-06,0,0
13289,transmitted,1,1.8364528545823171e-06,1,2.2780963315814773e-06,0,0
13287,humans,1,1.8364528545823171e-06,1,2.2780963315814773e-06,0,0
13286,ere,1,1.8364528545823171e-06,1,2.2780963315814773e-06,0,0
13290,@southcom,1,1.8364528545823171e-06,1,2.2780963315814773e-06,0,0
13291,@mattgaetz,1,1.8364528545823171e-06,1,2.2780963315814773e-06,0,0
13293,firebrand,1,1.8364528545823171e-06,1,2.2780963315814773e-06,0,0
13292,dispatches,1,1.8364528545823171e-06,1,2.2780963315814773e-06,0,0
13295,cent,1,1.8364528545823171e-06,1,2.2780963315814773e-06,0,0
13296,grantees,1,1.8364528545823171e-06,1,2.2780963315814773e-06,0,0
13297,re-examine,1,1.8364528545823171e-06,1,2.2780963315814773e-06,0,0
13298,tax-exempt,1,1.8364528545823171e-06,1,2.2780963315814773e-06,0,0
13302,race-based,1,1.8364528545823171e-06,1,2.2780963315814773e-06,0,0
13309,javelin,1,1.8364528545823171e-06,1,2.2780963315814773e-06,0,0
13308,anti-tank,1,1.8364528545823171e-06,1,2.2780963315814773e-06,0,0
13310,complained,1,1.8364528545823171e-06,1,2.2780963315814773e-06,0,0
13311,fay,1,1.8364528545823171e-06,1,2.2780963315814773e-06,0,0
13314,reschedule,1,1.8364528545823171e-06,1,2.2780963315814773e-06,0,0
13312,pease,1,1.8364528545823171e-06,1,2.2780963315814773e-06,0,0
13316,pool,1,1.8364528545823171e-06,1,2.2780963315814773e-06,0,0
13318,keyboard,1,1.8364528545823171e-06,1,2.2780963315814773e-06,0,0
13321,302,1,1.8364528545823171e-06,1,2.2780963315814773e-06,0,0
13320,#obamagate,1,1.8364528545823171e-06,1,2.2780963315814773e-06,0,0
13323,bidenobama,1,1.8364528545823171e-06,1,2.2780963315814773e-06,0,0
13324,unnecessarily,1,1.8364528545823171e-06,1,2.2780963315814773e-06,0,0
13327,walorski,1,1.8364528545823171e-06,1,2.2780963315814773e-06,0,0
13326,@jackiewalorski,1,1.8364528545823171e-06,1,2.2780963315814773e-06,0,0
13325,#in02,1,1.8364528545823171e-06,1,2.2780963315814773e-06,0,0
13329,@harris4congress,1,1.8364528545823171e-06,1,2.2780963315814773e-06,0,0
13328,#md01,1,1.8364528545823171e-06,1,2.2780963315814773e-06,0,0
13330,bins,1,1.8364528545823171e-06,1,2.2780963315814773e-06,0,0
13331,dumpster,1,1.8364528545823171e-06,1,2.2780963315814773e-06,0,0
13335,xenophobia,1,1.8364528545823171e-06,1,2.2780963315814773e-06,0,0
13337,@roundsforsenate,1,1.8364528545823171e-06,1,2.2780963315814773e-06,0,0
13336,#sdsen,1,1.8364528545823171e-06,1,2.2780963315814773e-06,0,0
13341,@mikesimpson4id,1,1.8364528545823171e-06,1,2.2780963315814773e-06,0,0
13340,#id02,1,1.8364528545823171e-06,1,2.2780963315814773e-06,0,0
13344,fulcher,1,1.8364528545823171e-06,1,2.2780963315814773e-06,0,0
13343,@russfulcher,1,1.8364528545823171e-06,1,2.2780963315814773e-06,0,0
13342,#id01,1,1.8364528545823171e-06,1,2.2780963315814773e-06,0,0
13348,treasured,1,1.8364528545823171e-06,1,2.2780963315814773e-06,0,0
13352,eaten,1,1.8364528545823171e-06,1,2.2780963315814773e-06,0,0
13354,@dustyjohnson,1,1.8364528545823171e-06,1,2.2780963315814773e-06,0,0
13353,#sdal,1,1.8364528545823171e-06,1,2.2780963315814773e-06,0,0
13357,ned,1,1.8364528545823171e-06,1,2.2780963315814773e-06,0,0
13362,supremely,1,1.8364528545823171e-06,1,2.2780963315814773e-06,0,0
13361,concasts,1,1.8364528545823171e-06,1,2.2780963315814773e-06,0,0
13363,adamant,1,1.8364528545823171e-06,1,2.2780963315814773e-06,0,0
13364,mccains,1,1.8364528545823171e-06,1,2.2780963315814773e-06,0,0
13366,@gregpencein,1,1.8364528545823171e-06,1,2.2780963315814773e-06,0,0
13365,#in06,1,1.8364528545823171e-06,1,2.2780963315814773e-06,0,0
13368,@jimbanks,1,1.8364528545823171e-06,1,2.2780963315814773e-06,0,0
13367,#in03,1,1.8364528545823171e-06,1,2.2780963315814773e-06,0,0
13370,@njtransit,1,1.8364528545823171e-06,1,2.2780963315814773e-06,0,0
13369,14b,1,1.8364528545823171e-06,1,2.2780963315814773e-06,0,0
13371,nynj,1,1.8364528545823171e-06,1,2.2780963315814773e-06,0,0
13373,foresight,1,1.8364528545823171e-06,1,2.2780963315814773e-06,0,0
13376,@cta,1,1.8364528545823171e-06,1,2.2780963315814773e-06,0,0
13375,817m,1,1.8364528545823171e-06,1,2.2780963315814773e-06,0,0
13379,@nytimesbooks,1,1.8364528545823171e-06,1,2.2780963315814773e-06,0,0
13380,deadheads,1,1.8364528545823171e-06,1,2.2780963315814773e-06,0,0
13382,sabotaged,1,1.8364528545823171e-06,1,2.2780963315814773e-06,0,0
13383,#savenyc,1,1.8364528545823171e-06,1,2.2780963315814773e-06,0,0
13384,@spaceforcedod,1,1.8364528545823171e-06,1,2.2780963315814773e-06,0,0
13385,displaying,1,1.8364528545823171e-06,1,2.2780963315814773e-06,0,0
13386,cooperating,1,1.8364528545823171e-06,1,2.2780963315814773e-06,0,0
13387,honoree,1,1.8364528545823171e-06,1,2.2780963315814773e-06,0,0
13388,@dineshdsouza,1,1.8364528545823171e-06,1,2.2780963315814773e-06,0,0
13394,reportedly,1,1.8364528545823171e-06,1,2.2780963315814773e-06,0,0
13396,spectacularly,1,1.8364528545823171e-06,1,2.2780963315814773e-06,0,0
13400,racket,1,1.8364528545823171e-06,1,2.2780963315814773e-06,0,0
13397,@sensusancollins,1,1.8364528545823171e-06,1,2.2780963315814773e-06,0,0
13402,shari,1,1.8364528545823171e-06,1,2.2780963315814773e-06,0,0
13401,redstone,1,1.8364528545823171e-06,1,2.2780963315814773e-06,0,0
13399,performing,1,1.8364528545823171e-06,1,2.2780963315814773e-06,0,0
13404,individulal,1,1.8364528545823171e-06,1,2.2780963315814773e-06,0,0
13408,history…,1,1.8364528545823171e-06,1,2.2780963315814773e-06,0,0
13410,macys,1,1.8364528545823171e-06,1,2.2780963315814773e-06,0,0
13413,vandalized,1,1.8364528545823171e-06,1,2.2780963315814773e-06,0,0
13411,panels,1,1.8364528545823171e-06,1,2.2780963315814773e-06,0,0
13412,storefront,1,1.8364528545823171e-06,1,2.2780963315814773e-06,0,0
13414,extradited,1,1.8364528545823171e-06,1,2.2780963315814773e-06,0,0
13416,29th,1,1.8364528545823171e-06,1,2.2780963315814773e-06,0,0
13421,@repdonbacon,1,1.8364528545823171e-06,1,2.2780963315814773e-06,0,0
13423,77m,1,1.8364528545823171e-06,1,2.2780963315814773e-06,0,0
13425,myersnaples,1,1.8364528545823171e-06,1,2.2780963315814773e-06,0,0
13426,dislike,1,1.8364528545823171e-06,1,2.2780963315814773e-06,0,0
13427,christine,1,1.8364528545823171e-06,1,2.2780963315814773e-06,0,0
13428,princeton,1,1.8364528545823171e-06,1,2.2780963315814773e-06,0,0
13429,woodrow,1,1.8364528545823171e-06,1,2.2780963315814773e-06,0,0
13431,regulationcuts,1,1.8364528545823171e-06,1,2.2780963315814773e-06,0,0
13434,shelter-in-place,1,1.8364528545823171e-06,1,2.2780963315814773e-06,0,0
13433,mode,1,1.8364528545823171e-06,1,2.2780963315814773e-06,0,0
13435,showcased,1,1.8364528545823171e-06,1,2.2780963315814773e-06,0,0
13437,brigade,1,1.8364528545823171e-06,1,2.2780963315814773e-06,0,0
13436,25-06,1,1.8364528545823171e-06,1,2.2780963315814773e-06,0,0
13439,ironclad,1,1.8364528545823171e-06,1,2.2780963315814773e-06,0,0
13440,battleship,1,1.8364528545823171e-06,1,2.2780963315814773e-06,0,0
13445,218,1,1.8364528545823171e-06,1,2.2780963315814773e-06,0,0
13446,dorn,1,1.8364528545823171e-06,1,2.2780963315814773e-06,0,0
13450,mann,1,1.8364528545823171e-06,1,2.2780963315814773e-06,0,0
13449,@traceymannks,1,1.8364528545823171e-06,1,2.2780963315814773e-06,0,0
13448,#ks01,1,1.8364528545823171e-06,1,2.2780963315814773e-06,0,0
13452,lankford,1,1.8364528545823171e-06,1,2.2780963315814773e-06,0,0
13454,आने,1,1.8364528545823171e-06,1,2.2780963315814773e-06,0,0
13458,तत्पर,1,1.8364528545823171e-06,1,2.2780963315814773e-06,0,0
13469,।,1,1.8364528545823171e-06,1,2.2780963315814773e-06,0,0
13462,रास्ते,1,1.8364528545823171e-06,1,2.2780963315814773e-06,0,0
13467,हैँ,1,1.8364528545823171e-06,1,2.2780963315814773e-06,0,0
13455,कुछ,1,1.8364528545823171e-06,1,2.2780963315814773e-06,0,0
13457,घंटों,1,1.8364528545823171e-06,1,2.2780963315814773e-06,0,0
13464,सबसे,1,1.8364528545823171e-06,1,2.2780963315814773e-06,0,0
13460,मिलेंगे,1,1.8364528545823171e-06,1,2.2780963315814773e-06,0,0
13472,gianforte,1,1.8364528545823171e-06,1,2.2780963315814773e-06,0,0
13473,montanas,1,1.8364528545823171e-06,1,2.2780963315814773e-06,0,0
13470,#mtgov,1,1.8364528545823171e-06,1,2.2780963315814773e-06,0,0
13491,प्रथम,1,1.8364528545823171e-06,1,2.2780963315814773e-06,0,0
13493,महिला,1,1.8364528545823171e-06,1,2.2780963315814773e-06,0,0
13477,इस,1,1.8364528545823171e-06,1,2.2780963315814773e-06,0,0
13487,देश,1,1.8364528545823171e-06,1,2.2780963315814773e-06,0,0
13505,हर,1,1.8364528545823171e-06,1,2.2780963315814773e-06,0,0
13489,नागरिक,1,1.8364528545823171e-06,1,2.2780963315814773e-06,0,0
13478,एक,1,1.8364528545823171e-06,1,2.2780963315814773e-06,0,0
13502,सन्देश,1,1.8364528545823171e-06,1,2.2780963315814773e-06,0,0
13486,देने,1,1.8364528545823171e-06,1,2.2780963315814773e-06,0,0
13485,दुनिया,1,1.8364528545823171e-06,1,2.2780963315814773e-06,0,0
13494,मील,1,1.8364528545823171e-06,1,2.2780963315814773e-06,0,0
13484,चक्कर,1,1.8364528545823171e-06,1,2.2780963315814773e-06,0,0
13498,लगा,1,1.8364528545823171e-06,1,2.2780963315814773e-06,0,0
13480,कर,1,1.8364528545823171e-06,1,2.2780963315814773e-06,0,0
13496,यहां,1,1.8364528545823171e-06,1,2.2780963315814773e-06,0,0
13476,आये,1,1.8364528545823171e-06,1,2.2780963315814773e-06,0,0
13503,सम्मान,1,1.8364528545823171e-06,1,2.2780963315814773e-06,0,0
13474,अमरीका,1,1.8364528545823171e-06,1,2.2780963315814773e-06,0,0
13499,लोग,1,1.8364528545823171e-06,1,2.2780963315814773e-06,0,0
13504,हमेशा,1,1.8364528545823171e-06,1,2.2780963315814773e-06,0,0
13501,सच्चे,1,1.8364528545823171e-06,1,2.2780963315814773e-06,0,0
13490,निष्ठावान,1,1.8364528545823171e-06,1,2.2780963315814773e-06,0,0
13488,दोस्त,1,1.8364528545823171e-06,1,2.2780963315814773e-06,0,0
13497,रहेंगे,1,1.8364528545823171e-06,1,2.2780963315814773e-06,0,0
13508,bungling,1,1.8364528545823171e-06,1,2.2780963315814773e-06,0,0
13510,start-stop,1,1.8364528545823171e-06,1,2.2780963315814773e-06,0,0
13514,harshbarger,1,1.8364528545823171e-06,1,2.2780963315814773e-06,0,0
13512,@dharshbargertn1,1,1.8364528545823171e-06,1,2.2780963315814773e-06,0,0
13511,#tn01,1,1.8364528545823171e-06,1,2.2780963315814773e-06,0,0
13516,@fitzgeraldforwi,1,1.8364528545823171e-06,1,2.2780963315814773e-06,0,0
13515,#wi05,1,1.8364528545823171e-06,1,2.2780963315814773e-06,0,0
13518,#cosen,1,1.8364528545823171e-06,1,2.2780963315814773e-06,0,0
13526,देशों,1,1.8364528545823171e-06,1,2.2780963315814773e-06,0,0
13532,मजबूत,1,1.8364528545823171e-06,1,2.2780963315814773e-06,0,0
13537,सम्पन्न,1,1.8364528545823171e-06,1,2.2780963315814773e-06,0,0
13529,बड़े,1,1.8364528545823171e-06,1,2.2780963315814773e-06,0,0
13536,सपने,1,1.8364528545823171e-06,1,2.2780963315814773e-06,0,0
13525,देखने,1,1.8364528545823171e-06,1,2.2780963315814773e-06,0,0
13534,वालों,1,1.8364528545823171e-06,1,2.2780963315814773e-06,0,0
13528,बड़ा,1,1.8364528545823171e-06,1,2.2780963315814773e-06,0,0
13520,अपना,1,1.8364528545823171e-06,1,2.2780963315814773e-06,0,0
13531,भविष्य,1,1.8364528545823171e-06,1,2.2780963315814773e-06,0,0
13527,पहले,1,1.8364528545823171e-06,1,2.2780963315814773e-06,0,0
13538,से,1,1.8364528545823171e-06,1,2.2780963315814773e-06,0,0
13523,कहीं,1,1.8364528545823171e-06,1,2.2780963315814773e-06,0,0
13519,अधिक,1,1.8364528545823171e-06,1,2.2780963315814773e-06,0,0
13522,उज्जवल,1,1.8364528545823171e-06,1,2.2780963315814773e-06,0,0
13533,यह,1,1.8364528545823171e-06,1,2.2780963315814773e-06,0,0
13524,तो,1,1.8364528545823171e-06,1,2.2780963315814773e-06,0,0
13535,शुरुआत,1,1.8364528545823171e-06,1,2.2780963315814773e-06,0,0
13539,है।,1,1.8364528545823171e-06,1,2.2780963315814773e-06,0,0
13541,rode,1,1.8364528545823171e-06,1,2.2780963315814773e-06,0,0
13543,🇺🇸🇮🇳,1,1.8364528545823171e-06,1,2.2780963315814773e-06,0,0
13544,hillharrisx,1,1.8364528545823171e-06,1,2.2780963315814773e-06,0,0
13549,इसी,1,1.8364528545823171e-06,1,2.2780963315814773e-06,0,0
13548,आया,1,1.8364528545823171e-06,1,2.2780963315814773e-06,0,0
13557,हूँ,1,1.8364528545823171e-06,1,2.2780963315814773e-06,0,0
13554,सद्भावना,1,1.8364528545823171e-06,1,2.2780963315814773e-06,0,0
13556,साथ,1,1.8364528545823171e-06,1,2.2780963315814773e-06,0,0
13550,ताकि,1,1.8364528545823171e-06,1,2.2780963315814773e-06,0,0
13546,अभिलाषा,1,1.8364528545823171e-06,1,2.2780963315814773e-06,0,0
13551,प्रतीक,1,1.8364528545823171e-06,1,2.2780963315814773e-06,0,0
13555,सांझेदारी,1,1.8364528545823171e-06,1,2.2780963315814773e-06,0,0
13547,अविश्वसनीय,1,1.8364528545823171e-06,1,2.2780963315814773e-06,0,0
13552,विस्तार,1,1.8364528545823171e-06,1,2.2780963315814773e-06,0,0
13553,सकें,1,1.8364528545823171e-06,1,2.2780963315814773e-06,0,0
13558,@govandybeshear,1,1.8364528545823171e-06,1,2.2780963315814773e-06,0,0
13561,president😉with,1,1.8364528545823171e-06,1,2.2780963315814773e-06,0,0
13559,crash😧,1,1.8364528545823171e-06,1,2.2780963315814773e-06,0,0
13564,democrat-run,1,1.8364528545823171e-06,1,2.2780963315814773e-06,0,0
13565,shapeand,1,1.8364528545823171e-06,1,2.2780963315814773e-06,0,0
13566,meter,1,1.8364528545823171e-06,1,2.2780963315814773e-06,0,0
13567,51000000,1,1.8364528545823171e-06,1,2.2780963315814773e-06,0,0
13569,wired,1,1.8364528545823171e-06,1,2.2780963315814773e-06,0,0
13570,gaining,1,1.8364528545823171e-06,1,2.2780963315814773e-06,0,0
13571,pictureyet,1,1.8364528545823171e-06,1,2.2780963315814773e-06,0,0
13575,overal,1,1.8364528545823171e-06,1,2.2780963315814773e-06,0,0
13576,anonymity,1,1.8364528545823171e-06,1,2.2780963315814773e-06,0,0
13577,michele,1,1.8364528545823171e-06,1,2.2780963315814773e-06,0,0
13581,hollen,1,1.8364528545823171e-06,1,2.2780963315814773e-06,0,0
13590,furor,1,1.8364528545823171e-06,1,2.2780963315814773e-06,0,0
13592,perhsps,1,1.8364528545823171e-06,1,2.2780963315814773e-06,0,0
13594,@narendramodi🇺🇸🇮🇳,1,1.8364528545823171e-06,1,2.2780963315814773e-06,0,0
13595,inflation-this,1,1.8364528545823171e-06,1,2.2780963315814773e-06,0,0
13596,concepts,1,1.8364528545823171e-06,1,2.2780963315814773e-06,0,0
13598,miner,1,1.8364528545823171e-06,1,2.2780963315814773e-06,0,0
13603,spoof,1,1.8364528545823171e-06,1,2.2780963315814773e-06,0,0
13601,@johnwhuber,1,1.8364528545823171e-06,1,2.2780963315814773e-06,0,0
13626,תמיד,1,1.8364528545823171e-06,1,2.2780963315814773e-06,0,0
13609,אעמוד,1,1.8364528545823171e-06,1,2.2780963315814773e-06,0,0
13622,לצד,1,1.8364528545823171e-06,1,2.2780963315814773e-06,0,0
13624,מדינת,1,1.8364528545823171e-06,1,2.2780963315814773e-06,0,0
13620,ישראל,1,1.8364528545823171e-06,1,2.2780963315814773e-06,0,0
13619,והעם,1,1.8364528545823171e-06,1,2.2780963315814773e-06,0,0
13616,היהודי,1,1.8364528545823171e-06,1,2.2780963315814773e-06,0,0
13608,אני,1,1.8364528545823171e-06,1,2.2780963315814773e-06,0,0
13625,תומך,1,1.8364528545823171e-06,1,2.2780963315814773e-06,0,0
13611,בחוזקה,1,1.8364528545823171e-06,1,2.2780963315814773e-06,0,0
13610,בבטיחותם,1,1.8364528545823171e-06,1,2.2780963315814773e-06,0,0
13618,ובטחונם,1,1.8364528545823171e-06,1,2.2780963315814773e-06,0,0
13617,ובזכותם,1,1.8364528545823171e-06,1,2.2780963315814773e-06,0,0
13621,לחיות,1,1.8364528545823171e-06,1,2.2780963315814773e-06,0,0
13612,במולדתם,1,1.8364528545823171e-06,1,2.2780963315814773e-06,0,0
13614,ההיסטורית,1,1.8364528545823171e-06,1,2.2780963315814773e-06,0,0
13613,הגיע,1,1.8364528545823171e-06,1,2.2780963315814773e-06,0,0
13615,הזמן,1,1.8364528545823171e-06,1,2.2780963315814773e-06,0,0
13623,לשלום,1,1.8364528545823171e-06,1,2.2780963315814773e-06,0,0
13627,palestine,1,1.8364528545823171e-06,1,2.2780963315814773e-06,0,0
13631,exhaustion,1,1.8364528545823171e-06,1,2.2780963315814773e-06,0,0
13630,complains,1,1.8364528545823171e-06,1,2.2780963315814773e-06,0,0
13633,planbetter,1,1.8364528545823171e-06,1,2.2780963315814773e-06,0,0
13632,affirm,1,1.8364528545823171e-06,1,2.2780963315814773e-06,0,0
13645,هذا,1,1.8364528545823171e-06,1,2.2780963315814773e-06,0,0
13644,قد,1,1.8364528545823171e-06,1,2.2780963315814773e-06,0,0
13639,تبدو,1,1.8364528545823171e-06,1,2.2780963315814773e-06,0,0
13641,عليه,1,1.8364528545823171e-06,1,2.2780963315814773e-06,0,0
13640,دولة,1,1.8364528545823171e-06,1,2.2780963315814773e-06,0,0
13642,فلسطين,1,1.8364528545823171e-06,1,2.2780963315814773e-06,0,0
13637,المستقبلية,1,1.8364528545823171e-06,1,2.2780963315814773e-06,0,0
13638,بعاصمة,1,1.8364528545823171e-06,1,2.2780963315814773e-06,0,0
13643,في,1,1.8364528545823171e-06,1,2.2780963315814773e-06,0,0
13634,أجزاء,1,1.8364528545823171e-06,1,2.2780963315814773e-06,0,0
13636,القدس,1,1.8364528545823171e-06,1,2.2780963315814773e-06,0,0
13635,الشرقية,1,1.8364528545823171e-06,1,2.2780963315814773e-06,0,0
13648,majewski,1,1.8364528545823171e-06,1,2.2780963315814773e-06,0,0
13650,@jackngraham,1,1.8364528545823171e-06,1,2.2780963315814773e-06,0,0
13651,@prestonwood,1,1.8364528545823171e-06,1,2.2780963315814773e-06,0,0
13661,wrestling,1,1.8364528545823171e-06,1,2.2780963315814773e-06,0,0
13654,27-year-old,1,1.8364528545823171e-06,1,2.2780963315814773e-06,0,0
13658,navid,1,1.8364528545823171e-06,1,2.2780963315814773e-06,0,0
13655,afkarai,1,1.8364528545823171e-06,1,2.2780963315814773e-06,0,0
13656,anti-government,1,1.8364528545823171e-06,1,2.2780963315814773e-06,0,0
13657,demonstration,1,1.8364528545823171e-06,1,2.2780963315814773e-06,0,0
13660,worsening,1,1.8364528545823171e-06,1,2.2780963315814773e-06,0,0
13664,monumrnt,1,1.8364528545823171e-06,1,2.2780963315814773e-06,0,0
13665,kirstie,1,1.8364528545823171e-06,1,2.2780963315814773e-06,0,0
13667,palmer,1,1.8364528545823171e-06,1,2.2780963315814773e-06,0,0
13670,from-its,1,1.8364528545823171e-06,1,2.2780963315814773e-06,0,0
13679,library,1,1.8364528545823171e-06,1,2.2780963315814773e-06,0,0
13680,simi,1,1.8364528545823171e-06,1,2.2780963315814773e-06,0,0
13681,@giannocaldwell,1,1.8364528545823171e-06,1,2.2780963315814773e-06,0,0
13684,wildwood,1,1.8364528545823171e-06,1,2.2780963315814773e-06,0,0
13683,#keepamericagreat🇺🇸,1,1.8364528545823171e-06,1,2.2780963315814773e-06,0,0
13685,reconstitute,1,1.8364528545823171e-06,1,2.2780963315814773e-06,0,0
13687,#trumprallynj,1,1.8364528545823171e-06,1,2.2780963315814773e-06,0,0
13689,pounces,1,1.8364528545823171e-06,1,2.2780963315814773e-06,0,0
13691,inherit,1,1.8364528545823171e-06,1,2.2780963315814773e-06,0,0
13692,securethen,1,1.8364528545823171e-06,1,2.2780963315814773e-06,0,0
13695,ginsberg,1,1.8364528545823171e-06,1,2.2780963315814773e-06,0,0
13698,protectively,1,1.8364528545823171e-06,1,2.2780963315814773e-06,0,0
13699,wings,1,1.8364528545823171e-06,1,2.2780963315814773e-06,0,0
13700,hometown,1,1.8364528545823171e-06,1,2.2780963315814773e-06,0,0
13701,1205,1,1.8364528545823171e-06,1,2.2780963315814773e-06,0,0
13702,feenstra,1,1.8364528545823171e-06,1,2.2780963315814773e-06,0,0
13703,hopping,1,1.8364528545823171e-06,1,2.2780963315814773e-06,0,0
13706,disrespectfully,1,1.8364528545823171e-06,1,2.2780963315814773e-06,0,0
13708,sadder,1,1.8364528545823171e-06,1,2.2780963315814773e-06,0,0
13707,@lawrence,1,1.8364528545823171e-06,1,2.2780963315814773e-06,0,0
13710,whipped,1,1.8364528545823171e-06,1,2.2780963315814773e-06,0,0
13709,unmercifully,1,1.8364528545823171e-06,1,2.2780963315814773e-06,0,0
13711,help-we,1,1.8364528545823171e-06,1,2.2780963315814773e-06,0,0
13712,unneeded,1,1.8364528545823171e-06,1,2.2780963315814773e-06,0,0
13714,offshoots,1,1.8364528545823171e-06,1,2.2780963315814773e-06,0,0
13716,unasked,1,1.8364528545823171e-06,1,2.2780963315814773e-06,0,0
13718,overthrown,1,1.8364528545823171e-06,1,2.2780963315814773e-06,0,0
13720,juror,1,1.8364528545823171e-06,1,2.2780963315814773e-06,0,0
13721,contributors,1,1.8364528545823171e-06,1,2.2780963315814773e-06,0,0
13723,nicest,1,1.8364528545823171e-06,1,2.2780963315814773e-06,0,0
13722,kindest,1,1.8364528545823171e-06,1,2.2780963315814773e-06,0,0
13724,pac-,1,1.8364528545823171e-06,1,2.2780963315814773e-06,0,0
13726,newport,1,1.8364528545823171e-06,1,2.2780963315814773e-06,0,0
13730,casket,1,1.8364528545823171e-06,1,2.2780963315814773e-06,0,0
13732,@randyfeenstra,1,1.8364528545823171e-06,1,2.2780963315814773e-06,0,0
13731,#ia04,1,1.8364528545823171e-06,1,2.2780963315814773e-06,0,0
13734,@repbarrymoore,1,1.8364528545823171e-06,1,2.2780963315814773e-06,0,0
13733,#al02,1,1.8364528545823171e-06,1,2.2780963315814773e-06,0,0
13738,carl,1,1.8364528545823171e-06,1,2.2780963315814773e-06,0,0
13737,@carlforalabama,1,1.8364528545823171e-06,1,2.2780963315814773e-06,0,0
13736,#al01,1,1.8364528545823171e-06,1,2.2780963315814773e-06,0,0
13739,lincolnand,1,1.8364528545823171e-06,1,2.2780963315814773e-06,0,0
13740,pinned,1,1.8364528545823171e-06,1,2.2780963315814773e-06,0,0
13741,800pme,1,1.8364528545823171e-06,1,2.2780963315814773e-06,0,0
13744,arresting,1,1.8364528545823171e-06,1,2.2780963315814773e-06,0,0
13745,blooded,1,1.8364528545823171e-06,1,2.2780963315814773e-06,0,0
13743,aaron,1,1.8364528545823171e-06,1,2.2780963315814773e-06,0,0
13746,danielson,1,1.8364528545823171e-06,1,2.2780963315814773e-06,0,0
13747,thug,1,1.8364528545823171e-06,1,2.2780963315814773e-06,0,0
13748,planmore,1,1.8364528545823171e-06,1,2.2780963315814773e-06,0,0
13749,@andrzejduda,1,1.8364528545823171e-06,1,2.2780963315814773e-06,0,0
13750,telecommunications,1,1.8364528545823171e-06,1,2.2780963315814773e-06,0,0
13759,balkans,1,1.8364528545823171e-06,1,2.2780963315814773e-06,0,0
13758,assisted,1,1.8364528545823171e-06,1,2.2780963315814773e-06,0,0
13761,@avdullah,1,1.8364528545823171e-06,1,2.2780963315814773e-06,0,0
13763,hoti,1,1.8364528545823171e-06,1,2.2780963315814773e-06,0,0
13760,#economicnormalization,1,1.8364528545823171e-06,1,2.2780963315814773e-06,0,0
13766,recommendeda,1,1.8364528545823171e-06,1,2.2780963315814773e-06,0,0
13770,serbias,1,1.8364528545823171e-06,1,2.2780963315814773e-06,0,0
13772,covid19,1,1.8364528545823171e-06,1,2.2780963315814773e-06,0,0
13773,muslim-majority,1,1.8364528545823171e-06,1,2.2780963315814773e-06,0,0
13774,normalize,1,1.8364528545823171e-06,1,2.2780963315814773e-06,0,0
13775,well-done,1,1.8364528545823171e-06,1,2.2780963315814773e-06,0,0
13776,antigovernment,1,1.8364528545823171e-06,1,2.2780963315814773e-06,0,0
13779,medically,1,1.8364528545823171e-06,1,2.2780963315814773e-06,0,0
13784,@starsandstripes,1,1.8364528545823171e-06,1,2.2780963315814773e-06,0,0
13785,@repdancrenshaw,1,1.8364528545823171e-06,1,2.2780963315814773e-06,0,0
13788,grilling,1,1.8364528545823171e-06,1,2.2780963315814773e-06,0,0
13792,morse,1,1.8364528545823171e-06,1,2.2780963315814773e-06,0,0
13793,chrisie,1,1.8364528545823171e-06,1,2.2780963315814773e-06,0,0
13794,biden-linked,1,1.8364528545823171e-06,1,2.2780963315814773e-06,0,0
13796,184,1,1.8364528545823171e-06,1,2.2780963315814773e-06,0,0
13797,@govtimwalz,1,1.8364528545823171e-06,1,2.2780963315814773e-06,0,0
13798,aspirations,1,1.8364528545823171e-06,1,2.2780963315814773e-06,0,0
13800,salacious,1,1.8364528545823171e-06,1,2.2780963315814773e-06,0,0
13802,220000,1,1.8364528545823171e-06,1,2.2780963315814773e-06,0,0
13803,gofundme,1,1.8364528545823171e-06,1,2.2780963315814773e-06,0,0
13810,synergy,1,1.8364528545823171e-06,1,2.2780963315814773e-06,0,0
13807,atlantics,1,1.8364528545823171e-06,1,2.2780963315814773e-06,0,0
13811,unofficial,1,1.8364528545823171e-06,1,2.2780963315814773e-06,0,0
13809,stenographer,1,1.8364528545823171e-06,1,2.2780963315814773e-06,0,0
13815,prioritizing,1,1.8364528545823171e-06,1,2.2780963315814773e-06,0,0
13819,ioc,1,1.8364528545823171e-06,1,2.2780963315814773e-06,0,0
13821,floridaearly,1,1.8364528545823171e-06,1,2.2780963315814773e-06,0,0
13822,isolated,1,1.8364528545823171e-06,1,2.2780963315814773e-06,0,0
13823,blasted,1,1.8364528545823171e-06,1,2.2780963315814773e-06,0,0
13824,caronavirus,1,1.8364528545823171e-06,1,2.2780963315814773e-06,0,0
13827,96-0,1,1.8364528545823171e-06,1,2.2780963315814773e-06,0,0
13828,#latinosfortrump,1,1.8364528545823171e-06,1,2.2780963315814773e-06,0,0
13830,undisciplined,1,1.8364528545823171e-06,1,2.2780963315814773e-06,0,0
13831,unsteady,1,1.8364528545823171e-06,1,2.2780963315814773e-06,0,0
13832,w50,1,1.8364528545823171e-06,1,2.2780963315814773e-06,0,0
13836,@realcandaceo,1,1.8364528545823171e-06,1,2.2780963315814773e-06,0,0
13837,@michaelcburgess,1,1.8364528545823171e-06,1,2.2780963315814773e-06,0,0
13838,@babin4congress,1,1.8364528545823171e-06,1,2.2780963315814773e-06,0,0
13839,eyewitness,1,1.8364528545823171e-06,1,2.2780963315814773e-06,0,0
13844,congress@repmikejohnson,1,1.8364528545823171e-06,1,2.2780963315814773e-06,0,0
13842,40big,1,1.8364528545823171e-06,1,2.2780963315814773e-06,0,0
13845,piers,1,1.8364528545823171e-06,1,2.2780963315814773e-06,0,0
13846,seige,1,1.8364528545823171e-06,1,2.2780963315814773e-06,0,0
13851,sightings,1,1.8364528545823171e-06,1,2.2780963315814773e-06,0,0
13854,ravaging,1,1.8364528545823171e-06,1,2.2780963315814773e-06,0,0
13855,thud,1,1.8364528545823171e-06,1,2.2780963315814773e-06,0,0
13857,massie,1,1.8364528545823171e-06,1,2.2780963315814773e-06,0,0
13860,roofmonday,1,1.8364528545823171e-06,1,2.2780963315814773e-06,0,0
13861,biden-sanders,1,1.8364528545823171e-06,1,2.2780963315814773e-06,0,0
13863,sledgehammer,1,1.8364528545823171e-06,1,2.2780963315814773e-06,0,0
13862,codes,1,1.8364528545823171e-06,1,2.2780963315814773e-06,0,0
13865,formulate,1,1.8364528545823171e-06,1,2.2780963315814773e-06,0,0
13866,40000,1,1.8364528545823171e-06,1,2.2780963315814773e-06,0,0
13868,#stopexecutionsiniran,1,1.8364528545823171e-06,1,2.2780963315814773e-06,0,0
13871,@generalmotors,1,1.8364528545823171e-06,1,2.2780963315814773e-06,0,0
13879,برای,1,1.8364528545823171e-06,1,2.2780963315814773e-06,0,0
13883,شرکت,1,1.8364528545823171e-06,1,2.2780963315814773e-06,0,0
13892,کردن,1,1.8364528545823171e-06,1,2.2780963315814773e-06,0,0
13880,تظاهرات,1,1.8364528545823171e-06,1,2.2780963315814773e-06,0,0
13887,محکوم,1,1.8364528545823171e-06,1,2.2780963315814773e-06,0,0
13888,مرگ,1,1.8364528545823171e-06,1,2.2780963315814773e-06,0,0
13878,اند,1,1.8364528545823171e-06,1,2.2780963315814773e-06,0,0
13890,هر,1,1.8364528545823171e-06,1,2.2780963315814773e-06,0,0
13886,لحظه,1,1.8364528545823171e-06,1,2.2780963315814773e-06,0,0
13885,قابل,1,1.8364528545823171e-06,1,2.2780963315814773e-06,0,0
13876,انتظار,1,1.8364528545823171e-06,1,2.2780963315814773e-06,0,0
13891,پیامی,1,1.8364528545823171e-06,1,2.2780963315814773e-06,0,0
13874,اسفناک,1,1.8364528545823171e-06,1,2.2780963315814773e-06,0,0
13881,دنیا,1,1.8364528545823171e-06,1,2.2780963315814773e-06,0,0
13884,فرستد,1,1.8364528545823171e-06,1,2.2780963315814773e-06,0,0
13877,انجام,1,1.8364528545823171e-06,1,2.2780963315814773e-06,0,0
13873,#اعدامنکنید,1,1.8364528545823171e-06,1,2.2780963315814773e-06,0,0
13894,statelocal,1,1.8364528545823171e-06,1,2.2780963315814773e-06,0,0
13896,texas-08,1,1.8364528545823171e-06,1,2.2780963315814773e-06,0,0
13897,enhancement,1,1.8364528545823171e-06,1,2.2780963315814773e-06,0,0
13900,storage,1,1.8364528545823171e-06,1,2.2780963315814773e-06,0,0
13901,humor,1,1.8364528545823171e-06,1,2.2780963315814773e-06,0,0
13902,stoke,1,1.8364528545823171e-06,1,2.2780963315814773e-06,0,0
13905,stepien,1,1.8364528545823171e-06,1,2.2780963315814773e-06,0,0
13904,parscale,1,1.8364528545823171e-06,1,2.2780963315814773e-06,0,0
13906,strategies,1,1.8364528545823171e-06,1,2.2780963315814773e-06,0,0
13908,semonite,1,1.8364528545823171e-06,1,2.2780963315814773e-06,0,0
13907,builder,1,1.8364528545823171e-06,1,2.2780963315814773e-06,0,0
13909,endowment,1,1.8364528545823171e-06,1,2.2780963315814773e-06,0,0
13912,@napopolice,1,1.8364528545823171e-06,1,2.2780963315814773e-06,0,0
13911,241000,1,1.8364528545823171e-06,1,2.2780963315814773e-06,0,0
13913,diagnosis,1,1.8364528545823171e-06,1,2.2780963315814773e-06,0,0
13914,irresponsibly,1,1.8364528545823171e-06,1,2.2780963315814773e-06,0,0
13915,politicizing,1,1.8364528545823171e-06,1,2.2780963315814773e-06,0,0
13916,unifying,1,1.8364528545823171e-06,1,2.2780963315814773e-06,0,0
13918,urgently-needed,1,1.8364528545823171e-06,1,2.2780963315814773e-06,0,0
13917,#caresact🇺🇸,1,1.8364528545823171e-06,1,2.2780963315814773e-06,0,0
13919,polices,1,1.8364528545823171e-06,1,2.2780963315814773e-06,0,0
13922,marshalling,1,1.8364528545823171e-06,1,2.2780963315814773e-06,0,0
13924,marshals,1,1.8364528545823171e-06,1,2.2780963315814773e-06,0,0
13928,enriched,1,1.8364528545823171e-06,1,2.2780963315814773e-06,0,0
13929,3rdvote,1,1.8364528545823171e-06,1,2.2780963315814773e-06,0,0
13933,prohibiting,1,1.8364528545823171e-06,1,2.2780963315814773e-06,0,0
13931,aided,1,1.8364528545823171e-06,1,2.2780963315814773e-06,0,0
13934,#nc11,1,1.8364528545823171e-06,1,2.2780963315814773e-06,0,0
13936,683,1,1.8364528545823171e-06,1,2.2780963315814773e-06,0,0
13938,#rnc2020,1,1.8364528545823171e-06,1,2.2780963315814773e-06,0,0
13939,rcp,1,1.8364528545823171e-06,1,2.2780963315814773e-06,0,0
13942,gunboats,1,1.8364528545823171e-06,1,2.2780963315814773e-06,0,0
13945,dragged,1,1.8364528545823171e-06,1,2.2780963315814773e-06,0,0
13944,#lawandorder,1,1.8364528545823171e-06,1,2.2780963315814773e-06,0,0
13949,@rjharris15,1,1.8364528545823171e-06,1,2.2780963315814773e-06,0,0
13950,whp580,1,1.8364528545823171e-06,1,2.2780963315814773e-06,0,0
13952,detainees,1,1.8364528545823171e-06,1,2.2780963315814773e-06,0,0
13953,zurich,1,1.8364528545823171e-06,1,2.2780963315814773e-06,0,0
13955,eastport,1,1.8364528545823171e-06,1,2.2780963315814773e-06,0,0
13956,jonesport,1,1.8364528545823171e-06,1,2.2780963315814773e-06,0,0
13957,stonington,1,1.8364528545823171e-06,1,2.2780963315814773e-06,0,0
13954,casco,1,1.8364528545823171e-06,1,2.2780963315814773e-06,0,0
13958,lobsters,1,1.8364528545823171e-06,1,2.2780963315814773e-06,0,0
13959,tariff-free,1,1.8364528545823171e-06,1,2.2780963315814773e-06,0,0
13960,ustr,1,1.8364528545823171e-06,1,2.2780963315814773e-06,0,0
13961,@oregongovbrown,1,1.8364528545823171e-06,1,2.2780963315814773e-06,0,0
13962,@tedwheeler,1,1.8364528545823171e-06,1,2.2780963315814773e-06,0,0
13963,@senatecloakroom,1,1.8364528545823171e-06,1,2.2780963315814773e-06,0,0
13964,@voanews,1,1.8364528545823171e-06,1,2.2780963315814773e-06,0,0
13965,low-flying,1,1.8364528545823171e-06,1,2.2780963315814773e-06,0,0
13967,trees,1,1.8364528545823171e-06,1,2.2780963315814773e-06,0,0
13968,disavowed,1,1.8364528545823171e-06,1,2.2780963315814773e-06,0,0
13969,frisk,1,1.8364528545823171e-06,1,2.2780963315814773e-06,0,0
13970,overused,1,1.8364528545823171e-06,1,2.2780963315814773e-06,0,0
13973,inner-circle,1,1.8364528545823171e-06,1,2.2780963315814773e-06,0,0
13976,slinked,1,1.8364528545823171e-06,1,2.2780963315814773e-06,0,0
13975,obscurity,1,1.8364528545823171e-06,1,2.2780963315814773e-06,0,0
13974,limelight,1,1.8364528545823171e-06,1,2.2780963315814773e-06,0,0
13978,entrusting,1,1.8364528545823171e-06,1,2.2780963315814773e-06,0,0
13977,@nrapvf,1,1.8364528545823171e-06,1,2.2780963315814773e-06,0,0
13979,prized,1,1.8364528545823171e-06,1,2.2780963315814773e-06,0,0
13980,@hudgov,1,1.8364528545823171e-06,1,2.2780963315814773e-06,0,0
13981,pantry,1,1.8364528545823171e-06,1,2.2780963315814773e-06,0,0
13982,tabulate,1,1.8364528545823171e-06,1,2.2780963315814773e-06,0,0
13984,heartache,1,1.8364528545823171e-06,1,2.2780963315814773e-06,0,0
13985,givng,1,1.8364528545823171e-06,1,2.2780963315814773e-06,0,0
13987,anwr,1,1.8364528545823171e-06,1,2.2780963315814773e-06,0,0
13992,355000,1,1.8364528545823171e-06,1,2.2780963315814773e-06,0,0
13996,unfixable,1,1.8364528545823171e-06,1,2.2780963315814773e-06,0,0
13997,@johnjharwood,1,1.8364528545823171e-06,1,2.2780963315814773e-06,0,0
13999,@johnsonleads,1,1.8364528545823171e-06,1,2.2780963315814773e-06,0,0
14000,@votedavidson,1,1.8364528545823171e-06,1,2.2780963315814773e-06,0,0
14002,#cpac2020,1,1.8364528545823171e-06,1,2.2780963315814773e-06,0,0
14004,shipbuilding,1,1.8364528545823171e-06,1,2.2780963315814773e-06,0,0
14003,designs,1,1.8364528545823171e-06,1,2.2780963315814773e-06,0,0
14006,curtis,1,1.8364528545823171e-06,1,2.2780963315814773e-06,0,0
14005,@curtisut,1,1.8364528545823171e-06,1,2.2780963315814773e-06,0,0
14007,@stewartforutah,1,1.8364528545823171e-06,1,2.2780963315814773e-06,0,0
14011,lunacy,1,1.8364528545823171e-06,1,2.2780963315814773e-06,0,0
14013,reyes,1,1.8364528545823171e-06,1,2.2780963315814773e-06,0,0
14012,@seanreyesut,1,1.8364528545823171e-06,1,2.2780963315814773e-06,0,0
14014,setter,1,1.8364528545823171e-06,1,2.2780963315814773e-06,0,0
14015,@bradwenstrup,1,1.8364528545823171e-06,1,2.2780963315814773e-06,0,0
14016,proclaiming,1,1.8364528545823171e-06,1,2.2780963315814773e-06,0,0
14017,bloombeg,1,1.8364528545823171e-06,1,2.2780963315814773e-06,0,0
14019,spit,1,1.8364528545823171e-06,1,2.2780963315814773e-06,0,0
14021,@miketurneroh,1,1.8364528545823171e-06,1,2.2780963315814773e-06,0,0
14022,advisorshow,1,1.8364528545823171e-06,1,2.2780963315814773e-06,0,0
14023,gravy,1,1.8364528545823171e-06,1,2.2780963315814773e-06,0,0
14024,posey,1,1.8364528545823171e-06,1,2.2780963315814773e-06,0,0
14025,imperils,1,1.8364528545823171e-06,1,2.2780963315814773e-06,0,0
14026,@stevestivers,1,1.8364528545823171e-06,1,2.2780963315814773e-06,0,0
14027,betty,1,1.8364528545823171e-06,1,2.2780963315814773e-06,0,0
14028,rivas,1,1.8364528545823171e-06,1,2.2780963315814773e-06,0,0
14030,zika,1,1.8364528545823171e-06,1,2.2780963315814773e-06,0,0
14032,fisagate,1,1.8364528545823171e-06,1,2.2780963315814773e-06,0,0
14033,russiagate,1,1.8364528545823171e-06,1,2.2780963315814773e-06,0,0
14031,dnithe,1,1.8364528545823171e-06,1,2.2780963315814773e-06,0,0
14036,supertuesday,1,1.8364528545823171e-06,1,2.2780963315814773e-06,0,0
14038,exponentially,1,1.8364528545823171e-06,1,2.2780963315814773e-06,0,0
14039,enjoy@foxnews,1,1.8364528545823171e-06,1,2.2780963315814773e-06,0,0
14040,heroine,1,1.8364528545823171e-06,1,2.2780963315814773e-06,0,0
14041,pent,1,1.8364528545823171e-06,1,2.2780963315814773e-06,0,0
14042,eection,1,1.8364528545823171e-06,1,2.2780963315814773e-06,0,0
14043,charlies,1,1.8364528545823171e-06,1,2.2780963315814773e-06,0,0
14044,futurethis,1,1.8364528545823171e-06,1,2.2780963315814773e-06,0,0
14049,rudeness,1,1.8364528545823171e-06,1,2.2780963315814773e-06,0,0
14048,kristen,1,1.8364528545823171e-06,1,2.2780963315814773e-06,0,0
14050,welker,1,1.8364528545823171e-06,1,2.2780963315814773e-06,0,0
14051,arson,1,1.8364528545823171e-06,1,2.2780963315814773e-06,0,0
14055,nayib,1,1.8364528545823171e-06,1,2.2780963315814773e-06,0,0
14061,spas,1,1.8364528545823171e-06,1,2.2780963315814773e-06,0,0
14058,salons,1,1.8364528545823171e-06,1,2.2780963315814773e-06,0,0
14062,tattoo,1,1.8364528545823171e-06,1,2.2780963315814773e-06,0,0
14057,parlors,1,1.8364528545823171e-06,1,2.2780963315814773e-06,0,0
14059,shops,1,1.8364528545823171e-06,1,2.2780963315814773e-06,0,0
14067,stephenson,1,1.8364528545823171e-06,1,2.2780963315814773e-06,0,0
14065,indebted,1,1.8364528545823171e-06,1,2.2780963315814773e-06,0,0
14069,unimaginably,1,1.8364528545823171e-06,1,2.2780963315814773e-06,0,0
14070,underperforming,1,1.8364528545823171e-06,1,2.2780963315814773e-06,0,0
14071,hernandez,1,1.8364528545823171e-06,1,2.2780963315814773e-06,0,0
14073,ecuador,1,1.8364528545823171e-06,1,2.2780963315814773e-06,0,0
14075,surprising,1,1.8364528545823171e-06,1,2.2780963315814773e-06,0,0
14080,mismanaged,1,1.8364528545823171e-06,1,2.2780963315814773e-06,0,0
14079,advent,1,1.8364528545823171e-06,1,2.2780963315814773e-06,0,0
14086,capping,1,1.8364528545823171e-06,1,2.2780963315814773e-06,0,0
14085,@pga,1,1.8364528545823171e-06,1,2.2780963315814773e-06,0,0
14089,fedexcup,1,1.8364528545823171e-06,1,2.2780963315814773e-06,0,0
14092,welch,1,1.8364528545823171e-06,1,2.2780963315814773e-06,0,0
14090,ge,1,1.8364528545823171e-06,1,2.2780963315814773e-06,0,0
14091,neutron,1,1.8364528545823171e-06,1,2.2780963315814773e-06,0,0
14094,pendley,1,1.8364528545823171e-06,1,2.2780963315814773e-06,0,0
14095,#riggedelection,1,1.8364528545823171e-06,1,2.2780963315814773e-06,0,0
14096,@tripleh,1,1.8364528545823171e-06,1,2.2780963315814773e-06,0,0
14099,partake,1,1.8364528545823171e-06,1,2.2780963315814773e-06,0,0
14103,weli,1,1.8364528545823171e-06,1,2.2780963315814773e-06,0,0
14104,enablers,1,1.8364528545823171e-06,1,2.2780963315814773e-06,0,0
14106,amazingtremendous,1,1.8364528545823171e-06,1,2.2780963315814773e-06,0,0
14107,abiy,1,1.8364528545823171e-06,1,2.2780963315814773e-06,0,0
14108,ahmed,1,1.8364528545823171e-06,1,2.2780963315814773e-06,0,0
14112,stupendous,1,1.8364528545823171e-06,1,2.2780963315814773e-06,0,0
14114,stunner,1,1.8364528545823171e-06,1,2.2780963315814773e-06,0,0
14115,blazer,1,1.8364528545823171e-06,1,2.2780963315814773e-06,0,0
14117,medgar,1,1.8364528545823171e-06,1,2.2780963315814773e-06,0,0
14118,fischbach,1,1.8364528545823171e-06,1,2.2780963315814773e-06,0,0
14122,laboratory,1,1.8364528545823171e-06,1,2.2780963315814773e-06,0,0
14123,sunlight,1,1.8364528545823171e-06,1,2.2780963315814773e-06,0,0
14127,1015,1,1.8364528545823171e-06,1,2.2780963315814773e-06,0,0
14131,@billcassidy,1,1.8364528545823171e-06,1,2.2780963315814773e-06,0,0
14132,timid,1,1.8364528545823171e-06,1,2.2780963315814773e-06,0,0
14133,@stpatrickscath,1,1.8364528545823171e-06,1,2.2780963315814773e-06,0,0
14134,offender,1,1.8364528545823171e-06,1,2.2780963315814773e-06,0,0
14140,hamberger,1,1.8364528545823171e-06,1,2.2780963315814773e-06,0,0
14141,hamburger,1,1.8364528545823171e-06,1,2.2780963315814773e-06,0,0
14142,rectify,1,1.8364528545823171e-06,1,2.2780963315814773e-06,0,0
14144,nobles,1,1.8364528545823171e-06,1,2.2780963315814773e-06,0,0
14145,nastier,1,1.8364528545823171e-06,1,2.2780963315814773e-06,0,0
14146,plugging,1,1.8364528545823171e-06,1,2.2780963315814773e-06,0,0
14150,quarterbacks,1,1.8364528545823171e-06,1,2.2780963315814773e-06,0,0
14149,flown,1,1.8364528545823171e-06,1,2.2780963315814773e-06,0,0
14151,counterpart,1,1.8364528545823171e-06,1,2.2780963315814773e-06,0,0
14156,@alexazar,1,1.8364528545823171e-06,1,2.2780963315814773e-06,0,0
14157,perception,1,1.8364528545823171e-06,1,2.2780963315814773e-06,0,0
14160,sarcasm,1,1.8364528545823171e-06,1,2.2780963315814773e-06,0,0
14161,thuggery,1,1.8364528545823171e-06,1,2.2780963315814773e-06,0,0
14163,diners,1,1.8364528545823171e-06,1,2.2780963315814773e-06,0,0
14164,scaring,1,1.8364528545823171e-06,1,2.2780963315814773e-06,0,0
14165,taunts,1,1.8364528545823171e-06,1,2.2780963315814773e-06,0,0
14167,betrayals,1,1.8364528545823171e-06,1,2.2780963315814773e-06,0,0
14168,balls,1,1.8364528545823171e-06,1,2.2780963315814773e-06,0,0
14169,comply,1,1.8364528545823171e-06,1,2.2780963315814773e-06,0,0
14172,jar,1,1.8364528545823171e-06,1,2.2780963315814773e-06,0,0
14179,squirm,1,1.8364528545823171e-06,1,2.2780963315814773e-06,0,0
14180,housewives,1,1.8364528545823171e-06,1,2.2780963315814773e-06,0,0
14182,lateness,1,1.8364528545823171e-06,1,2.2780963315814773e-06,0,0
14185,dominate,1,1.8364528545823171e-06,1,2.2780963315814773e-06,0,0
14186,@tesla,1,1.8364528545823171e-06,1,2.2780963315814773e-06,0,0
14188,distanced,1,1.8364528545823171e-06,1,2.2780963315814773e-06,0,0
14190,28149,1,1.8364528545823171e-06,1,2.2780963315814773e-06,0,0
14192,mdevine@nypostcom,1,1.8364528545823171e-06,1,2.2780963315814773e-06,0,0
14201,idled,1,1.8364528545823171e-06,1,2.2780963315814773e-06,0,0
14202,@pastordscott,1,1.8364528545823171e-06,1,2.2780963315814773e-06,0,0
14203,inspirational,1,1.8364528545823171e-06,1,2.2780963315814773e-06,0,0
14205,unstoppable,1,1.8364528545823171e-06,1,2.2780963315814773e-06,0,0
14207,gripe,1,1.8364528545823171e-06,1,2.2780963315814773e-06,0,0
14208,compensate,1,1.8364528545823171e-06,1,2.2780963315814773e-06,0,0
14209,phases,1,1.8364528545823171e-06,1,2.2780963315814773e-06,0,0
14213,marshalls,1,1.8364528545823171e-06,1,2.2780963315814773e-06,0,0
14217,pennies,1,1.8364528545823171e-06,1,2.2780963315814773e-06,0,0
14215,epi-pens,1,1.8364528545823171e-06,1,2.2780963315814773e-06,0,0
14216,jacked,1,1.8364528545823171e-06,1,2.2780963315814773e-06,0,0
14214,bargains,1,1.8364528545823171e-06,1,2.2780963315814773e-06,0,0
14218,insulin,1,1.8364528545823171e-06,1,2.2780963315814773e-06,0,0
14219,#americastrong,1,1.8364528545823171e-06,1,2.2780963315814773e-06,0,0
14220,looney,1,1.8364528545823171e-06,1,2.2780963315814773e-06,0,0
14224,communites,1,1.8364528545823171e-06,1,2.2780963315814773e-06,0,0
14229,@brandonstraka,1,1.8364528545823171e-06,1,2.2780963315814773e-06,0,0
14230,paymentsthey,1,1.8364528545823171e-06,1,2.2780963315814773e-06,0,0
14234,philbin,1,1.8364528545823171e-06,1,2.2780963315814773e-06,0,0
14239,hanna,1,1.8364528545823171e-06,1,2.2780963315814773e-06,0,0
14237,@hawaiiema,1,1.8364528545823171e-06,1,2.2780963315814773e-06,0,0
14238,@tdem,1,1.8364528545823171e-06,1,2.2780963315814773e-06,0,0
14242,#sc02,1,1.8364528545823171e-06,1,2.2780963315814773e-06,0,0
14246,redactions,1,1.8364528545823171e-06,1,2.2780963315814773e-06,0,0
14250,@austinscott4ga,1,1.8364528545823171e-06,1,2.2780963315814773e-06,0,0
14249,#ga08,1,1.8364528545823171e-06,1,2.2780963315814773e-06,0,0
14251,#ga01,1,1.8364528545823171e-06,1,2.2780963315814773e-06,0,0
14253,#wv03,1,1.8364528545823171e-06,1,2.2780963315814773e-06,0,0
14257,mooney,1,1.8364528545823171e-06,1,2.2780963315814773e-06,0,0
14256,@mooneyforwv,1,1.8364528545823171e-06,1,2.2780963315814773e-06,0,0
14255,#wv02,1,1.8364528545823171e-06,1,2.2780963315814773e-06,0,0
14258,danced,1,1.8364528545823171e-06,1,2.2780963315814773e-06,0,0
14259,sf,1,1.8364528545823171e-06,1,2.2780963315814773e-06,0,0
14262,amodei,1,1.8364528545823171e-06,1,2.2780963315814773e-06,0,0
14261,@amodeifornevada,1,1.8364528545823171e-06,1,2.2780963315814773e-06,0,0
14260,#nv02,1,1.8364528545823171e-06,1,2.2780963315814773e-06,0,0
14266,burgum,1,1.8364528545823171e-06,1,2.2780963315814773e-06,0,0
14265,@dougfordakota,1,1.8364528545823171e-06,1,2.2780963315814773e-06,0,0
14268,kathryn,1,1.8364528545823171e-06,1,2.2780963315814773e-06,0,0
14267,burgums,1,1.8364528545823171e-06,1,2.2780963315814773e-06,0,0
14264,#ndgov,1,1.8364528545823171e-06,1,2.2780963315814773e-06,0,0
14270,winston-salem,1,1.8364528545823171e-06,1,2.2780963315814773e-06,0,0
14272,penned,1,1.8364528545823171e-06,1,2.2780963315814773e-06,0,0
14276,remotely,1,1.8364528545823171e-06,1,2.2780963315814773e-06,0,0
14273,goodells,1,1.8364528545823171e-06,1,2.2780963315814773e-06,0,0
14277,sincerity,1,1.8364528545823171e-06,1,2.2780963315814773e-06,0,0
14278,310000,1,1.8364528545823171e-06,1,2.2780963315814773e-06,0,0
14286,israel-uae,1,1.8364528545823171e-06,1,2.2780963315814773e-06,0,0
14287,dampen,1,1.8364528545823171e-06,1,2.2780963315814773e-06,0,0
14289,blathering,1,1.8364528545823171e-06,1,2.2780963315814773e-06,0,0
14296,priests,1,1.8364528545823171e-06,1,2.2780963315814773e-06,0,0
14300,ricans,1,1.8364528545823171e-06,1,2.2780963315814773e-06,0,0
14299,clementes,1,1.8364528545823171e-06,1,2.2780963315814773e-06,0,0
14297,#clementeday,1,1.8364528545823171e-06,1,2.2780963315814773e-06,0,0
14298,#retire21,1,1.8364528545823171e-06,1,2.2780963315814773e-06,0,0
14302,buffalo,1,1.8364528545823171e-06,1,2.2780963315814773e-06,0,0
14304,protester,1,1.8364528545823171e-06,1,2.2780963315814773e-06,0,0
14308,shoved,1,1.8364528545823171e-06,1,2.2780963315814773e-06,0,0
14305,provocateur,1,1.8364528545823171e-06,1,2.2780963315814773e-06,0,0
14303,gugino,1,1.8364528545823171e-06,1,2.2780963315814773e-06,0,0
14306,scan,1,1.8364528545823171e-06,1,2.2780963315814773e-06,0,0
14307,scanner,1,1.8364528545823171e-06,1,2.2780963315814773e-06,0,0
14309,experiment,1,1.8364528545823171e-06,1,2.2780963315814773e-06,0,0
14310,fictional,1,1.8364528545823171e-06,1,2.2780963315814773e-06,0,0
14312,touting,1,1.8364528545823171e-06,1,2.2780963315814773e-06,0,0
14313,withholds,1,1.8364528545823171e-06,1,2.2780963315814773e-06,0,0
14314,crummy,1,1.8364528545823171e-06,1,2.2780963315814773e-06,0,0
14317,securely,1,1.8364528545823171e-06,1,2.2780963315814773e-06,0,0
14318,reawakening,1,1.8364528545823171e-06,1,2.2780963315814773e-06,0,0
14319,@lacyjohnsonmn,1,1.8364528545823171e-06,1,2.2780963315814773e-06,0,0
14321,patio,1,1.8364528545823171e-06,1,2.2780963315814773e-06,0,0
14320,caligiuri,1,1.8364528545823171e-06,1,2.2780963315814773e-06,0,0
14323,gloria,1,1.8364528545823171e-06,1,2.2780963315814773e-06,0,0
14326,vincent,1,1.8364528545823171e-06,1,2.2780963315814773e-06,0,0
14327,adored,1,1.8364528545823171e-06,1,2.2780963315814773e-06,0,0
14328,@kristinbtate,1,1.8364528545823171e-06,1,2.2780963315814773e-06,0,0
14331,mail-in-voting,1,1.8364528545823171e-06,1,2.2780963315814773e-06,0,0
14332,grim,1,1.8364528545823171e-06,1,2.2780963315814773e-06,0,0
14336,256,1,1.8364528545823171e-06,1,2.2780963315814773e-06,0,0
14338,plasma,1,1.8364528545823171e-06,1,2.2780963315814773e-06,0,0
14339,🌐,1,1.8364528545823171e-06,1,2.2780963315814773e-06,0,0
14340,systematically,1,1.8364528545823171e-06,1,2.2780963315814773e-06,0,0
14341,singletary,1,1.8364528545823171e-06,1,2.2780963315814773e-06,0,0
14343,clyburn,1,1.8364528545823171e-06,1,2.2780963315814773e-06,0,0
14344,capability,1,1.8364528545823171e-06,1,2.2780963315814773e-06,0,0
14347,re-enacted,1,1.8364528545823171e-06,1,2.2780963315814773e-06,0,0
14348,cought,1,1.8364528545823171e-06,1,2.2780963315814773e-06,0,0
14350,undecided,1,1.8364528545823171e-06,1,2.2780963315814773e-06,0,0
14353,stroll,1,1.8364528545823171e-06,1,2.2780963315814773e-06,0,0
14354,mgmt,1,1.8364528545823171e-06,1,2.2780963315814773e-06,0,0
14356,twin,1,1.8364528545823171e-06,1,2.2780963315814773e-06,0,0
14355,cheater,1,1.8364528545823171e-06,1,2.2780963315814773e-06,0,0
14358,temporary,1,1.8364528545823171e-06,1,2.2780963315814773e-06,0,0
14360,failings,1,1.8364528545823171e-06,1,2.2780963315814773e-06,0,0
14361,60000000,1,1.8364528545823171e-06,1,2.2780963315814773e-06,0,0
14362,gaffe,1,1.8364528545823171e-06,1,2.2780963315814773e-06,0,0
14366,disparity,1,1.8364528545823171e-06,1,2.2780963315814773e-06,0,0
14370,defender,1,1.8364528545823171e-06,1,2.2780963315814773e-06,0,0
14373,@laurenboebert,1,1.8364528545823171e-06,1,2.2780963315814773e-06,0,0
14375,@millercongress,1,1.8364528545823171e-06,1,2.2780963315814773e-06,0,0
14374,#il15,1,1.8364528545823171e-06,1,2.2780963315814773e-06,0,0
14377,@richhudson,1,1.8364528545823171e-06,1,2.2780963315814773e-06,0,0
14376,#nc08,1,1.8364528545823171e-06,1,2.2780963315814773e-06,0,0
14379,@byrondonalds,1,1.8364528545823171e-06,1,2.2780963315814773e-06,0,0
14378,#fl19,1,1.8364528545823171e-06,1,2.2780963315814773e-06,0,0
14381,@katcammack,1,1.8364528545823171e-06,1,2.2780963315814773e-06,0,0
14382,kat,1,1.8364528545823171e-06,1,2.2780963315814773e-06,0,0
14380,#fl03,1,1.8364528545823171e-06,1,2.2780963315814773e-06,0,0
14384,@teamcmr,1,1.8364528545823171e-06,1,2.2780963315814773e-06,0,0
14383,#wa05,1,1.8364528545823171e-06,1,2.2780963315814773e-06,0,0
14389,@newhouse4rep,1,1.8364528545823171e-06,1,2.2780963315814773e-06,0,0
14388,#wa04,1,1.8364528545823171e-06,1,2.2780963315814773e-06,0,0
14394,luetkemeyer,1,1.8364528545823171e-06,1,2.2780963315814773e-06,0,0
14392,@luetkemeyerb,1,1.8364528545823171e-06,1,2.2780963315814773e-06,0,0
14391,#mo03,1,1.8364528545823171e-06,1,2.2780963315814773e-06,0,0
14397,hartzler,1,1.8364528545823171e-06,1,2.2780963315814773e-06,0,0
14396,@vickyh4congress,1,1.8364528545823171e-06,1,2.2780963315814773e-06,0,0
14395,#mo04,1,1.8364528545823171e-06,1,2.2780963315814773e-06,0,0
14399,#mo07,1,1.8364528545823171e-06,1,2.2780963315814773e-06,0,0
14405,@jasonsmithmo,1,1.8364528545823171e-06,1,2.2780963315814773e-06,0,0
14404,#mo08,1,1.8364528545823171e-06,1,2.2780963315814773e-06,0,0
14407,toughest-ever,1,1.8364528545823171e-06,1,2.2780963315814773e-06,0,0
14406,pillaging,1,1.8364528545823171e-06,1,2.2780963315814773e-06,0,0
14409,witty,1,1.8364528545823171e-06,1,2.2780963315814773e-06,0,0
14411,jpmorgan,1,1.8364528545823171e-06,1,2.2780963315814773e-06,0,0
14412,#september11,1,1.8364528545823171e-06,1,2.2780963315814773e-06,0,0
14414,solemnly,1,1.8364528545823171e-06,1,2.2780963315814773e-06,0,0
14417,trojan,1,1.8364528545823171e-06,1,2.2780963315814773e-06,0,0
14420,bognet,1,1.8364528545823171e-06,1,2.2780963315814773e-06,0,0
14419,@bognet4congress,1,1.8364528545823171e-06,1,2.2780963315814773e-06,0,0
14418,#pa08,1,1.8364528545823171e-06,1,2.2780963315814773e-06,0,0
14421,texarkana,1,1.8364528545823171e-06,1,2.2780963315814773e-06,0,0
14422,@flykissimmee,1,1.8364528545823171e-06,1,2.2780963315814773e-06,0,0
14424,1877m,1,1.8364528545823171e-06,1,2.2780963315814773e-06,0,0
14425,@pitairport,1,1.8364528545823171e-06,1,2.2780963315814773e-06,0,0
14426,observation,1,1.8364528545823171e-06,1,2.2780963315814773e-06,0,0
14428,@ilmairport,1,1.8364528545823171e-06,1,2.2780963315814773e-06,0,0
14427,211,1,1.8364528545823171e-06,1,2.2780963315814773e-06,0,0
14430,@goingplacescle,1,1.8364528545823171e-06,1,2.2780963315814773e-06,0,0
14429,@cakairport,1,1.8364528545823171e-06,1,2.2780963315814773e-06,0,0
14431,reno-stead,1,1.8364528545823171e-06,1,2.2780963315814773e-06,0,0
14432,taxiway,1,1.8364528545823171e-06,1,2.2780963315814773e-06,0,0
14433,@airforceonehq,1,1.8364528545823171e-06,1,2.2780963315814773e-06,0,0
14436,lifestyle,1,1.8364528545823171e-06,1,2.2780963315814773e-06,0,0
14440,wanda,1,1.8364528545823171e-06,1,2.2780963315814773e-06,0,0
14439,vázquez,1,1.8364528545823171e-06,1,2.2780963315814773e-06,0,0
14438,garced,1,1.8364528545823171e-06,1,2.2780963315814773e-06,0,0
14437,@wandavazquezg,1,1.8364528545823171e-06,1,2.2780963315814773e-06,0,0
14443,#mo06,1,1.8364528545823171e-06,1,2.2780963315814773e-06,0,0
14445,battling,1,1.8364528545823171e-06,1,2.2780963315814773e-06,0,0
14446,declarations,1,1.8364528545823171e-06,1,2.2780963315814773e-06,0,0
14447,accidentally,1,1.8364528545823171e-06,1,2.2780963315814773e-06,0,0
14451,whitmeropen,1,1.8364528545823171e-06,1,2.2780963315814773e-06,0,0
14454,rachael,1,1.8364528545823171e-06,1,2.2780963315814773e-06,0,0
14461,@stevescully,1,1.8364528545823171e-06,1,2.2780963315814773e-06,0,0
14462,breakouts,1,1.8364528545823171e-06,1,2.2780963315814773e-06,0,0
14463,entrapped,1,1.8364528545823171e-06,1,2.2780963315814773e-06,0,0
14465,splashdown,1,1.8364528545823171e-06,1,2.2780963315814773e-06,0,0
14466,@floridachiefs,1,1.8364528545823171e-06,1,2.2780963315814773e-06,0,0
14470,bomber,1,1.8364528545823171e-06,1,2.2780963315814773e-06,0,0
14471,dzhokhar,1,1.8364528545823171e-06,1,2.2780963315814773e-06,0,0
14472,tsarnaev,1,1.8364528545823171e-06,1,2.2780963315814773e-06,0,0
14474,supremacistwhile,1,1.8364528545823171e-06,1,2.2780963315814773e-06,0,0
14475,boating,1,1.8364528545823171e-06,1,2.2780963315814773e-06,0,0
14478,castro-chavistas,1,1.8364528545823171e-06,1,2.2780963315814773e-06,0,0
14479,castro-lover,1,1.8364528545823171e-06,1,2.2780963315814773e-06,0,0
14477,bass,1,1.8364528545823171e-06,1,2.2780963315814773e-06,0,0
14482,gustavo,1,1.8364528545823171e-06,1,2.2780963315814773e-06,0,0
14483,m-19,1,1.8364528545823171e-06,1,2.2780963315814773e-06,0,0
14481,guerrilla,1,1.8364528545823171e-06,1,2.2780963315814773e-06,0,0
14485,@alvarouribevel,1,1.8364528545823171e-06,1,2.2780963315814773e-06,0,0
14486,castro-chavismo,1,1.8364528545823171e-06,1,2.2780963315814773e-06,0,0
14487,colombian,1,1.8364528545823171e-06,1,2.2780963315814773e-06,0,0
14490,savannas,1,1.8364528545823171e-06,1,2.2780963315814773e-06,0,0
14489,295,1,1.8364528545823171e-06,1,2.2780963315814773e-06,0,0
14488,#operationladyjustice,1,1.8364528545823171e-06,1,2.2780963315814773e-06,0,0
14491,#me02,1,1.8364528545823171e-06,1,2.2780963315814773e-06,0,0
14495,shedd,1,1.8364528545823171e-06,1,2.2780963315814773e-06,0,0
14493,@tiffanyshedd,1,1.8364528545823171e-06,1,2.2780963315814773e-06,0,0
14494,arizonas,1,1.8364528545823171e-06,1,2.2780963315814773e-06,0,0
14492,#az01,1,1.8364528545823171e-06,1,2.2780963315814773e-06,0,0
14496,frorida,1,1.8364528545823171e-06,1,2.2780963315814773e-06,0,0
14497,bait,1,1.8364528545823171e-06,1,2.2780963315814773e-06,0,0
14498,fdrs,1,1.8364528545823171e-06,1,2.2780963315814773e-06,0,0
14499,@natesilver538,1,1.8364528545823171e-06,1,2.2780963315814773e-06,0,0
14504,evades,1,1.8364528545823171e-06,1,2.2780963315814773e-06,0,0
14507,faucis,1,1.8364528545823171e-06,1,2.2780963315814773e-06,0,0
14506,agreeand,1,1.8364528545823171e-06,1,2.2780963315814773e-06,0,0
14509,sj,1,1.8364528545823171e-06,1,2.2780963315814773e-06,0,0
14511,230th,1,1.8364528545823171e-06,1,2.2780963315814773e-06,0,0
14513,gallons,1,1.8364528545823171e-06,1,2.2780963315814773e-06,0,0
14514,mgoodwin@nypostcom,1,1.8364528545823171e-06,1,2.2780963315814773e-06,0,0
14517,floridas,1,1.8364528545823171e-06,1,2.2780963315814773e-06,0,0
14516,cleaned,1,1.8364528545823171e-06,1,2.2780963315814773e-06,0,0
14518,instantaneously,1,1.8364528545823171e-06,1,2.2780963315814773e-06,0,0
14520,wonders,1,1.8364528545823171e-06,1,2.2780963315814773e-06,0,0
14519,#hr1957,1,1.8364528545823171e-06,1,2.2780963315814773e-06,0,0
14521,#semperfidelis,1,1.8364528545823171e-06,1,2.2780963315814773e-06,0,0
14524,ore,1,1.8364528545823171e-06,1,2.2780963315814773e-06,0,0
14522,citys,1,1.8364528545823171e-06,1,2.2780963315814773e-06,0,0
14525,subside,1,1.8364528545823171e-06,1,2.2780963315814773e-06,0,0
14523,mcgurn,1,1.8364528545823171e-06,1,2.2780963315814773e-06,0,0
14529,habit,1,1.8364528545823171e-06,1,2.2780963315814773e-06,0,0
14530,lll,1,1.8364528545823171e-06,1,2.2780963315814773e-06,0,0
14528,crook,1,1.8364528545823171e-06,1,2.2780963315814773e-06,0,0
14533,lecture,1,1.8364528545823171e-06,1,2.2780963315814773e-06,0,0
14534,morals,1,1.8364528545823171e-06,1,2.2780963315814773e-06,0,0
14537,#japan🇯🇵,1,1.8364528545823171e-06,1,2.2780963315814773e-06,0,0
14539,#fnn,1,1.8364528545823171e-06,1,2.2780963315814773e-06,0,0
14547,sponsored,1,1.8364528545823171e-06,1,2.2780963315814773e-06,0,0
14546,occurring,1,1.8364528545823171e-06,1,2.2780963315814773e-06,0,0
14545,demonstrators,1,1.8364528545823171e-06,1,2.2780963315814773e-06,0,0
14544,communicate,1,1.8364528545823171e-06,1,2.2780963315814773e-06,0,0
14549,@dcsheriff,1,1.8364528545823171e-06,1,2.2780963315814773e-06,0,0
14551,agothis,1,1.8364528545823171e-06,1,2.2780963315814773e-06,0,0
14555,squandering,1,1.8364528545823171e-06,1,2.2780963315814773e-06,0,0
14554,#iranprotests,1,1.8364528545823171e-06,1,2.2780963315814773e-06,0,0
14557,poorer,1,1.8364528545823171e-06,1,2.2780963315814773e-06,0,0
14558,47and,1,1.8364528545823171e-06,1,2.2780963315814773e-06,0,0
14559,bundle,1,1.8364528545823171e-06,1,2.2780963315814773e-06,0,0
14562,dreamt,1,1.8364528545823171e-06,1,2.2780963315814773e-06,0,0
14565,bending,1,1.8364528545823171e-06,1,2.2780963315814773e-06,0,0
14570,jamess,1,1.8364528545823171e-06,1,2.2780963315814773e-06,0,0
14566,ch,1,1.8364528545823171e-06,1,2.2780963315814773e-06,0,0
14578,est,1,1.8364528545823171e-06,1,2.2780963315814773e-06,0,0
14580,#2,1,1.8364528545823171e-06,1,2.2780963315814773e-06,0,0
14581,paramedics,1,1.8364528545823171e-06,1,2.2780963315814773e-06,0,0
14582,@foxandfrlends,1,1.8364528545823171e-06,1,2.2780963315814773e-06,0,0
14584,russiatrump,1,1.8364528545823171e-06,1,2.2780963315814773e-06,0,0
14586,otherwiseand,1,1.8364528545823171e-06,1,2.2780963315814773e-06,0,0
14587,@foxnews-fbis,1,1.8364528545823171e-06,1,2.2780963315814773e-06,0,0
14589,reassigned,1,1.8364528545823171e-06,1,2.2780963315814773e-06,0,0
14590,racing,1,1.8364528545823171e-06,1,2.2780963315814773e-06,0,0
14596,trumans,1,1.8364528545823171e-06,1,2.2780963315814773e-06,0,0
14595,economystock,1,1.8364528545823171e-06,1,2.2780963315814773e-06,0,0
14597,compiling,1,1.8364528545823171e-06,1,2.2780963315814773e-06,0,0
14599,showering,1,1.8364528545823171e-06,1,2.2780963315814773e-06,0,0
14598,phenomenon,1,1.8364528545823171e-06,1,2.2780963315814773e-06,0,0
14602,influential,1,1.8364528545823171e-06,1,2.2780963315814773e-06,0,0
14604,strategically,1,1.8364528545823171e-06,1,2.2780963315814773e-06,0,0
14605,obamacarerepealed,1,1.8364528545823171e-06,1,2.2780963315814773e-06,0,0
14609,rescinding,1,1.8364528545823171e-06,1,2.2780963315814773e-06,0,0
14610,expensing,1,1.8364528545823171e-06,1,2.2780963315814773e-06,0,0
14613,winour,1,1.8364528545823171e-06,1,2.2780963315814773e-06,0,0
14612,pillars,1,1.8364528545823171e-06,1,2.2780963315814773e-06,0,0
14620,railways,1,1.8364528545823171e-06,1,2.2780963315814773e-06,0,0
14624,conquering,1,1.8364528545823171e-06,1,2.2780963315814773e-06,0,0
14623,#wrightbrothers,1,1.8364528545823171e-06,1,2.2780963315814773e-06,0,0
14626,motivate,1,1.8364528545823171e-06,1,2.2780963315814773e-06,0,0
14627,supersonic,1,1.8364528545823171e-06,1,2.2780963315814773e-06,0,0
14630,heartbeat,1,1.8364528545823171e-06,1,2.2780963315814773e-06,0,0
14635,squadron,1,1.8364528545823171e-06,1,2.2780963315814773e-06,0,0
14633,hmx-1,1,1.8364528545823171e-06,1,2.2780963315814773e-06,0,0
14636,bluethank,1,1.8364528545823171e-06,1,2.2780963315814773e-06,0,0
14640,1960,1,1.8364528545823171e-06,1,2.2780963315814773e-06,0,0
14641,roomtoday,1,1.8364528545823171e-06,1,2.2780963315814773e-06,0,0
14643,explorers,1,1.8364528545823171e-06,1,2.2780963315814773e-06,0,0
14644,inventors,1,1.8364528545823171e-06,1,2.2780963315814773e-06,0,0
14647,maze,1,1.8364528545823171e-06,1,2.2780963315814773e-06,0,0
14652,retractions,1,1.8364528545823171e-06,1,2.2780963315814773e-06,0,0
14651,meadia,1,1.8364528545823171e-06,1,2.2780963315814773e-06,0,0
14654,write-in,1,1.8364528545823171e-06,1,2.2780963315814773e-06,0,0
14655,#hanukkah,1,1.8364528545823171e-06,1,2.2780963315814773e-06,0,0
14657,pro-abortion,1,1.8364528545823171e-06,1,2.2780963315814773e-06,0,0
14658,crooked-used,1,1.8364528545823171e-06,1,2.2780963315814773e-06,0,0
14662,4-8,1,1.8364528545823171e-06,1,2.2780963315814773e-06,0,0
14663,defamatory,1,1.8364528545823171e-06,1,2.2780963315814773e-06,0,0
14664,exposeda,1,1.8364528545823171e-06,1,2.2780963315814773e-06,0,0
14667,sanctuaries,1,1.8364528545823171e-06,1,2.2780963315814773e-06,0,0
14671,1996,1,1.8364528545823171e-06,1,2.2780963315814773e-06,0,0
14673,retraction,1,1.8364528545823171e-06,1,2.2780963315814773e-06,0,0
14676,museums-the,1,1.8364528545823171e-06,1,2.2780963315814773e-06,0,0
14677,@philbryantms,1,1.8364528545823171e-06,1,2.2780963315814773e-06,0,0
14681,purposeful,1,1.8364528545823171e-06,1,2.2780963315814773e-06,0,0
14682,contingent,1,1.8364528545823171e-06,1,2.2780963315814773e-06,0,0
14684,lifemerry,1,1.8364528545823171e-06,1,2.2780963315814773e-06,0,0
14686,recorded@secretaryacosta,1,1.8364528545823171e-06,1,2.2780963315814773e-06,0,0
14688,fines,1,1.8364528545823171e-06,1,2.2780963315814773e-06,0,0
14695,oceans,1,1.8364528545823171e-06,1,2.2780963315814773e-06,0,0
14694,harrowing,1,1.8364528545823171e-06,1,2.2780963315814773e-06,0,0
14696,skies,1,1.8364528545823171e-06,1,2.2780963315814773e-06,0,0
14692,alikeremember,1,1.8364528545823171e-06,1,2.2780963315814773e-06,0,0
14697,1271941,1,1.8364528545823171e-06,1,2.2780963315814773e-06,0,0
14700,harborand,1,1.8364528545823171e-06,1,2.2780963315814773e-06,0,0
14699,#pearlharborremembranceday🇺🇸,1,1.8364528545823171e-06,1,2.2780963315814773e-06,0,0
14702,1941,1,1.8364528545823171e-06,1,2.2780963315814773e-06,0,0
14703,kilmeadereally,1,1.8364528545823171e-06,1,2.2780963315814773e-06,0,0
14706,tel,1,1.8364528545823171e-06,1,2.2780963315814773e-06,0,0
14704,aviv,1,1.8364528545823171e-06,1,2.2780963315814773e-06,0,0
14707,#periscope,1,1.8364528545823171e-06,1,2.2780963315814773e-06,0,0
14713,utahs,1,1.8364528545823171e-06,1,2.2780963315814773e-06,0,0
14708,capitolit,1,1.8364528545823171e-06,1,2.2780963315814773e-06,0,0
14712,proclamations,1,1.8364528545823171e-06,1,2.2780963315814773e-06,0,0
14711,modify,1,1.8364528545823171e-06,1,2.2780963315814773e-06,0,0
14710,escalante,1,1.8364528545823171e-06,1,2.2780963315814773e-06,0,0
14714,borders&,1,1.8364528545823171e-06,1,2.2780963315814773e-06,0,0
14715,refusal,1,1.8364528545823171e-06,1,2.2780963315814773e-06,0,0
14718,suspending,1,1.8364528545823171e-06,1,2.2780963315814773e-06,0,0
14717,horrendously,1,1.8364528545823171e-06,1,2.2780963315814773e-06,0,0
14720,interrogation,1,1.8364528545823171e-06,1,2.2780963315814773e-06,0,0
14722,timesand,1,1.8364528545823171e-06,1,2.2780963315814773e-06,0,0
14724,seamstress,1,1.8364528545823171e-06,1,2.2780963315814773e-06,0,0
14723,montgomery,1,1.8364528545823171e-06,1,2.2780963315814773e-06,0,0
14728,shepherding,1,1.8364528545823171e-06,1,2.2780963315814773e-06,0,0
14729,actthe,1,1.8364528545823171e-06,1,2.2780963315814773e-06,0,0
14730,enactment,1,1.8364528545823171e-06,1,2.2780963315814773e-06,0,0
14731,ignite,1,1.8364528545823171e-06,1,2.2780963315814773e-06,0,0
14733,speculating,1,1.8364528545823171e-06,1,2.2780963315814773e-06,0,0
14735,felon,1,1.8364528545823171e-06,1,2.2780963315814773e-06,0,0
14738,verdict,1,1.8364528545823171e-06,1,2.2780963315814773e-06,0,0
14740,allthe,1,1.8364528545823171e-06,1,2.2780963315814773e-06,0,0
14741,humanitywhatever,1,1.8364528545823171e-06,1,2.2780963315814773e-06,0,0
14742,#dow24k,1,1.8364528545823171e-06,1,2.2780963315814773e-06,0,0
14745,partnersduring,1,1.8364528545823171e-06,1,2.2780963315814773e-06,0,0
14746,princes,1,1.8364528545823171e-06,1,2.2780963315814773e-06,0,0
14744,finalizing,1,1.8364528545823171e-06,1,2.2780963315814773e-06,0,0
14743,f-16s,1,1.8364528545823171e-06,1,2.2780963315814773e-06,0,0
14747,24000,1,1.8364528545823171e-06,1,2.2780963315814773e-06,0,0
14748,glum,1,1.8364528545823171e-06,1,2.2780963315814773e-06,0,0
14749,abound,1,1.8364528545823171e-06,1,2.2780963315814773e-06,0,0
14750,condemned,1,1.8364528545823171e-06,1,2.2780963315814773e-06,0,0
14751,installed,1,1.8364528545823171e-06,1,2.2780963315814773e-06,0,0
14754,pipe,1,1.8364528545823171e-06,1,2.2780963315814773e-06,0,0
14753,organ,1,1.8364528545823171e-06,1,2.2780963315814773e-06,0,0
14757,securitycharles,1,1.8364528545823171e-06,1,2.2780963315814773e-06,0,0
14756,mcculloughfmr,1,1.8364528545823171e-06,1,2.2780963315814773e-06,0,0
14758,citations,1,1.8364528545823171e-06,1,2.2780963315814773e-06,0,0
14759,justicedepartment,1,1.8364528545823171e-06,1,2.2780963315814773e-06,0,0
14763,destinybut,1,1.8364528545823171e-06,1,2.2780963315814773e-06,0,0
14766,present-a,1,1.8364528545823171e-06,1,2.2780963315814773e-06,0,0
14768,linea,1,1.8364528545823171e-06,1,2.2780963315814773e-06,0,0
14770,excluding,1,1.8364528545823171e-06,1,2.2780963315814773e-06,0,0
14769,cea,1,1.8364528545823171e-06,1,2.2780963315814773e-06,0,0
14771,q3stock,1,1.8364528545823171e-06,1,2.2780963315814773e-06,0,0
14772,shift,1,1.8364528545823171e-06,1,2.2780963315814773e-06,0,0
14780,mccullough,1,1.8364528545823171e-06,1,2.2780963315814773e-06,0,0
14781,1262,1,1.8364528545823171e-06,1,2.2780963315814773e-06,0,0
14782,1295,1,1.8364528545823171e-06,1,2.2780963315814773e-06,0,0
14787,#givingtuesday,1,1.8364528545823171e-06,1,2.2780963315814773e-06,0,0
14788,stadiums,1,1.8364528545823171e-06,1,2.2780963315814773e-06,0,0
14789,mathematical,1,1.8364528545823171e-06,1,2.2780963315814773e-06,0,0
14792,russiarussia,1,1.8364528545823171e-06,1,2.2780963315814773e-06,0,0
14795,#smallbusinesssaturdaya,1,1.8364528545823171e-06,1,2.2780963315814773e-06,0,0
14796,creators,1,1.8364528545823171e-06,1,2.2780963315814773e-06,0,0
14794,#smallbiz,1,1.8364528545823171e-06,1,2.2780963315814773e-06,0,0
14793,#shopsmall,1,1.8364528545823171e-06,1,2.2780963315814773e-06,0,0
14799,defenseless,1,1.8364528545823171e-06,1,2.2780963315814773e-06,0,0
14803,worshipers,1,1.8364528545823171e-06,1,2.2780963315814773e-06,0,0
14810,inlet,1,1.8364528545823171e-06,1,2.2780963315814773e-06,0,0
14811,riviera,1,1.8364528545823171e-06,1,2.2780963315814773e-06,0,0
14812,monterey,1,1.8364528545823171e-06,1,2.2780963315814773e-06,0,0
14815,@theplumlinegs,1,1.8364528545823171e-06,1,2.2780963315814773e-06,0,0
14817,aaa,1,1.8364528545823171e-06,1,2.2780963315814773e-06,0,0
14819,conducting,1,1.8364528545823171e-06,1,2.2780963315814773e-06,0,0
14823,lavars,1,1.8364528545823171e-06,1,2.2780963315814773e-06,0,0
14824,drumstick,1,1.8364528545823171e-06,1,2.2780963315814773e-06,0,0
14826,wishbone,1,1.8364528545823171e-06,1,2.2780963315814773e-06,0,0
14825,gobblers,1,1.8364528545823171e-06,1,2.2780963315814773e-06,0,0
14829,marshawn,1,1.8364528545823171e-06,1,2.2780963315814773e-06,0,0
14830,nfls,1,1.8364528545823171e-06,1,2.2780963315814773e-06,0,0
14831,raiders,1,1.8364528545823171e-06,1,2.2780963315814773e-06,0,0
14828,boos,1,1.8364528545823171e-06,1,2.2780963315814773e-06,0,0
14833,big-game,1,1.8364528545823171e-06,1,2.2780963315814773e-06,0,0
14834,elephants,1,1.8364528545823171e-06,1,2.2780963315814773e-06,0,0
14836,5-10,1,1.8364528545823171e-06,1,2.2780963315814773e-06,0,0
14839,liangelo,1,1.8364528545823171e-06,1,2.2780963315814773e-06,0,0
14840,unaccepting,1,1.8364528545823171e-06,1,2.2780963315814773e-06,0,0
14841,zinke,1,1.8364528545823171e-06,1,2.2780963315814773e-06,0,0
14844,collegiate,1,1.8364528545823171e-06,1,2.2780963315814773e-06,0,0
14843,20162017,1,1.8364528545823171e-06,1,2.2780963315814773e-06,0,0
14842,#ncaachampions🏆photos,1,1.8364528545823171e-06,1,2.2780963315814773e-06,0,0
14846,gangshundreds,1,1.8364528545823171e-06,1,2.2780963315814773e-06,0,0
14848,frankenstien,1,1.8364528545823171e-06,1,2.2780963315814773e-06,0,0
14849,227-205,1,1.8364528545823171e-06,1,2.2780963315814773e-06,0,0
14853,mechanism,1,1.8364528545823171e-06,1,2.2780963315814773e-06,0,0
14854,pitfalls,1,1.8364528545823171e-06,1,2.2780963315814773e-06,0,0
14858,policyweak,1,1.8364528545823171e-06,1,2.2780963315814773e-06,0,0
14859,friendships,1,1.8364528545823171e-06,1,2.2780963315814773e-06,0,0
14860,fruits,1,1.8364528545823171e-06,1,2.2780963315814773e-06,0,0
14863,30s,1,1.8364528545823171e-06,1,2.2780963315814773e-06,0,0
14864,50s,1,1.8364528545823171e-06,1,2.2780963315814773e-06,0,0
14865,#asean50,1,1.8364528545823171e-06,1,2.2780963315814773e-06,0,0
14867,indiv,1,1.8364528545823171e-06,1,2.2780963315814773e-06,0,0
14877,tran,1,1.8364528545823171e-06,1,2.2780963315814773e-06,0,0
14874,dai,1,1.8364528545823171e-06,1,2.2780963315814773e-06,0,0
14876,quang,1,1.8364528545823171e-06,1,2.2780963315814773e-06,0,0
14873,anniv,1,1.8364528545823171e-06,1,2.2780963315814773e-06,0,0
14875,gala,1,1.8364528545823171e-06,1,2.2780963315814773e-06,0,0
14878,pastand,1,1.8364528545823171e-06,1,2.2780963315814773e-06,0,0
14881,misspelled,1,1.8364528545823171e-06,1,2.2780963315814773e-06,0,0
14883,#apec,1,1.8364528545823171e-06,1,2.2780963315814773e-06,0,0
14884,destination,1,1.8364528545823171e-06,1,2.2780963315814773e-06,0,0
14885,phillipines,1,1.8364528545823171e-06,1,2.2780963315814773e-06,0,0
14887,upping,1,1.8364528545823171e-06,1,2.2780963315814773e-06,0,0
14890,242nd,1,1.8364528545823171e-06,1,2.2780963315814773e-06,0,0
14889,#usmc242,1,1.8364528545823171e-06,1,2.2780963315814773e-06,0,0
14888,#semperfi,1,1.8364528545823171e-06,1,2.2780963315814773e-06,0,0
14892,-economic,1,1.8364528545823171e-06,1,2.2780963315814773e-06,0,0
14894,mutually,1,1.8364528545823171e-06,1,2.2780963315814773e-06,0,0
14893,beneficial,1,1.8364528545823171e-06,1,2.2780963315814773e-06,0,0
14897,destinies,1,1.8364528545823171e-06,1,2.2780963315814773e-06,0,0
14902,wdiverse,1,1.8364528545823171e-06,1,2.2780963315814773e-06,0,0
14900,cultures,1,1.8364528545823171e-06,1,2.2780963315814773e-06,0,0
14901,side-by-side,1,1.8364528545823171e-06,1,2.2780963315814773e-06,0,0
14906,zoo,1,1.8364528545823171e-06,1,2.2780963315814773e-06,0,0
14912,admins,1,1.8364528545823171e-06,1,2.2780963315814773e-06,0,0
14911,100s,1,1.8364528545823171e-06,1,2.2780963315814773e-06,0,0
14913,wouldve,1,1.8364528545823171e-06,1,2.2780963315814773e-06,0,0
14914,🇺🇸🇨🇳,1,1.8364528545823171e-06,1,2.2780963315814773e-06,0,0
14915,memorable,1,1.8364528545823171e-06,1,2.2780963315814773e-06,0,0
14917,304-227,1,1.8364528545823171e-06,1,2.2780963315814773e-06,0,0
14923,restraint,1,1.8364528545823171e-06,1,2.2780963315814773e-06,0,0
14920,fatal,1,1.8364528545823171e-06,1,2.2780963315814773e-06,0,0
14921,miscalculation,1,1.8364528545823171e-06,1,2.2780963315814773e-06,0,0
14924,rejoining,1,1.8364528545823171e-06,1,2.2780963315814773e-06,0,0
14928,assurance,1,1.8364528545823171e-06,1,2.2780963315814773e-06,0,0
14929,commmitment,1,1.8364528545823171e-06,1,2.2780963315814773e-06,0,0
14932,korea🇺🇸🇰🇷,1,1.8364528545823171e-06,1,2.2780963315814773e-06,0,0
14930,#nationalassembly,1,1.8364528545823171e-06,1,2.2780963315814773e-06,0,0
14931,#potusinasia,1,1.8364528545823171e-06,1,2.2780963315814773e-06,0,0
14935,natl,1,1.8364528545823171e-06,1,2.2780963315814773e-06,0,0
14938,@billygraham,1,1.8364528545823171e-06,1,2.2780963315814773e-06,0,0
14940,anti-second,1,1.8364528545823171e-06,1,2.2780963315814773e-06,0,0
14943,humphreys,1,1.8364528545823171e-06,1,2.2780963315814773e-06,0,0
14946,milking,1,1.8364528545823171e-06,1,2.2780963315814773e-06,0,0
14950,hideki,1,1.8364528545823171e-06,1,2.2780963315814773e-06,0,0
14951,matsuyama,1,1.8364528545823171e-06,1,2.2780963315814773e-06,0,0
14954,ipo,1,1.8364528545823171e-06,1,2.2780963315814773e-06,0,0
14953,aramco,1,1.8364528545823171e-06,1,2.2780963315814773e-06,0,0
14955,trill,1,1.8364528545823171e-06,1,2.2780963315814773e-06,0,0
14957,@pacificcommandremember,1,1.8364528545823171e-06,1,2.2780963315814773e-06,0,0
14956,#pearlharbor,1,1.8364528545823171e-06,1,2.2780963315814773e-06,0,0
14958,@ussarizonaa,1,1.8364528545823171e-06,1,2.2780963315814773e-06,0,0
14960,@pacificcommand,1,1.8364528545823171e-06,1,2.2780963315814773e-06,0,0
14961,arrival,1,1.8364528545823171e-06,1,2.2780963315814773e-06,0,0
14962,skorea,1,1.8364528545823171e-06,1,2.2780963315814773e-06,0,0
14967,out-and,1,1.8364528545823171e-06,1,2.2780963315814773e-06,0,0
14969,storming,1,1.8364528545823171e-06,1,2.2780963315814773e-06,0,0
14970,@federalreserve,1,1.8364528545823171e-06,1,2.2780963315814773e-06,0,0
14973,broadcoms,1,1.8364528545823171e-06,1,2.2780963315814773e-06,0,0
14971,america20,1,1.8364528545823171e-06,1,2.2780963315814773e-06,0,0
14975,rev,1,1.8364528545823171e-06,1,2.2780963315814773e-06,0,0
14974,researchengineering,1,1.8364528545823171e-06,1,2.2780963315814773e-06,0,0
14976,@broadcom,1,1.8364528545823171e-06,1,2.2780963315814773e-06,0,0
14977,hock,1,1.8364528545823171e-06,1,2.2780963315814773e-06,0,0
14979,tan,1,1.8364528545823171e-06,1,2.2780963315814773e-06,0,0
14978,hqs,1,1.8364528545823171e-06,1,2.2780963315814773e-06,0,0
14980,vulnerabilities,1,1.8364528545823171e-06,1,2.2780963315814773e-06,0,0
14984,champions⚾️,1,1.8364528545823171e-06,1,2.2780963315814773e-06,0,0
14981,#earnhistory,1,1.8364528545823171e-06,1,2.2780963315814773e-06,0,0
14985,guantanamo,1,1.8364528545823171e-06,1,2.2780963315814773e-06,0,0
14992,horrifying,1,1.8364528545823171e-06,1,2.2780963315814773e-06,0,0
14993,coltony,1,1.8364528545823171e-06,1,2.2780963315814773e-06,0,0
14997,shaffer,1,1.8364528545823171e-06,1,2.2780963315814773e-06,0,0
15000,productionup📈78,1,1.8364528545823171e-06,1,2.2780963315814773e-06,0,0
14999,down📉315,1,1.8364528545823171e-06,1,2.2780963315814773e-06,0,0
14998,#endingwaroncoal,1,1.8364528545823171e-06,1,2.2780963315814773e-06,0,0
15001,#halloween2017,1,1.8364528545823171e-06,1,2.2780963315814773e-06,0,0
15004,apprehension,1,1.8364528545823171e-06,1,2.2780963315814773e-06,0,0
15005,mustafa,1,1.8364528545823171e-06,1,2.2780963315814773e-06,0,0
15002,al-imam,1,1.8364528545823171e-06,1,2.2780963315814773e-06,0,0
15006,dither,1,1.8364528545823171e-06,1,2.2780963315814773e-06,0,0
15007,manaforts,1,1.8364528545823171e-06,1,2.2780963315814773e-06,0,0
15008,michaelcaputo,1,1.8364528545823171e-06,1,2.2780963315814773e-06,0,0
15010,972000,1,1.8364528545823171e-06,1,2.2780963315814773e-06,0,0
15009,12400000,1,1.8364528545823171e-06,1,2.2780963315814773e-06,0,0
15013,okd,1,1.8364528545823171e-06,1,2.2780963315814773e-06,0,0
15014,coincidental,1,1.8364528545823171e-06,1,2.2780963315814773e-06,0,0
15015,democratsclinton,1,1.8364528545823171e-06,1,2.2780963315814773e-06,0,0
15020,#firstrespondersday,1,1.8364528545823171e-06,1,2.2780963315814773e-06,0,0
15024,happenedhow,1,1.8364528545823171e-06,1,2.2780963315814773e-06,0,0
15025,russia➡️,1,1.8364528545823171e-06,1,2.2780963315814773e-06,0,0
15028,anxiously,1,1.8364528545823171e-06,1,2.2780963315814773e-06,0,0
15029,awaiting,1,1.8364528545823171e-06,1,2.2780963315814773e-06,0,0
15030,be🎥,1,1.8364528545823171e-06,1,2.2780963315814773e-06,0,0
15031,depths,1,1.8364528545823171e-06,1,2.2780963315814773e-06,0,0
15034,hc,1,1.8364528545823171e-06,1,2.2780963315814773e-06,0,0
15035,@leegreenwood83,1,1.8364528545823171e-06,1,2.2780963315814773e-06,0,0
15036,@joyvilla,1,1.8364528545823171e-06,1,2.2780963315814773e-06,0,0
15037,affliction,1,1.8364528545823171e-06,1,2.2780963315814773e-06,0,0
15040,meetingswork,1,1.8364528545823171e-06,1,2.2780963315814773e-06,0,0
15042,statuesheritage,1,1.8364528545823171e-06,1,2.2780963315814773e-06,0,0
15046,@danpatrickthank,1,1.8364528545823171e-06,1,2.2780963315814773e-06,0,0
15049,#dobbs,1,1.8364528545823171e-06,1,2.2780963315814773e-06,0,0
15052,fest,1,1.8364528545823171e-06,1,2.2780963315814773e-06,0,0
15055,tennesse,1,1.8364528545823171e-06,1,2.2780963315814773e-06,0,0
15056,catcher,1,1.8364528545823171e-06,1,2.2780963315814773e-06,0,0
15057,hizballah,1,1.8364528545823171e-06,1,2.2780963315814773e-06,0,0
15058,widow,1,1.8364528545823171e-06,1,2.2780963315814773e-06,0,0
15062,sinking,1,1.8364528545823171e-06,1,2.2780963315814773e-06,0,0
15061,orgs,1,1.8364528545823171e-06,1,2.2780963315814773e-06,0,0
15059,cred,1,1.8364528545823171e-06,1,2.2780963315814773e-06,0,0
15063,bartiromo,1,1.8364528545823171e-06,1,2.2780963315814773e-06,0,0
15064,yrs,1,1.8364528545823171e-06,1,2.2780963315814773e-06,0,0
15067,fewest,1,1.8364528545823171e-06,1,2.2780963315814773e-06,0,0
15066,@bpolitics,1,1.8364528545823171e-06,1,2.2780963315814773e-06,0,0
15070,hails,1,1.8364528545823171e-06,1,2.2780963315814773e-06,0,0
15071,liberation,1,1.8364528545823171e-06,1,2.2780963315814773e-06,0,0
15072,raqqa,1,1.8364528545823171e-06,1,2.2780963315814773e-06,0,0
15069,anti-isis,1,1.8364528545823171e-06,1,2.2780963315814773e-06,0,0
15073,receipt,1,1.8364528545823171e-06,1,2.2780963315814773e-06,0,0
15076,@unsecretary-general,1,1.8364528545823171e-06,1,2.2780963315814773e-06,0,0
15078,#vegasstrong,1,1.8364528545823171e-06,1,2.2780963315814773e-06,0,0
15080,wilsond,1,1.8364528545823171e-06,1,2.2780963315814773e-06,0,0
15081,100isis,1,1.8364528545823171e-06,1,2.2780963315814773e-06,0,0
15083,griparmy,1,1.8364528545823171e-06,1,2.2780963315814773e-06,0,0
15082,dilloncjtfoir,1,1.8364528545823171e-06,1,2.2780963315814773e-06,0,0
15085,#puertorico🇵🇷with,1,1.8364528545823171e-06,1,2.2780963315814773e-06,0,0
15088,@bradthorthank,1,1.8364528545823171e-06,1,2.2780963315814773e-06,0,0
15090,20000📈21000📈22000📈,1,1.8364528545823171e-06,1,2.2780963315814773e-06,0,0
15091,23000📈this,1,1.8364528545823171e-06,1,2.2780963315814773e-06,0,0
15093,yearfour,1,1.8364528545823171e-06,1,2.2780963315814773e-06,0,0
15089,#dow23k,1,1.8364528545823171e-06,1,2.2780963315814773e-06,0,0
15094,@nfl,1,1.8364528545823171e-06,1,2.2780963315814773e-06,0,0
15099,hides,1,1.8364528545823171e-06,1,2.2780963315814773e-06,0,0
15096,assertion,1,1.8364528545823171e-06,1,2.2780963315814773e-06,0,0
15098,compliance,1,1.8364528545823171e-06,1,2.2780963315814773e-06,0,0
15097,brazenly,1,1.8364528545823171e-06,1,2.2780963315814773e-06,0,0
15100,limitsamb,1,1.8364528545823171e-06,1,2.2780963315814773e-06,0,0
15103,job-creators,1,1.8364528545823171e-06,1,2.2780963315814773e-06,0,0
15104,ins,1,1.8364528545823171e-06,1,2.2780963315814773e-06,0,0
15106,this-obviously,1,1.8364528545823171e-06,1,2.2780963315814773e-06,0,0
15111,@heritage,1,1.8364528545823171e-06,1,2.2780963315814773e-06,0,0
15118,130pme,1,1.8364528545823171e-06,1,2.2780963315814773e-06,0,0
15120,23000,1,1.8364528545823171e-06,1,2.2780963315814773e-06,0,0
15119,#dow23k📈,1,1.8364528545823171e-06,1,2.2780963315814773e-06,0,0
15124,reptom,1,1.8364528545823171e-06,1,2.2780963315814773e-06,0,0
15123,marino,1,1.8364528545823171e-06,1,2.2780963315814773e-06,0,0
15122,czar,1,1.8364528545823171e-06,1,2.2780963315814773e-06,0,0
15125,greenville-spartanburg,1,1.8364528545823171e-06,1,2.2780963315814773e-06,0,0
15127,cancelations,1,1.8364528545823171e-06,1,2.2780963315814773e-06,0,0
15128,terminations,1,1.8364528545823171e-06,1,2.2780963315814773e-06,0,0
15131,plunged,1,1.8364528545823171e-06,1,2.2780963315814773e-06,0,0
15134,guise,1,1.8364528545823171e-06,1,2.2780963315814773e-06,0,0
15133,fortunedems,1,1.8364528545823171e-06,1,2.2780963315814773e-06,0,0
15136,2004📈,1,1.8364528545823171e-06,1,2.2780963315814773e-06,0,0
15138,#valuesvoterssummit,1,1.8364528545823171e-06,1,2.2780963315814773e-06,0,0
15139,#242navybday,1,1.8364528545823171e-06,1,2.2780963315814773e-06,0,0
15140,hs,1,1.8364528545823171e-06,1,2.2780963315814773e-06,0,0
15142,subsidy,1,1.8364528545823171e-06,1,2.2780963315814773e-06,0,0
15143,fakenews,1,1.8364528545823171e-06,1,2.2780963315814773e-06,0,0
15144,#nationalfarmersday📸,1,1.8364528545823171e-06,1,2.2780963315814773e-06,0,0
15149,looms,1,1.8364528545823171e-06,1,2.2780963315814773e-06,0,0
15150,sharyl,1,1.8364528545823171e-06,1,2.2780963315814773e-06,0,0
15153,licenses,1,1.8364528545823171e-06,1,2.2780963315814773e-06,0,0
15155,america🇺🇸,1,1.8364528545823171e-06,1,2.2780963315814773e-06,0,0
15156,545pme,1,1.8364528545823171e-06,1,2.2780963315814773e-06,0,0
15157,harrisburg,1,1.8364528545823171e-06,1,2.2780963315814773e-06,0,0
15158,1m,1,1.8364528545823171e-06,1,2.2780963315814773e-06,0,0
15161,anthem-respect,1,1.8364528545823171e-06,1,2.2780963315814773e-06,0,0
15163,bordersthe,1,1.8364528545823171e-06,1,2.2780963315814773e-06,0,0
15164,electionneed,1,1.8364528545823171e-06,1,2.2780963315814773e-06,0,0
15165,leaps,1,1.8364528545823171e-06,1,2.2780963315814773e-06,0,0
15168,back-to-back,1,1.8364528545823171e-06,1,2.2780963315814773e-06,0,0
15167,#stanleycup,1,1.8364528545823171e-06,1,2.2780963315814773e-06,0,0
15172,jemele,1,1.8364528545823171e-06,1,2.2780963315814773e-06,0,0
15175,bordersthey,1,1.8364528545823171e-06,1,2.2780963315814773e-06,0,0
15176,flagstand,1,1.8364528545823171e-06,1,2.2780963315814773e-06,0,0
15179,racking,1,1.8364528545823171e-06,1,2.2780963315814773e-06,0,0
15182,@secondlady,1,1.8364528545823171e-06,1,2.2780963315814773e-06,0,0
15185,#lasvegasstrong,1,1.8364528545823171e-06,1,2.2780963315814773e-06,0,0
15186,#usa🇺🇸🎥,1,1.8364528545823171e-06,1,2.2780963315814773e-06,0,0
15187,makings,1,1.8364528545823171e-06,1,2.2780963315814773e-06,0,0
15190,@tbn,1,1.8364528545823171e-06,1,2.2780963315814773e-06,0,0
15191,#hurricanenate,1,1.8364528545823171e-06,1,2.2780963315814773e-06,0,0
15197,unfunny,1,1.8364528545823171e-06,1,2.2780963315814773e-06,0,0
15196,repetitive,1,1.8364528545823171e-06,1,2.2780963315814773e-06,0,0
15198,northamwho,1,1.8364528545823171e-06,1,2.2780963315814773e-06,0,0
15199,virginiais,1,1.8364528545823171e-06,1,2.2780963315814773e-06,0,0
15200,up-fake,1,1.8364528545823171e-06,1,2.2780963315814773e-06,0,0
15206,#teamusa🇺🇸🏆on,1,1.8364528545823171e-06,1,2.2780963315814773e-06,0,0
15207,@presidentscup,1,1.8364528545823171e-06,1,2.2780963315814773e-06,0,0
15208,ingrates,1,1.8364528545823171e-06,1,2.2780963315814773e-06,0,0
15213,racefake,1,1.8364528545823171e-06,1,2.2780963315814773e-06,0,0
15214,tues,1,1.8364528545823171e-06,1,2.2780963315814773e-06,0,0
15216,ricodo,1,1.8364528545823171e-06,1,2.2780963315814773e-06,0,0
15217,gonzalez-colon,1,1.8364528545823171e-06,1,2.2780963315814773e-06,0,0
15222,ricky,1,1.8364528545823171e-06,1,2.2780963315814773e-06,0,0
15224,fr,1,1.8364528545823171e-06,1,2.2780963315814773e-06,0,0
15225,@impdnews,1,1.8364528545823171e-06,1,2.2780963315814773e-06,0,0
15226,holiest,1,1.8364528545823171e-06,1,2.2780963315814773e-06,0,0
15228,aligning,1,1.8364528545823171e-06,1,2.2780963315814773e-06,0,0
15229,hardagainst,1,1.8364528545823171e-06,1,2.2780963315814773e-06,0,0
15230,oddsin,1,1.8364528545823171e-06,1,2.2780963315814773e-06,0,0
15232,docks,1,1.8364528545823171e-06,1,2.2780963315814773e-06,0,0
15235,generators,1,1.8364528545823171e-06,1,2.2780963315814773e-06,0,0
15236,months-and,1,1.8364528545823171e-06,1,2.2780963315814773e-06,0,0
15239,anti-trumpthe,1,1.8364528545823171e-06,1,2.2780963315814773e-06,0,0
15240,hencefake,1,1.8364528545823171e-06,1,2.2780963315814773e-06,0,0
15237,@nytimesapologized,1,1.8364528545823171e-06,1,2.2780963315814773e-06,0,0
15244,usain,1,1.8364528545823171e-06,1,2.2780963315814773e-06,0,0
15242,bolt,1,1.8364528545823171e-06,1,2.2780963315814773e-06,0,0
15245,🇺🇸🇯🇲,1,1.8364528545823171e-06,1,2.2780963315814773e-06,0,0
15246,advising,1,1.8364528545823171e-06,1,2.2780963315814773e-06,0,0
15248,presidents-then,1,1.8364528545823171e-06,1,2.2780963315814773e-06,0,0
15247,nsc,1,1.8364528545823171e-06,1,2.2780963315814773e-06,0,0
15249,@usun,1,1.8364528545823171e-06,1,2.2780963315814773e-06,0,0
15250,@marianorajoy,1,1.8364528545823171e-06,1,2.2780963315814773e-06,0,0
15251,isolate,1,1.8364528545823171e-06,1,2.2780963315814773e-06,0,0
15252,🇺🇸🇪🇸,1,1.8364528545823171e-06,1,2.2780963315814773e-06,0,0
15253,@un,1,1.8364528545823171e-06,1,2.2780963315814773e-06,0,0
15254,carmen,1,1.8364528545823171e-06,1,2.2780963315814773e-06,0,0
15258,yulin,1,1.8364528545823171e-06,1,2.2780963315814773e-06,0,0
15256,etcwe,1,1.8364528545823171e-06,1,2.2780963315814773e-06,0,0
15257,thereon,1,1.8364528545823171e-06,1,2.2780963315814773e-06,0,0
15260,tortured,1,1.8364528545823171e-06,1,2.2780963315814773e-06,0,0
15263,made-we,1,1.8364528545823171e-06,1,2.2780963315814773e-06,0,0
15264,booing,1,1.8364528545823171e-06,1,2.2780963315814773e-06,0,0
15266,changed-complete,1,1.8364528545823171e-06,1,2.2780963315814773e-06,0,0
15267,owed,1,1.8364528545823171e-06,1,2.2780963315814773e-06,0,0
15268,#standforouranthem,1,1.8364528545823171e-06,1,2.2780963315814773e-06,0,0
15270,nhl,1,1.8364528545823171e-06,1,2.2780963315814773e-06,0,0
15271,echoes,1,1.8364528545823171e-06,1,2.2780963315814773e-06,0,0
15272,countrytell,1,1.8364528545823171e-06,1,2.2780963315814773e-06,0,0
15275,laughingly,1,1.8364528545823171e-06,1,2.2780963315814773e-06,0,0
15274,deceived,1,1.8364528545823171e-06,1,2.2780963315814773e-06,0,0
15278,test-fired,1,1.8364528545823171e-06,1,2.2780963315814773e-06,0,0
15276,israelthey,1,1.8364528545823171e-06,1,2.2780963315814773e-06,0,0
15277,koreanot,1,1.8364528545823171e-06,1,2.2780963315814773e-06,0,0
15280,nflor,1,1.8364528545823171e-06,1,2.2780963315814773e-06,0,0
15283,teamstephen,1,1.8364528545823171e-06,1,2.2780963315814773e-06,0,0
15281,curry,1,1.8364528545823171e-06,1,2.2780963315814773e-06,0,0
15282,hesitatingtherefore,1,1.8364528545823171e-06,1,2.2780963315814773e-06,0,0
15286,madman,1,1.8364528545823171e-06,1,2.2780963315814773e-06,0,0
15289,koreastay,1,1.8364528545823171e-06,1,2.2780963315814773e-06,0,0
15290,#unga🎥,1,1.8364528545823171e-06,1,2.2780963315814773e-06,0,0
15293,ashraf,1,1.8364528545823171e-06,1,2.2780963315814773e-06,0,0
15295,@ricardorossello-,1,1.8364528545823171e-06,1,2.2780963315814773e-06,0,0
15296,lie-just,1,1.8364528545823171e-06,1,2.2780963315814773e-06,0,0
15297,alabamathat,1,1.8364528545823171e-06,1,2.2780963315814773e-06,0,0
15301,palestinian,1,1.8364528545823171e-06,1,2.2780963315814773e-06,0,0
15302,weverybody,1,1.8364528545823171e-06,1,2.2780963315814773e-06,0,0
15303,abdullah,1,1.8364528545823171e-06,1,2.2780963315814773e-06,0,0
15304,meeting🇺🇸🇯🇴,1,1.8364528545823171e-06,1,2.2780963315814773e-06,0,0
15305,noticing,1,1.8364528545823171e-06,1,2.2780963315814773e-06,0,0
15307,emmys,1,1.8364528545823171e-06,1,2.2780963315814773e-06,0,0
15308,nationsmet,1,1.8364528545823171e-06,1,2.2780963315814773e-06,0,0
15309,you-,1,1.8364528545823171e-06,1,2.2780963315814773e-06,0,0
15310,@un🎥,1,1.8364528545823171e-06,1,2.2780963315814773e-06,0,0
15311,#ungafull,1,1.8364528545823171e-06,1,2.2780963315814773e-06,0,0
15312,the🇺🇸has,1,1.8364528545823171e-06,1,2.2780963315814773e-06,0,0
15315,sg,1,1.8364528545823171e-06,1,2.2780963315814773e-06,0,0
15316,@cia,1,1.8364528545823171e-06,1,2.2780963315814773e-06,0,0
15319,shuette,1,1.8364528545823171e-06,1,2.2780963315814773e-06,0,0
15320,lifecont,1,1.8364528545823171e-06,1,2.2780963315814773e-06,0,0
15321,countryproclamation,1,1.8364528545823171e-06,1,2.2780963315814773e-06,0,0
15322,fx,1,1.8364528545823171e-06,1,2.2780963315814773e-06,0,0
15323,giaccio-on,1,1.8364528545823171e-06,1,2.2780963315814773e-06,0,0
15324,programming,1,1.8364528545823171e-06,1,2.2780963315814773e-06,0,0
15325,untruth,1,1.8364528545823171e-06,1,2.2780963315814773e-06,0,0
15326,yearsmust,1,1.8364528545823171e-06,1,2.2780963315814773e-06,0,0
15327,specific-but,1,1.8364528545823171e-06,1,2.2780963315814773e-06,0,0
15328,mannerthe,1,1.8364528545823171e-06,1,2.2780963315814773e-06,0,0
15329,recruitment,1,1.8364528545823171e-06,1,2.2780963315814773e-06,0,0
15330,terroristthese,1,1.8364528545823171e-06,1,2.2780963315814773e-06,0,0
15331,florida-just,1,1.8364528545823171e-06,1,2.2780963315814773e-06,0,0
15335,floridaemergency,1,1.8364528545823171e-06,1,2.2780963315814773e-06,0,0
15333,1-800-342-3557,1,1.8364528545823171e-06,1,2.2780963315814773e-06,0,0
15334,1-800-fl-help-1,1,1.8364528545823171e-06,1,2.2780963315814773e-06,0,0
15337,payer,1,1.8364528545823171e-06,1,2.2780963315814773e-06,0,0
15336,curse,1,1.8364528545823171e-06,1,2.2780963315814773e-06,0,0
15343,haunt,1,1.8364528545823171e-06,1,2.2780963315814773e-06,0,0
15344,hillarythey,1,1.8364528545823171e-06,1,2.2780963315814773e-06,0,0
15350,najib,1,1.8364528545823171e-06,1,2.2780963315814773e-06,0,0
15348,abdul,1,1.8364528545823171e-06,1,2.2780963315814773e-06,0,0
15351,razak,1,1.8364528545823171e-06,1,2.2780963315814773e-06,0,0
15349,malaysia,1,1.8364528545823171e-06,1,2.2780963315814773e-06,0,0
15353,luke,1,1.8364528545823171e-06,1,2.2780963315814773e-06,0,0
15354,locationsthan,1,1.8364528545823171e-06,1,2.2780963315814773e-06,0,0
15357,#neverforget911,1,1.8364528545823171e-06,1,2.2780963315814773e-06,0,0
15358,@flgovscottif,1,1.8364528545823171e-06,1,2.2780963315814773e-06,0,0
15360,sheltertheres,1,1.8364528545823171e-06,1,2.2780963315814773e-06,0,0
15363,florida-,1,1.8364528545823171e-06,1,2.2780963315814773e-06,0,0
15365,#irmahurricane2017🎥,1,1.8364528545823171e-06,1,2.2780963315814773e-06,0,0
15367,reformtax,1,1.8364528545823171e-06,1,2.2780963315814773e-06,0,0
15368,repub,1,1.8364528545823171e-06,1,2.2780963315814773e-06,0,0
15370,wayif,1,1.8364528545823171e-06,1,2.2780963315814773e-06,0,0
15371,#oneamericaappeal,1,1.8364528545823171e-06,1,2.2780963315814773e-06,0,0
15372,#hurricaneirma,1,1.8364528545823171e-06,1,2.2780963315814773e-06,0,0
15379,sabah,1,1.8364528545823171e-06,1,2.2780963315814773e-06,0,0
15374,al-ahmed,1,1.8364528545823171e-06,1,2.2780963315814773e-06,0,0
15375,al-jaber,1,1.8364528545823171e-06,1,2.2780963315814773e-06,0,0
15376,al-sabah,1,1.8364528545823171e-06,1,2.2780963315814773e-06,0,0
15380,re-establish,1,1.8364528545823171e-06,1,2.2780963315814773e-06,0,0
15386,mandan,1,1.8364528545823171e-06,1,2.2780963315814773e-06,0,0
15387,nd,1,1.8364528545823171e-06,1,2.2780963315814773e-06,0,0
15382,@dougburgum,1,1.8364528545823171e-06,1,2.2780963315814773e-06,0,0
15381,@brentsanfordnd,1,1.8364528545823171e-06,1,2.2780963315814773e-06,0,0
15384,@senatorheitkamp,1,1.8364528545823171e-06,1,2.2780963315814773e-06,0,0
15388,andeavor,1,1.8364528545823171e-06,1,2.2780963315814773e-06,0,0
15389,refinery,1,1.8364528545823171e-06,1,2.2780963315814773e-06,0,0
15390,rosselló,1,1.8364528545823171e-06,1,2.2780963315814773e-06,0,0
15391,declarations➡️,1,1.8364528545823171e-06,1,2.2780963315814773e-06,0,0
15392,weary,1,1.8364528545823171e-06,1,2.2780963315814773e-06,0,0
15393,legalize,1,1.8364528545823171e-06,1,2.2780963315814773e-06,0,0
15394,revisit,1,1.8364528545823171e-06,1,2.2780963315814773e-06,0,0
15396,appeasement,1,1.8364528545823171e-06,1,2.2780963315814773e-06,0,0
15400,hereos,1,1.8364528545823171e-06,1,2.2780963315814773e-06,0,0
15399,@nationalguard,1,1.8364528545823171e-06,1,2.2780963315814773e-06,0,0
15398,#leos,1,1.8364528545823171e-06,1,2.2780963315814773e-06,0,0
15402,yougod,1,1.8364528545823171e-06,1,2.2780963315814773e-06,0,0
15403,#southernbaptist,1,1.8364528545823171e-06,1,2.2780963315814773e-06,0,0
15405,@sendrelief,1,1.8364528545823171e-06,1,2.2780963315814773e-06,0,0
15404,@salvationarmyus,1,1.8364528545823171e-06,1,2.2780963315814773e-06,0,0
15407,#prayfortexas,1,1.8364528545823171e-06,1,2.2780963315814773e-06,0,0
15408,overand,1,1.8364528545823171e-06,1,2.2780963315814773e-06,0,0
15409,heeling,1,1.8364528545823171e-06,1,2.2780963315814773e-06,0,0
15410,#texasstrong,1,1.8364528545823171e-06,1,2.2780963315814773e-06,0,0
15412,ferocious,1,1.8364528545823171e-06,1,2.2780963315814773e-06,0,0
15413,harveymy,1,1.8364528545823171e-06,1,2.2780963315814773e-06,0,0
15416,nationfull,1,1.8364528545823171e-06,1,2.2780963315814773e-06,0,0
15418,incrediblethanks,1,1.8364528545823171e-06,1,2.2780963315814773e-06,0,0
15421,canadaboth,1,1.8364528545823171e-06,1,2.2780963315814773e-06,0,0
15422,difficultmay,1,1.8364528545823171e-06,1,2.2780963315814773e-06,0,0
15424,reimbursementother,1,1.8364528545823171e-06,1,2.2780963315814773e-06,0,0
15425,cm,1,1.8364528545823171e-06,1,2.2780963315814773e-06,0,0
15427,stormhurricane,1,1.8364528545823171e-06,1,2.2780963315814773e-06,0,0
15428,rains,1,1.8364528545823171e-06,1,2.2780963315814773e-06,0,0
15429,govs,1,1.8364528545823171e-06,1,2.2780963315814773e-06,0,0
15430,arpaio,1,1.8364528545823171e-06,1,2.2780963315814773e-06,0,0
15436,elaine,1,1.8364528545823171e-06,1,2.2780963315814773e-06,0,0
15435,@tombossert45,1,1.8364528545823171e-06,1,2.2780963315814773e-06,0,0
15437,retaking,1,1.8364528545823171e-06,1,2.2780963315814773e-06,0,0
15440,staes,1,1.8364528545823171e-06,1,2.2780963315814773e-06,0,0
15442,intensifies,1,1.8364528545823171e-06,1,2.2780963315814773e-06,0,0
15441,#planahead,1,1.8364528545823171e-06,1,2.2780963315814773e-06,0,0
15445,failedthat,1,1.8364528545823171e-06,1,2.2780963315814773e-06,0,0
15449,strongto,1,1.8364528545823171e-06,1,2.2780963315814773e-06,0,0
15450,easy-now,1,1.8364528545823171e-06,1,2.2780963315814773e-06,0,0
15452,ballard,1,1.8364528545823171e-06,1,2.2780963315814773e-06,0,0
15453,@americanlegion,1,1.8364528545823171e-06,1,2.2780963315814773e-06,0,0
15454,@secshulkin🎥,1,1.8364528545823171e-06,1,2.2780963315814773e-06,0,0
15458,#phoenixrally,1,1.8364528545823171e-06,1,2.2780963315814773e-06,0,0
15461,onward,1,1.8364528545823171e-06,1,2.2780963315814773e-06,0,0
15462,whope,1,1.8364528545823171e-06,1,2.2780963315814773e-06,0,0
15463,#maga🇺🇸tickets,1,1.8364528545823171e-06,1,2.2780963315814773e-06,0,0
15465,falwell,1,1.8364528545823171e-06,1,2.2780963315814773e-06,0,0
15468,@martywalsh,1,1.8364528545823171e-06,1,2.2780963315814773e-06,0,0
15469,@breitbartnewsmaybe,1,1.8364528545823171e-06,1,2.2780963315814773e-06,0,0
15473,sung,1,1.8364528545823171e-06,1,2.2780963315814773e-06,0,0
15472,hyun,1,1.8364528545823171e-06,1,2.2780963315814773e-06,0,0
15474,@kissimmeepolice,1,1.8364528545823171e-06,1,2.2780963315814773e-06,0,0
15475,#hr873,1,1.8364528545823171e-06,1,2.2780963315814773e-06,0,0
15476,authorizescont➡️,1,1.8364528545823171e-06,1,2.2780963315814773e-06,0,0
15477,combatant,1,1.8364528545823171e-06,1,2.2780963315814773e-06,0,0
15478,oncont,1,1.8364528545823171e-06,1,2.2780963315814773e-06,0,0
15479,pershing,1,1.8364528545823171e-06,1,2.2780963315814773e-06,0,0
15480,barcelona,1,1.8364528545823171e-06,1,2.2780963315814773e-06,0,0
15482,comparably,1,1.8364528545823171e-06,1,2.2780963315814773e-06,0,0
15483,stonewall,1,1.8364528545823171e-06,1,2.2780963315814773e-06,0,0
15484,kelli,1,1.8364528545823171e-06,1,2.2780963315814773e-06,0,0
15485,non-factor,1,1.8364528545823171e-06,1,2.2780963315814773e-06,0,0
15487,misrepresent,1,1.8364528545823171e-06,1,2.2780963315814773e-06,0,0
15489,trouncingthe,1,1.8364528545823171e-06,1,2.2780963315814773e-06,0,0
15490,equivalency,1,1.8364528545823171e-06,1,2.2780963315814773e-06,0,0
15491,kkk,1,1.8364528545823171e-06,1,2.2780963315814773e-06,0,0
15492,neo-nazis,1,1.8364528545823171e-06,1,2.2780963315814773e-06,0,0
15493,supremacists,1,1.8364528545823171e-06,1,2.2780963315814773e-06,0,0
15494,@mayorgimenez,1,1.8364528545823171e-06,1,2.2780963315814773e-06,0,0
15495,22nd,1,1.8364528545823171e-06,1,2.2780963315814773e-06,0,0
15496,colmery,1,1.8364528545823171e-06,1,2.2780963315814773e-06,0,0
15497,educational,1,1.8364528545823171e-06,1,2.2780963315814773e-06,0,0
15498,businesspeople,1,1.8364528545823171e-06,1,2.2780963315814773e-06,0,0
15501,grandstanders,1,1.8364528545823171e-06,1,2.2780963315814773e-06,0,0
15502,satisfiedtruly,1,1.8364528545823171e-06,1,2.2780963315814773e-06,0,0
15504,@merck,1,1.8364528545823171e-06,1,2.2780963315814773e-06,0,0
15506,frazier,1,1.8364528545823171e-06,1,2.2780963315814773e-06,0,0
15505,councilhe,1,1.8364528545823171e-06,1,2.2780963315814773e-06,0,0
15510,#charlottesville,1,1.8364528545823171e-06,1,2.2780963315814773e-06,0,0
15511,better-but,1,1.8364528545823171e-06,1,2.2780963315814773e-06,0,0
15513,placelocked,1,1.8364528545823171e-06,1,2.2780963315814773e-06,0,0
15512,loadedshould,1,1.8364528545823171e-06,1,2.2780963315814773e-06,0,0
15514,unwisely,1,1.8364528545823171e-06,1,2.2780963315814773e-06,0,0
15515,rebounds,1,1.8364528545823171e-06,1,2.2780963315814773e-06,0,0
15516,#ges2017,1,1.8364528545823171e-06,1,2.2780963315814773e-06,0,0
15519,excessive,1,1.8364528545823171e-06,1,2.2780963315814773e-06,0,0
15520,renovate,1,1.8364528545823171e-06,1,2.2780963315814773e-06,0,0
15521,achievednot,1,1.8364528545823171e-06,1,2.2780963315814773e-06,0,0
15522,amazonwashingtonpost,1,1.8364528545823171e-06,1,2.2780963315814773e-06,0,0
15524,failingnewyorktimes,1,1.8364528545823171e-06,1,2.2780963315814773e-06,0,0
15523,clintonlynch,1,1.8364528545823171e-06,1,2.2780963315814773e-06,0,0
15526,failurecountries,1,1.8364528545823171e-06,1,2.2780963315814773e-06,0,0
15528,#purpleheartday💜i,1,1.8364528545823171e-06,1,2.2780963315814773e-06,0,0
15534,securityisis,1,1.8364528545823171e-06,1,2.2780963315814773e-06,0,0
15535,nk,1,1.8364528545823171e-06,1,2.2780963315814773e-06,0,0
15536,sanction,1,1.8364528545823171e-06,1,2.2780963315814773e-06,0,0
15537,#isis,1,1.8364528545823171e-06,1,2.2780963315814773e-06,0,0
15538,accelerated,1,1.8364528545823171e-06,1,2.2780963315814773e-06,0,0
15540,wstate,1,1.8364528545823171e-06,1,2.2780963315814773e-06,0,0
15539,preparedness,1,1.8364528545823171e-06,1,2.2780963315814773e-06,0,0
15541,#cg227🇺🇸,1,1.8364528545823171e-06,1,2.2780963315814773e-06,0,0
15542,wowdem,1,1.8364528545823171e-06,1,2.2780963315814773e-06,0,0
15544,highand,1,1.8364528545823171e-06,1,2.2780963315814773e-06,0,0
15543,busting,1,1.8364528545823171e-06,1,2.2780963315814773e-06,0,0
15546,plantplants,1,1.8364528545823171e-06,1,2.2780963315814773e-06,0,0
15547,16b,1,1.8364528545823171e-06,1,2.2780963315814773e-06,0,0
15548,4k,1,1.8364528545823171e-06,1,2.2780963315814773e-06,0,0
15553,#vavideoconnect,1,1.8364528545823171e-06,1,2.2780963315814773e-06,0,0
15554,#makeamericagreatagain🇺🇸tickets,1,1.8364528545823171e-06,1,2.2780963315814773e-06,0,0
15555,#raiseact,1,1.8364528545823171e-06,1,2.2780963315814773e-06,0,0
15559,rust,1,1.8364528545823171e-06,1,2.2780963315814773e-06,0,0
15557,belt,1,1.8364528545823171e-06,1,2.2780963315814773e-06,0,0
15558,heros,1,1.8364528545823171e-06,1,2.2780963315814773e-06,0,0
15560,futureread,1,1.8364528545823171e-06,1,2.2780963315814773e-06,0,0
15561,roarwatch,1,1.8364528545823171e-06,1,2.2780963315814773e-06,0,0
15564,replaceand,1,1.8364528545823171e-06,1,2.2780963315814773e-06,0,0
15563,nuke,1,1.8364528545823171e-06,1,2.2780963315814773e-06,0,0
15565,instrumental,1,1.8364528545823171e-06,1,2.2780963315814773e-06,0,0
15566,quitters,1,1.8364528545823171e-06,1,2.2780963315814773e-06,0,0
15569,generalsecretary,1,1.8364528545823171e-06,1,2.2780963315814773e-06,0,0
15570,eradicated,1,1.8364528545823171e-06,1,2.2780963315814773e-06,0,0
15571,#lesmharrisburg,1,1.8364528545823171e-06,1,2.2780963315814773e-06,0,0
15573,implode,1,1.8364528545823171e-06,1,2.2780963315814773e-06,0,0
15579,shine,1,1.8364528545823171e-06,1,2.2780963315814773e-06,0,0
15580,13k,1,1.8364528545823171e-06,1,2.2780963315814773e-06,0,0
15581,madeintheusa🇺🇸,1,1.8364528545823171e-06,1,2.2780963315814773e-06,0,0
15583,god🎥,1,1.8364528545823171e-06,1,2.2780963315814773e-06,0,0
15584,burdened,1,1.8364528545823171e-06,1,2.2780963315814773e-06,0,0
15585,entail,1,1.8364528545823171e-06,1,2.2780963315814773e-06,0,0
15588,amvets,1,1.8364528545823171e-06,1,2.2780963315814773e-06,0,0
15590,#makeamericagreatagain🇺🇸🎥,1,1.8364528545823171e-06,1,2.2780963315814773e-06,0,0
15591,@senjohnmccain-thank,1,1.8364528545823171e-06,1,2.2780963315814773e-06,0,0
15592,grt,1,1.8364528545823171e-06,1,2.2780963315814773e-06,0,0
15595,saad,1,1.8364528545823171e-06,1,2.2780963315814773e-06,0,0
15593,hariri,1,1.8364528545823171e-06,1,2.2780963315814773e-06,0,0
15594,live➡️,1,1.8364528545823171e-06,1,2.2780963315814773e-06,0,0
15596,healthcarethe,1,1.8364528545823171e-06,1,2.2780963315814773e-06,0,0
15603,torturing,1,1.8364528545823171e-06,1,2.2780963315814773e-06,0,0
15602,peoplethe,1,1.8364528545823171e-06,1,2.2780963315814773e-06,0,0
15606,no-tax,1,1.8364528545823171e-06,1,2.2780963315814773e-06,0,0
15607,rebels,1,1.8364528545823171e-06,1,2.2780963315814773e-06,0,0
15609,#2017jambo-,1,1.8364528545823171e-06,1,2.2780963315814773e-06,0,0
15610,#ocarenightmare,1,1.8364528545823171e-06,1,2.2780963315814773e-06,0,0
15616,beleaguered,1,1.8364528545823171e-06,1,2.2780963315814773e-06,0,0
15617,ourselvesnot,1,1.8364528545823171e-06,1,2.2780963315814773e-06,0,0
15618,sewer,1,1.8364528545823171e-06,1,2.2780963315814773e-06,0,0
15620,screg,1,1.8364528545823171e-06,1,2.2780963315814773e-06,0,0
15619,cuttingstock,1,1.8364528545823171e-06,1,2.2780963315814773e-06,0,0
15621,repercussions,1,1.8364528545823171e-06,1,2.2780963315814773e-06,0,0
15622,storyopinion,1,1.8364528545823171e-06,1,2.2780963315814773e-06,0,0
15623,#ussgeraldrford☑️keep,1,1.8364528545823171e-06,1,2.2780963315814773e-06,0,0
15628,watch🇺🇸☑️protect,1,1.8364528545823171e-06,1,2.2780963315814773e-06,0,0
15626,her🇺🇸☑️defend,1,1.8364528545823171e-06,1,2.2780963315814773e-06,0,0
15627,her🇺🇸☑️love,1,1.8364528545823171e-06,1,2.2780963315814773e-06,0,0
15625,her🇺🇸good,1,1.8364528545823171e-06,1,2.2780963315814773e-06,0,0
15632,ford➡️,1,1.8364528545823171e-06,1,2.2780963315814773e-06,0,0
15635,usfake,1,1.8364528545823171e-06,1,2.2780963315814773e-06,0,0
15637,terroristal-baghdaditheir,1,1.8364528545823171e-06,1,2.2780963315814773e-06,0,0
15638,postthis,1,1.8364528545823171e-06,1,2.2780963315814773e-06,0,0
15639,sessionsthese,1,1.8364528545823171e-06,1,2.2780963315814773e-06,0,0
15640,#honorthem🇺🇸remarks,1,1.8364528545823171e-06,1,2.2780963315814773e-06,0,0
15644,icymi-,1,1.8364528545823171e-06,1,2.2780963315814773e-06,0,0
15649,growth📈that,1,1.8364528545823171e-06,1,2.2780963315814773e-06,0,0
15647,america🇺🇸four,1,1.8364528545823171e-06,1,2.2780963315814773e-06,0,0
15648,dollars💰richer,1,1.8364528545823171e-06,1,2.2780963315814773e-06,0,0
15645,-stuart,1,1.8364528545823171e-06,1,2.2780963315814773e-06,0,0
15646,@varneyco🎥,1,1.8364528545823171e-06,1,2.2780963315814773e-06,0,0
15650,#madeinamerica🇺🇸📸,1,1.8364528545823171e-06,1,2.2780963315814773e-06,0,0
15651,corning,1,1.8364528545823171e-06,1,2.2780963315814773e-06,0,0
15653,lunchtimethe,1,1.8364528545823171e-06,1,2.2780963315814773e-06,0,0
15655,slate,1,1.8364528545823171e-06,1,2.2780963315814773e-06,0,0
15657,co-leading,1,1.8364528545823171e-06,1,2.2780963315814773e-06,0,0
15658,#ussjohnfinn,1,1.8364528545823171e-06,1,2.2780963315814773e-06,0,0
15659,capabilities,1,1.8364528545823171e-06,1,2.2780963315814773e-06,0,0
15661,caputo,1,1.8364528545823171e-06,1,2.2780963315814773e-06,0,0
15662,out-numbered,1,1.8364528545823171e-06,1,2.2780963315814773e-06,0,0
15664,hillaryclinton,1,1.8364528545823171e-06,1,2.2780963315814773e-06,0,0
15665,great-should,1,1.8364528545823171e-06,1,2.2780963315814773e-06,0,0
15666,#14juillet,1,1.8364528545823171e-06,1,2.2780963315814773e-06,0,0
15670,mourns,1,1.8364528545823171e-06,1,2.2780963315814773e-06,0,0
15672,thru,1,1.8364528545823171e-06,1,2.2780963315814773e-06,0,0
15674,impt,1,1.8364528545823171e-06,1,2.2780963315814773e-06,0,0
15673,7yrs,1,1.8364528545823171e-06,1,2.2780963315814773e-06,0,0
15675,eiffel,1,1.8364528545823171e-06,1,2.2780963315814773e-06,0,0
15678,élysée,1,1.8364528545823171e-06,1,2.2780963315814773e-06,0,0
15677,palace,1,1.8364528545823171e-06,1,2.2780963315814773e-06,0,0
15680,les,1,1.8364528545823171e-06,1,2.2780963315814773e-06,0,0
15679,invalides,1,1.8364528545823171e-06,1,2.2780963315814773e-06,0,0
15681,@usembassyfrance,1,1.8364528545823171e-06,1,2.2780963315814773e-06,0,0
15683,bastille,1,1.8364528545823171e-06,1,2.2780963315814773e-06,0,0
15682,100yrs,1,1.8364528545823171e-06,1,2.2780963315814773e-06,0,0
15688,willfully,1,1.8364528545823171e-06,1,2.2780963315814773e-06,0,0
15690,197,1,1.8364528545823171e-06,1,2.2780963315814773e-06,0,0
15691,motheras,1,1.8364528545823171e-06,1,2.2780963315814773e-06,0,0
15693,cant-but,1,1.8364528545823171e-06,1,2.2780963315814773e-06,0,0
15692,can&,1,1.8364528545823171e-06,1,2.2780963315814773e-06,0,0
15695,guarded,1,1.8364528545823171e-06,1,2.2780963315814773e-06,0,0
15696,constructively,1,1.8364528545823171e-06,1,2.2780963315814773e-06,0,0
15697,vehemently,1,1.8364528545823171e-06,1,2.2780963315814773e-06,0,0
15700,@polizeihamburg,1,1.8364528545823171e-06,1,2.2780963315814773e-06,0,0
15707,shoulder-to-shoulder,1,1.8364528545823171e-06,1,2.2780963315814773e-06,0,0
15710,poland🇺🇸🇵🇱,1,1.8364528545823171e-06,1,2.2780963315814773e-06,0,0
15709,here➡️,1,1.8364528545823171e-06,1,2.2780963315814773e-06,0,0
15712,usss,1,1.8364528545823171e-06,1,2.2780963315814773e-06,0,0
15711,152nd,1,1.8364528545823171e-06,1,2.2780963315814773e-06,0,0
15713,historywhy,1,1.8364528545823171e-06,1,2.2780963315814773e-06,0,0
15715,#july4,1,1.8364528545823171e-06,1,2.2780963315814773e-06,0,0
15716,intraday,1,1.8364528545823171e-06,1,2.2780963315814773e-06,0,0
15717,#charliegard,1,1.8364528545823171e-06,1,2.2780963315814773e-06,0,0
15719,overcoming,1,1.8364528545823171e-06,1,2.2780963315814773e-06,0,0
15721,bared,1,1.8364528545823171e-06,1,2.2780963315814773e-06,0,0
15722,evangelic,1,1.8364528545823171e-06,1,2.2780963315814773e-06,0,0
15723,#prouddeplorable,1,1.8364528545823171e-06,1,2.2780963315814773e-06,0,0
15725,#nosanctuaryforcriminalsactstatement,1,1.8364528545823171e-06,1,2.2780963315814773e-06,0,0
15726,@greta,1,1.8364528545823171e-06,1,2.2780963315814773e-06,0,0
15727,susteren,1,1.8364528545823171e-06,1,2.2780963315814773e-06,0,0
15728,#canada150,1,1.8364528545823171e-06,1,2.2780963315814773e-06,0,0
15732,moons,1,1.8364528545823171e-06,1,2.2780963315814773e-06,0,0
15730,assurances,1,1.8364528545823171e-06,1,2.2780963315814773e-06,0,0
15734,enquirer,1,1.8364528545823171e-06,1,2.2780963315814773e-06,0,0
15735,1714,1,1.8364528545823171e-06,1,2.2780963315814773e-06,0,0
15739,ene,1,1.8364528545823171e-06,1,2.2780963315814773e-06,0,0
15741,@epascottpruitt,1,1.8364528545823171e-06,1,2.2780963315814773e-06,0,0
15740,#unleashingamericanenergy,1,1.8364528545823171e-06,1,2.2780963315814773e-06,0,0
15743,#saveamericanlives,1,1.8364528545823171e-06,1,2.2780963315814773e-06,0,0
15744,bills☑️,1,1.8364528545823171e-06,1,2.2780963315814773e-06,0,0
15745,☑️pass,1,1.8364528545823171e-06,1,2.2780963315814773e-06,0,0
15746,face-lift,1,1.8364528545823171e-06,1,2.2780963315814773e-06,0,0
15747,sugar,1,1.8364528545823171e-06,1,2.2780963315814773e-06,0,0
15748,misstated,1,1.8364528545823171e-06,1,2.2780963315814773e-06,0,0
15749,@cubs,1,1.8364528545823171e-06,1,2.2780963315814773e-06,0,0
15750,⚾️,1,1.8364528545823171e-06,1,2.2780963315814773e-06,0,0
15752,#amazonwashingtonpost,1,1.8364528545823171e-06,1,2.2780963315814773e-06,0,0
15753,guardian,1,1.8364528545823171e-06,1,2.2780963315814773e-06,0,0
15754,handels,1,1.8364528545823171e-06,1,2.2780963315814773e-06,0,0
15757,9-o,1,1.8364528545823171e-06,1,2.2780963315814773e-06,0,0
15759,magnifying,1,1.8364528545823171e-06,1,2.2780963315814773e-06,0,0
15761,choke,1,1.8364528545823171e-06,1,2.2780963315814773e-06,0,0
15763,complainthey,1,1.8364528545823171e-06,1,2.2780963315814773e-06,0,0
15764,#vaaccountability,1,1.8364528545823171e-06,1,2.2780963315814773e-06,0,0
15766,picnic,1,1.8364528545823171e-06,1,2.2780963315814773e-06,0,0
15765,@marineband,1,1.8364528545823171e-06,1,2.2780963315814773e-06,0,0
15767,#healthcarebill,1,1.8364528545823171e-06,1,2.2780963315814773e-06,0,0
15768,deadliest,1,1.8364528545823171e-06,1,2.2780963315814773e-06,0,0
15771,intercepts,1,1.8364528545823171e-06,1,2.2780963315814773e-06,0,0
15776,kirkwood,1,1.8364528545823171e-06,1,2.2780963315814773e-06,0,0
15775,cellular,1,1.8364528545823171e-06,1,2.2780963315814773e-06,0,0
15778,healthcaretax,1,1.8364528545823171e-06,1,2.2780963315814773e-06,0,0
15777,cutssecurity,1,1.8364528545823171e-06,1,2.2780963315814773e-06,0,0
15781,pence➡️,1,1.8364528545823171e-06,1,2.2780963315814773e-06,0,0
15782,brutality,1,1.8364528545823171e-06,1,2.2780963315814773e-06,0,0
15783,security-a,1,1.8364528545823171e-06,1,2.2780963315814773e-06,0,0
15784,@jcvarela,1,1.8364528545823171e-06,1,2.2780963315814773e-06,0,0
15787,varela,1,1.8364528545823171e-06,1,2.2780963315814773e-06,0,0
15785,afternoon🇺🇸🇵🇦➡️,1,1.8364528545823171e-06,1,2.2780963315814773e-06,0,0
15789,#voteralphnorman,1,1.8364528545823171e-06,1,2.2780963315814773e-06,0,0
15790,scs,1,1.8364528545823171e-06,1,2.2780963315814773e-06,0,0
15791,#ussfitzgerald,1,1.8364528545823171e-06,1,2.2780963315814773e-06,0,0
15792,securitytheir,1,1.8364528545823171e-06,1,2.2780963315814773e-06,0,0
15795,ratingthats,1,1.8364528545823171e-06,1,2.2780963315814773e-06,0,0
15796,scjustice,1,1.8364528545823171e-06,1,2.2780963315814773e-06,0,0
15799,cubanamerican,1,1.8364528545823171e-06,1,2.2780963315814773e-06,0,0
15800,cubamemorandum,1,1.8364528545823171e-06,1,2.2780963315814773e-06,0,0
15802,cubavideo,1,1.8364528545823171e-06,1,2.2780963315814773e-06,0,0
15803,#congressionalbaseballgame⚾️,1,1.8364528545823171e-06,1,2.2780963315814773e-06,0,0
15804,#workforceweek,1,1.8364528545823171e-06,1,2.2780963315814773e-06,0,0
15806,@wctc,1,1.8364528545823171e-06,1,2.2780963315814773e-06,0,0
15807,bleached,1,1.8364528545823171e-06,1,2.2780963315814773e-06,0,0
15809,wag,1,1.8364528545823171e-06,1,2.2780963315814773e-06,0,0
15808,cleared-,1,1.8364528545823171e-06,1,2.2780963315814773e-06,0,0
15810,non-dealings,1,1.8364528545823171e-06,1,2.2780963315814773e-06,0,0
15812,lo,1,1.8364528545823171e-06,1,2.2780963315814773e-06,0,0
15815,purposesgave,1,1.8364528545823171e-06,1,2.2780963315814773e-06,0,0
15819,tigersfull,1,1.8364528545823171e-06,1,2.2780963315814773e-06,0,0
15817,#nationalchampions🏈,1,1.8364528545823171e-06,1,2.2780963315814773e-06,0,0
15820,br,1,1.8364528545823171e-06,1,2.2780963315814773e-06,0,0
15821,#pulsenightclub,1,1.8364528545823171e-06,1,2.2780963315814773e-06,0,0
15822,up-,1,1.8364528545823171e-06,1,2.2780963315814773e-06,0,0
15823,#dow,1,1.8364528545823171e-06,1,2.2780963315814773e-06,0,0
15824,#nasdaq,1,1.8364528545823171e-06,1,2.2780963315814773e-06,0,0
15825,195,1,1.8364528545823171e-06,1,2.2780963315814773e-06,0,0
15827,#infrastructureweek,1,1.8364528545823171e-06,1,2.2780963315814773e-06,0,0
15831,hensarling,1,1.8364528545823171e-06,1,2.2780963315814773e-06,0,0
15830,dodd-frank,1,1.8364528545823171e-06,1,2.2780963315814773e-06,0,0
15832,vindicationand,1,1.8364528545823171e-06,1,2.2780963315814773e-06,0,0
15834,substandard,1,1.8364528545823171e-06,1,2.2780963315814773e-06,0,0
15835,watch➡️,1,1.8364528545823171e-06,1,2.2780963315814773e-06,0,0
15836,@whitehouse➡️,1,1.8364528545823171e-06,1,2.2780963315814773e-06,0,0
15838,73,1,1.8364528545823171e-06,1,2.2780963315814773e-06,0,0
15841,washpost,1,1.8364528545823171e-06,1,2.2780963315814773e-06,0,0
15842,unfiltered,1,1.8364528545823171e-06,1,2.2780963315814773e-06,0,0
15843,finally➡️,1,1.8364528545823171e-06,1,2.2780963315814773e-06,0,0
15844,@secshulkins,1,1.8364528545823171e-06,1,2.2780963315814773e-06,0,0
15849,knives,1,1.8364528545823171e-06,1,2.2780963315814773e-06,0,0
15850,#americafirst🇺🇸➡️,1,1.8364528545823171e-06,1,2.2780963315814773e-06,0,0
15851,nguyễn,1,1.8364528545823171e-06,1,2.2780963315814773e-06,0,0
15853,xuân,1,1.8364528545823171e-06,1,2.2780963315814773e-06,0,0
15852,phúc,1,1.8364528545823171e-06,1,2.2780963315814773e-06,0,0
15854,alliances,1,1.8364528545823171e-06,1,2.2780963315814773e-06,0,0
15858,missilebut,1,1.8364528545823171e-06,1,2.2780963315814773e-06,0,0
15860,disparaging,1,1.8364528545823171e-06,1,2.2780963315814773e-06,0,0
15862,exsist,1,1.8364528545823171e-06,1,2.2780963315814773e-06,0,0
15866,aluminum-,1,1.8364528545823171e-06,1,2.2780963315814773e-06,0,0
15868,trade-distorting,1,1.8364528545823171e-06,1,2.2780963315814773e-06,0,0
15867,practicesto,1,1.8364528545823171e-06,1,2.2780963315814773e-06,0,0
15870,in-,1,1.8364528545823171e-06,1,2.2780963315814773e-06,0,0
15871,#g7taormina,1,1.8364528545823171e-06,1,2.2780963315814773e-06,0,0
15872,mattarella,1,1.8364528545823171e-06,1,2.2780963315814773e-06,0,0
15874,civilization-,1,1.8364528545823171e-06,1,2.2780963315814773e-06,0,0
15875,evil➡️,1,1.8364528545823171e-06,1,2.2780963315814773e-06,0,0
15877,taormina,1,1.8364528545823171e-06,1,2.2780963315814773e-06,0,0
15880,#natomeeting,1,1.8364528545823171e-06,1,2.2780963315814773e-06,0,0
15882,peac,1,1.8364528545823171e-06,1,2.2780963315814773e-06,0,0
15884,#g7,1,1.8364528545823171e-06,1,2.2780963315814773e-06,0,0
15885,@presidentruvi,1,1.8364528545823171e-06,1,2.2780963315814773e-06,0,0
15886,@presidentruvi-,1,1.8364528545823171e-06,1,2.2780963315814773e-06,0,0
15887,#potusabroad🇺🇸,1,1.8364528545823171e-06,1,2.2780963315814773e-06,0,0
15890,states-,1,1.8364528545823171e-06,1,2.2780963315814773e-06,0,0
15891,riyadh,1,1.8364528545823171e-06,1,2.2780963315814773e-06,0,0
15894,5142017,1,1.8364528545823171e-06,1,2.2780963315814773e-06,0,0
15895,5202017,1,1.8364528545823171e-06,1,2.2780963315814773e-06,0,0
15893,#policeweekproclamation➡️,1,1.8364528545823171e-06,1,2.2780963315814773e-06,0,0
15898,santos,1,1.8364528545823171e-06,1,2.2780963315814773e-06,0,0
15899,today🇺🇸🇨🇴joint,1,1.8364528545823171e-06,1,2.2780963315814773e-06,0,0
15896,conf➡️,1,1.8364528545823171e-06,1,2.2780963315814773e-06,0,0
15901,#cgacommencement17,1,1.8364528545823171e-06,1,2.2780963315814773e-06,0,0
15902,@uscgacademy,1,1.8364528545823171e-06,1,2.2780963315814773e-06,0,0
15903,erdoğan,1,1.8364528545823171e-06,1,2.2780963315814773e-06,0,0
15906,#policeweek,1,1.8364528545823171e-06,1,2.2780963315814773e-06,0,0
15908,36th,1,1.8364528545823171e-06,1,2.2780963315814773e-06,0,0
15907,#nationalpoliceweekwatch,1,1.8364528545823171e-06,1,2.2780963315814773e-06,0,0
15909,#mothersday,1,1.8364528545823171e-06,1,2.2780963315814773e-06,0,0
15910,@libertyu,1,1.8364528545823171e-06,1,2.2780963315814773e-06,0,0
15914,welcomed,1,1.8364528545823171e-06,1,2.2780963315814773e-06,0,0
15913,rocketry,1,1.8364528545823171e-06,1,2.2780963315814773e-06,0,0
15911,#tarc,1,1.8364528545823171e-06,1,2.2780963315814773e-06,0,0
15915,hel,1,1.8364528545823171e-06,1,2.2780963315814773e-06,0,0
15916,surrogates,1,1.8364528545823171e-06,1,2.2780963315814773e-06,0,0
15917,day-,1,1.8364528545823171e-06,1,2.2780963315814773e-06,0,0
15921,sergei,1,1.8364528545823171e-06,1,2.2780963315814773e-06,0,0
15918,fm,1,1.8364528545823171e-06,1,2.2780963315814773e-06,0,0
15920,pavlo,1,1.8364528545823171e-06,1,2.2780963315814773e-06,0,0
15922,rosie,1,1.8364528545823171e-06,1,2.2780963315814773e-06,0,0
15923,integrity➡️,1,1.8364528545823171e-06,1,2.2780963315814773e-06,0,0
15924,aggrieved,1,1.8364528545823171e-06,1,2.2780963315814773e-06,0,0
15926,forgivenessand,1,1.8364528545823171e-06,1,2.2780963315814773e-06,0,0
15929,richie,1,1.8364528545823171e-06,1,2.2780963315814773e-06,0,0
15927,devised,1,1.8364528545823171e-06,1,2.2780963315814773e-06,0,0
15934,reiterated,1,1.8364528545823171e-06,1,2.2780963315814773e-06,0,0
15933,knows-,1,1.8364528545823171e-06,1,2.2780963315814773e-06,0,0
15935,giorgi,1,1.8364528545823171e-06,1,2.2780963315814773e-06,0,0
15936,kvirikashvili,1,1.8364528545823171e-06,1,2.2780963315814773e-06,0,0
15938,@pgajohndaly,1,1.8364528545823171e-06,1,2.2780963315814773e-06,0,0
15939,rexnord,1,1.8364528545823171e-06,1,2.2780963315814773e-06,0,0
15941,disruptive,1,1.8364528545823171e-06,1,2.2780963315814773e-06,0,0
15943,wowthe,1,1.8364528545823171e-06,1,2.2780963315814773e-06,0,0
15942,possiblefar,1,1.8364528545823171e-06,1,2.2780963315814773e-06,0,0
15945,australians,1,1.8364528545823171e-06,1,2.2780963315814773e-06,0,0
15944,--everybody,1,1.8364528545823171e-06,1,2.2780963315814773e-06,0,0
15946,inclusion,1,1.8364528545823171e-06,1,2.2780963315814773e-06,0,0
15949,victorious,1,1.8364528545823171e-06,1,2.2780963315814773e-06,0,0
15952,spiralaetna,1,1.8364528545823171e-06,1,2.2780963315814773e-06,0,0
15951,indv,1,1.8364528545823171e-06,1,2.2780963315814773e-06,0,0
15954,subcommittee,1,1.8364528545823171e-06,1,2.2780963315814773e-06,0,0
15955,mahmoud,1,1.8364528545823171e-06,1,2.2780963315814773e-06,0,0
15957,justification,1,1.8364528545823171e-06,1,2.2780963315814773e-06,0,0
15959,falcons,1,1.8364528545823171e-06,1,2.2780963315814773e-06,0,0
15962,eos,1,1.8364528545823171e-06,1,2.2780963315814773e-06,0,0
15960,countryeo1,1,1.8364528545823171e-06,1,2.2780963315814773e-06,0,0
15961,eo2,1,1.8364528545823171e-06,1,2.2780963315814773e-06,0,0
15963,islanders,1,1.8364528545823171e-06,1,2.2780963315814773e-06,0,0
15964,donorsnew,1,1.8364528545823171e-06,1,2.2780963315814773e-06,0,0
15965,obstructionthey,1,1.8364528545823171e-06,1,2.2780963315814773e-06,0,0
15967,signings,1,1.8364528545823171e-06,1,2.2780963315814773e-06,0,0
15971,juliana,1,1.8364528545823171e-06,1,2.2780963315814773e-06,0,0
15970,awada,1,1.8364528545823171e-06,1,2.2780963315814773e-06,0,0
15973,jeopardizing,1,1.8364528545823171e-06,1,2.2780963315814773e-06,0,0
15974,good-deal,1,1.8364528545823171e-06,1,2.2780963315814773e-06,0,0
15976,fro,1,1.8364528545823171e-06,1,2.2780963315814773e-06,0,0
15978,prohibitions,1,1.8364528545823171e-06,1,2.2780963315814773e-06,0,0
15980,antiquities,1,1.8364528545823171e-06,1,2.2780963315814773e-06,0,0
15982,cities-both,1,1.8364528545823171e-06,1,2.2780963315814773e-06,0,0
15983,americaexecutive,1,1.8364528545823171e-06,1,2.2780963315814773e-06,0,0
15984,museums,1,1.8364528545823171e-06,1,2.2780963315814773e-06,0,0
15985,w20,1,1.8364528545823171e-06,1,2.2780963315814773e-06,0,0
15986,tumbling,1,1.8364528545823171e-06,1,2.2780963315814773e-06,0,0
15988,@astropeggy,1,1.8364528545823171e-06,1,2.2780963315814773e-06,0,0
15992,containing,1,1.8364528545823171e-06,1,2.2780963315814773e-06,0,0
15993,enhances,1,1.8364528545823171e-06,1,2.2780963315814773e-06,0,0
15999,sb,1,1.8364528545823171e-06,1,2.2780963315814773e-06,0,0
16001,identifying,1,1.8364528545823171e-06,1,2.2780963315814773e-06,0,0
16003,aya,1,1.8364528545823171e-06,1,2.2780963315814773e-06,0,0
16005,paolo,1,1.8364528545823171e-06,1,2.2780963315814773e-06,0,0
16004,gentiloni,1,1.8364528545823171e-06,1,2.2780963315814773e-06,0,0
16007,@patriots,1,1.8364528545823171e-06,1,2.2780963315814773e-06,0,0
16008,#s544,1,1.8364528545823171e-06,1,2.2780963315814773e-06,0,0
16009,#buyamericanhireamerican🇺🇸,1,1.8364528545823171e-06,1,2.2780963315814773e-06,0,0
16012,#buyamericanhireamerican🇺🇸watch➡️,1,1.8364528545823171e-06,1,2.2780963315814773e-06,0,0
16013,@ossoff,1,1.8364528545823171e-06,1,2.2780963315814773e-06,0,0
16014,taxes-very,1,1.8364528545823171e-06,1,2.2780963315814773e-06,0,0
16016,wisconsintrump,1,1.8364528545823171e-06,1,2.2780963315814773e-06,0,0
16017,congressioal,1,1.8364528545823171e-06,1,2.2780963315814773e-06,0,0
16018,knowles,1,1.8364528545823171e-06,1,2.2780963315814773e-06,0,0
16019,georgia-bad,1,1.8364528545823171e-06,1,2.2780963315814773e-06,0,0
16020,republican-easily,1,1.8364528545823171e-06,1,2.2780963315814773e-06,0,0
16021,manipulator,1,1.8364528545823171e-06,1,2.2780963315814773e-06,0,0
16022,atlantas,1,1.8364528545823171e-06,1,2.2780963315814773e-06,0,0
16023,senses,1,1.8364528545823171e-06,1,2.2780963315814773e-06,0,0
16028,menace,1,1.8364528545823171e-06,1,2.2780963315814773e-06,0,0
16030,#chagsameach,1,1.8364528545823171e-06,1,2.2780963315814773e-06,0,0
16031,americ,1,1.8364528545823171e-06,1,2.2780963315814773e-06,0,0
16034,runways,1,1.8364528545823171e-06,1,2.2780963315814773e-06,0,0
16035,goodwill,1,1.8364528545823171e-06,1,2.2780963315814773e-06,0,0
16036,#soldierridedc,1,1.8364528545823171e-06,1,2.2780963315814773e-06,0,0
16039,mcgarvey,1,1.8364528545823171e-06,1,2.2780963315814773e-06,0,0
16040,#ceotownhall➡️,1,1.8364528545823171e-06,1,2.2780963315814773e-06,0,0
16041,betwe,1,1.8364528545823171e-06,1,2.2780963315814773e-06,0,0
16042,al-sisi,1,1.8364528545823171e-06,1,2.2780963315814773e-06,0,0
16043,#liub,1,1.8364528545823171e-06,1,2.2780963315814773e-06,0,0
16044,@jclayfield,1,1.8364528545823171e-06,1,2.2780963315814773e-06,0,0
16045,unmasked,1,1.8364528545823171e-06,1,2.2780963315814773e-06,0,0
16048,#weeklyaddress,1,1.8364528545823171e-06,1,2.2780963315814773e-06,0,0
16049,condoleezza,1,1.8364528545823171e-06,1,2.2780963315814773e-06,0,0
16051,lars,1,1.8364528545823171e-06,1,2.2780963315814773e-06,0,0
16052,løkke,1,1.8364528545823171e-06,1,2.2780963315814773e-06,0,0
16050,@larsloekke,1,1.8364528545823171e-06,1,2.2780963315814773e-06,0,0
16053,enlisting,1,1.8364528545823171e-06,1,2.2780963315814773e-06,0,0
16056,raullabrador,1,1.8364528545823171e-06,1,2.2780963315814773e-06,0,0
16057,@repkenbuck,1,1.8364528545823171e-06,1,2.2780963315814773e-06,0,0
16059,#thankaveteran,1,1.8364528545823171e-06,1,2.2780963315814773e-06,0,0
16060,empowerment,1,1.8364528545823171e-06,1,2.2780963315814773e-06,0,0
16061,session➡️,1,1.8364528545823171e-06,1,2.2780963315814773e-06,0,0
16062,#madeintheusa🇺🇸watch,1,1.8364528545823171e-06,1,2.2780963315814773e-06,0,0
16064,folds,1,1.8364528545823171e-06,1,2.2780963315814773e-06,0,0
16066,snatch,1,1.8364528545823171e-06,1,2.2780963315814773e-06,0,0
16065,jaws,1,1.8364528545823171e-06,1,2.2780963315814773e-06,0,0
16068,20k,1,1.8364528545823171e-06,1,2.2780963315814773e-06,0,0
16069,#keystonepipeline,1,1.8364528545823171e-06,1,2.2780963315814773e-06,0,0
16070,grea,1,1.8364528545823171e-06,1,2.2780963315814773e-06,0,0
16071,irony,1,1.8364528545823171e-06,1,2.2780963315814773e-06,0,0
16072,pp,1,1.8364528545823171e-06,1,2.2780963315814773e-06,0,0
16073,skyrocketing,1,1.8364528545823171e-06,1,2.2780963315814773e-06,0,0
16074,trucking,1,1.8364528545823171e-06,1,2.2780963315814773e-06,0,0
16075,#ahca,1,1.8364528545823171e-06,1,2.2780963315814773e-06,0,0
16078,#nationalagday,1,1.8364528545823171e-06,1,2.2780963315814773e-06,0,0
16079,ingrained,1,1.8364528545823171e-06,1,2.2780963315814773e-06,0,0
16081,s442,1,1.8364528545823171e-06,1,2.2780963315814773e-06,0,0
16080,engineers,1,1.8364528545823171e-06,1,2.2780963315814773e-06,0,0
16082,kentucky-,1,1.8364528545823171e-06,1,2.2780963315814773e-06,0,0
16084,@republicanstudy,1,1.8364528545823171e-06,1,2.2780963315814773e-06,0,0
16088,lá,1,1.8364528545823171e-06,1,2.2780963315814773e-06,0,0
16086,fheile,1,1.8364528545823171e-06,1,2.2780963315814773e-06,0,0
16089,phadraig,1,1.8364528545823171e-06,1,2.2780963315814773e-06,0,0
16087,irish,1,1.8364528545823171e-06,1,2.2780963315814773e-06,0,0
16091,taoiseach,1,1.8364528545823171e-06,1,2.2780963315814773e-06,0,0
16090,@endakennytd,1,1.8364528545823171e-06,1,2.2780963315814773e-06,0,0
16093,prioritywithout,1,1.8364528545823171e-06,1,2.2780963315814773e-06,0,0
16094,#potus7,1,1.8364528545823171e-06,1,2.2780963315814773e-06,0,0
16095,@snoopdogg,1,1.8364528545823171e-06,1,2.2780963315814773e-06,0,0
16097,mailbox,1,1.8364528545823171e-06,1,2.2780963315814773e-06,0,0
16099,wiedefeld,1,1.8364528545823171e-06,1,2.2780963315814773e-06,0,0
16100,#readthebill,1,1.8364528545823171e-06,1,2.2780963315814773e-06,0,0
16101,#maga🇺🇸➡️,1,1.8364528545823171e-06,1,2.2780963315814773e-06,0,0
16102,@senateyouth,1,1.8364528545823171e-06,1,2.2780963315814773e-06,0,0
16104,linkedin,1,1.8364528545823171e-06,1,2.2780963315814773e-06,0,0
16105,fabric,1,1.8364528545823171e-06,1,2.2780963315814773e-06,0,0
16108,picked-off,1,1.8364528545823171e-06,1,2.2780963315814773e-06,0,0
16111,nowwere,1,1.8364528545823171e-06,1,2.2780963315814773e-06,0,0
16113,exxon,1,1.8364528545823171e-06,1,2.2780963315814773e-06,0,0
16114,mobil,1,1.8364528545823171e-06,1,2.2780963315814773e-06,0,0
16116,voluntarily,1,1.8364528545823171e-06,1,2.2780963315814773e-06,0,0
16118,tapp,1,1.8364528545823171e-06,1,2.2780963315814773e-06,0,0
16117,nixonwatergate,1,1.8364528545823171e-06,1,2.2780963315814773e-06,0,0
16122,wires,1,1.8364528545823171e-06,1,2.2780963315814773e-06,0,0
16121,tapped,1,1.8364528545823171e-06,1,2.2780963315814773e-06,0,0
16123,ambs,1,1.8364528545823171e-06,1,2.2780963315814773e-06,0,0
16124,hearby,1,1.8364528545823171e-06,1,2.2780963315814773e-06,0,0
16125,hypocrite,1,1.8364528545823171e-06,1,2.2780963315814773e-06,0,0
16126,addressjoin,1,1.8364528545823171e-06,1,2.2780963315814773e-06,0,0
16128,overplaying,1,1.8364528545823171e-06,1,2.2780963315814773e-06,0,0
16127,grip,1,1.8364528545823171e-06,1,2.2780963315814773e-06,0,0
16129,intentional,1,1.8364528545823171e-06,1,2.2780963315814773e-06,0,0
16130,#jointsession,1,1.8364528545823171e-06,1,2.2780963315814773e-06,0,0
16131,#jointaddress,1,1.8364528545823171e-06,1,2.2780963315814773e-06,0,0
16133,favorably,1,1.8364528545823171e-06,1,2.2780963315814773e-06,0,0
16132,@hotlinejosh,1,1.8364528545823171e-06,1,2.2780963315814773e-06,0,0
16134,peo,1,1.8364528545823171e-06,1,2.2780963315814773e-06,0,0
16139,permeated,1,1.8364528545823171e-06,1,2.2780963315814773e-06,0,0
16140,kravis,1,1.8364528545823171e-06,1,2.2780963315814773e-06,0,0
16143,smithsonians,1,1.8364528545823171e-06,1,2.2780963315814773e-06,0,0
16142,culturea,1,1.8364528545823171e-06,1,2.2780963315814773e-06,0,0
16144,agreeyet,1,1.8364528545823171e-06,1,2.2780963315814773e-06,0,0
16146,1100amwatch,1,1.8364528545823171e-06,1,2.2780963315814773e-06,0,0
16147,kellogg,1,1.8364528545823171e-06,1,2.2780963315814773e-06,0,0
16152,leopoldo,1,1.8364528545823171e-06,1,2.2780963315814773e-06,0,0
16151,@liliantintori,1,1.8364528545823171e-06,1,2.2780963315814773e-06,0,0
16154,aetna,1,1.8364528545823171e-06,1,2.2780963315814773e-06,0,0
16156,orlando-melbourne,1,1.8364528545823171e-06,1,2.2780963315814773e-06,0,0
16155,airporttickets,1,1.8364528545823171e-06,1,2.2780963315814773e-06,0,0
16158,@israelipm,1,1.8364528545823171e-06,1,2.2780963315814773e-06,0,0
16157,#icymi🇺🇸🇮🇱joint,1,1.8364528545823171e-06,1,2.2780963315814773e-06,0,0
16160,un-american,1,1.8364528545823171e-06,1,2.2780963315814773e-06,0,0
16161,fbishould,1,1.8364528545823171e-06,1,2.2780963315814773e-06,0,0
16162,politicsand,1,1.8364528545823171e-06,1,2.2780963315814773e-06,0,0
16163,fbijust,1,1.8364528545823171e-06,1,2.2780963315814773e-06,0,0
16166,non-sense,1,1.8364528545823171e-06,1,2.2780963315814773e-06,0,0
16165,cover-up,1,1.8364528545823171e-06,1,2.2780963315814773e-06,0,0
16167,humana,1,1.8364528545823171e-06,1,2.2780963315814773e-06,0,0
16170,parent-teacher,1,1.8364528545823171e-06,1,2.2780963315814773e-06,0,0
16169,@betsydevos,1,1.8364528545823171e-06,1,2.2780963315814773e-06,0,0
16171,nkorea,1,1.8364528545823171e-06,1,2.2780963315814773e-06,0,0
16172,#vasecretary,1,1.8364528545823171e-06,1,2.2780963315814773e-06,0,0
16173,shulkin,1,1.8364528545823171e-06,1,2.2780963315814773e-06,0,0
16175,canada🇨🇦and,1,1.8364528545823171e-06,1,2.2780963315814773e-06,0,0
16178,miller-,1,1.8364528545823171e-06,1,2.2780963315814773e-06,0,0
16179,big-time,1,1.8364528545823171e-06,1,2.2780963315814773e-06,0,0
16180,callshes,1,1.8364528545823171e-06,1,2.2780963315814773e-06,0,0
16181,-211,1,1.8364528545823171e-06,1,2.2780963315814773e-06,0,0
16185,playef,1,1.8364528545823171e-06,1,2.2780963315814773e-06,0,0
16186,fla,1,1.8364528545823171e-06,1,2.2780963315814773e-06,0,0
16188,fighterjet,1,1.8364528545823171e-06,1,2.2780963315814773e-06,0,0
16190,reprieve,1,1.8364528545823171e-06,1,2.2780963315814773e-06,0,0
16189,hail,1,1.8364528545823171e-06,1,2.2780963315814773e-06,0,0
16191,wt,1,1.8364528545823171e-06,1,2.2780963315814773e-06,0,0
16192,#marineone,1,1.8364528545823171e-06,1,2.2780963315814773e-06,0,0
16194,mrxi,1,1.8364528545823171e-06,1,2.2780963315814773e-06,0,0
16195,nov14,1,1.8364528545823171e-06,1,2.2780963315814773e-06,0,0
16198,lawfare,1,1.8364528545823171e-06,1,2.2780963315814773e-06,0,0
16199,remarkably,1,1.8364528545823171e-06,1,2.2780963315814773e-06,0,0
16201,@senatorsessionslive,1,1.8364528545823171e-06,1,2.2780963315814773e-06,0,0
16203,emboldens,1,1.8364528545823171e-06,1,2.2780963315814773e-06,0,0
16206,senrichard,1,1.8364528545823171e-06,1,2.2780963315814773e-06,0,0
16204,lienow,1,1.8364528545823171e-06,1,2.2780963315814773e-06,0,0
16205,misrepresents,1,1.8364528545823171e-06,1,2.2780963315814773e-06,0,0
16207,@senatorsessions,1,1.8364528545823171e-06,1,2.2780963315814773e-06,0,0
16208,trump-style,1,1.8364528545823171e-06,1,2.2780963315814773e-06,0,0
16210,krzanich,1,1.8364528545823171e-06,1,2.2780963315814773e-06,0,0
16209,@intel,1,1.8364528545823171e-06,1,2.2780963315814773e-06,0,0
16211,@nordstrom,1,1.8364528545823171e-06,1,2.2780963315814773e-06,0,0
16212,assoc,1,1.8364528545823171e-06,1,2.2780963315814773e-06,0,0
16213,serv,1,1.8364528545823171e-06,1,2.2780963315814773e-06,0,0
16214,#1in,1,1.8364528545823171e-06,1,2.2780963315814773e-06,0,0
16216,airs,1,1.8364528545823171e-06,1,2.2780963315814773e-06,0,0
16218,marginalize,1,1.8364528545823171e-06,1,2.2780963315814773e-06,0,0
16222,law-enforcement,1,1.8364528545823171e-06,1,2.2780963315814773e-06,0,0
16223,middle-eastern,1,1.8364528545823171e-06,1,2.2780963315814773e-06,0,0
16224,&security,1,1.8364528545823171e-06,1,2.2780963315814773e-06,0,0
16225,littlewe,1,1.8364528545823171e-06,1,2.2780963315814773e-06,0,0
16226,louvre,1,1.8364528545823171e-06,1,2.2780963315814773e-06,0,0
16228,crafted,1,1.8364528545823171e-06,1,2.2780963315814773e-06,0,0
16229,apprenticebut,1,1.8364528545823171e-06,1,2.2780963315814773e-06,0,0
16230,@samsung,1,1.8364528545823171e-06,1,2.2780963315814773e-06,0,0
16231,life-line,1,1.8364528545823171e-06,1,2.2780963315814773e-06,0,0
16232,missileshould,1,1.8364528545823171e-06,1,2.2780963315814773e-06,0,0
16234,uc,1,1.8364528545823171e-06,1,2.2780963315814773e-06,0,0
16233,berkeley,1,1.8364528545823171e-06,1,2.2780963315814773e-06,0,0
16236,mic,1,1.8364528545823171e-06,1,2.2780963315814773e-06,0,0
16235,mess-just,1,1.8364528545823171e-06,1,2.2780963315814773e-06,0,0
16238,dudes,1,1.8364528545823171e-06,1,2.2780963315814773e-06,0,0
16239,109,1,1.8364528545823171e-06,1,2.2780963315814773e-06,0,0
16240,outage,1,1.8364528545823171e-06,1,2.2780963315814773e-06,0,0
16243,energies,1,1.8364528545823171e-06,1,2.2780963315814773e-06,0,0
16244,iii,1,1.8364528545823171e-06,1,2.2780963315814773e-06,0,0
16247,challenger,1,1.8364528545823171e-06,1,2.2780963315814773e-06,0,0
16249,readersthey,1,1.8364528545823171e-06,1,2.2780963315814773e-06,0,0
16250,thr,1,1.8364528545823171e-06,1,2.2780963315814773e-06,0,0
16252,votestand,1,1.8364528545823171e-06,1,2.2780963315814773e-06,0,0
16251,phillips,1,1.8364528545823171e-06,1,2.2780963315814773e-06,0,0
16253,miami-dade,1,1.8364528545823171e-06,1,2.2780963315814773e-06,0,0
16254,1000pm,1,1.8364528545823171e-06,1,2.2780963315814773e-06,0,0
16255,@senmajleader,1,1.8364528545823171e-06,1,2.2780963315814773e-06,0,0
16257,muir,1,1.8364528545823171e-06,1,2.2780963315814773e-06,0,0
16259,@romoabcnews,1,1.8364528545823171e-06,1,2.2780963315814773e-06,0,0
16260,228,1,1.8364528545823171e-06,1,2.2780963315814773e-06,0,0
16262,displayed,1,1.8364528545823171e-06,1,2.2780963315814773e-06,0,0
16263,upperlower,1,1.8364528545823171e-06,1,2.2780963315814773e-06,0,0
16264,hallmark,1,1.8364528545823171e-06,1,2.2780963315814773e-06,0,0
16265,celebs,1,1.8364528545823171e-06,1,2.2780963315814773e-06,0,0
16266,dcthank,1,1.8364528545823171e-06,1,2.2780963315814773e-06,0,0
16267,again🇺🇸,1,1.8364528545823171e-06,1,2.2780963315814773e-06,0,0
16269,rulers,1,1.8364528545823171e-06,1,2.2780963315814773e-06,0,0
16271,swearing-in,1,1.8364528545823171e-06,1,2.2780963315814773e-06,0,0
16272,#inauguration,1,1.8364528545823171e-06,1,2.2780963315814773e-06,0,0
16273,tonight-,1,1.8364528545823171e-06,1,2.2780963315814773e-06,0,0
16274,#godblesstheusa,1,1.8364528545823171e-06,1,2.2780963315814773e-06,0,0
16277,@thealabamaband,1,1.8364528545823171e-06,1,2.2780963315814773e-06,0,0
16276,147,1,1.8364528545823171e-06,1,2.2780963315814773e-06,0,0
16278,bayer,1,1.8364528545823171e-06,1,2.2780963315814773e-06,0,0
16282,won--and,1,1.8364528545823171e-06,1,2.2780963315814773e-06,0,0
16284,hypocritical,1,1.8364528545823171e-06,1,2.2780963315814773e-06,0,0
16283,bushs,1,1.8364528545823171e-06,1,2.2780963315814773e-06,0,0
16285,swearing-inhe,1,1.8364528545823171e-06,1,2.2780963315814773e-06,0,0
16286,boycotted,1,1.8364528545823171e-06,1,2.2780963315814773e-06,0,0
16288,@drgoodspine,1,1.8364528545823171e-06,1,2.2780963315814773e-06,0,0
16289,@ivanka,1,1.8364528545823171e-06,1,2.2780963315814773e-06,0,0
16290,@levisteveholt,1,1.8364528545823171e-06,1,2.2780963315814773e-06,0,0
16291,build-up,1,1.8364528545823171e-06,1,2.2780963315814773e-06,0,0
16292,outgoing,1,1.8364528545823171e-06,1,2.2780963315814773e-06,0,0
16293,pres-elect,1,1.8364528545823171e-06,1,2.2780963315814773e-06,0,0
16294,thatthose,1,1.8364528545823171e-06,1,2.2780963315814773e-06,0,0
16295,documentit,1,1.8364528545823171e-06,1,2.2780963315814773e-06,0,0
16296,presentedtrumps,1,1.8364528545823171e-06,1,2.2780963315814773e-06,0,0
16297,untrusting,1,1.8364528545823171e-06,1,2.2780963315814773e-06,0,0
16299,inner-cities,1,1.8364528545823171e-06,1,2.2780963315814773e-06,0,0
16300,detective,1,1.8364528545823171e-06,1,2.2780963315814773e-06,0,0
16301,mcdonald,1,1.8364528545823171e-06,1,2.2780963315814773e-06,0,0
16302,unaffordable,1,1.8364528545823171e-06,1,2.2780963315814773e-06,0,0
16304,#repealobamacare-,1,1.8364528545823171e-06,1,2.2780963315814773e-06,0,0
16306,bean,1,1.8364528545823171e-06,1,2.2780963315814773e-06,0,0
16305,@lbperfectmaine,1,1.8364528545823171e-06,1,2.2780963315814773e-06,0,0
16308,factstoo,1,1.8364528545823171e-06,1,2.2780963315814773e-06,0,0
16310,@zhuamy3,1,1.8364528545823171e-06,1,2.2780963315814773e-06,0,0
16311,☀️☀️☀️thank,1,1.8364528545823171e-06,1,2.2780963315814773e-06,0,0
16312,meare,1,1.8364528545823171e-06,1,2.2780963315814773e-06,0,0
16314,12-yr,1,1.8364528545823171e-06,1,2.2780963315814773e-06,0,0
16315,1980,1,1.8364528545823171e-06,1,2.2780963315814773e-06,0,0
16317,1billion,1,1.8364528545823171e-06,1,2.2780963315814773e-06,0,0
16321,meryl,1,1.8364528545823171e-06,1,2.2780963315814773e-06,0,0
16323,streep,1,1.8364528545823171e-06,1,2.2780963315814773e-06,0,0
16322,over-rated,1,1.8364528545823171e-06,1,2.2780963315814773e-06,0,0
16319,actresses,1,1.8364528545823171e-06,1,2.2780963315814773e-06,0,0
16320,globes,1,1.8364528545823171e-06,1,2.2780963315814773e-06,0,0
16325,rupert,1,1.8364528545823171e-06,1,2.2780963315814773e-06,0,0
16324,murdoch,1,1.8364528545823171e-06,1,2.2780963315814773e-06,0,0
16330,interfe,1,1.8364528545823171e-06,1,2.2780963315814773e-06,0,0
16333,timken,1,1.8364528545823171e-06,1,2.2780963315814773e-06,0,0
16334,pressing,1,1.8364528545823171e-06,1,2.2780963315814773e-06,0,0
16335,negligence,1,1.8364528545823171e-06,1,2.2780963315814773e-06,0,0
16336,placethe,1,1.8364528545823171e-06,1,2.2780963315814773e-06,0,0
16340,editors,1,1.8364528545823171e-06,1,2.2780963315814773e-06,0,0
16339,conde,1,1.8364528545823171e-06,1,2.2780963315814773e-06,0,0
16341,nast,1,1.8364528545823171e-06,1,2.2780963315814773e-06,0,0
16342,star-and,1,1.8364528545823171e-06,1,2.2780963315814773e-06,0,0
16343,swamped,1,1.8364528545823171e-06,1,2.2780963315814773e-06,0,0
16344,minutethey,1,1.8364528545823171e-06,1,2.2780963315814773e-06,0,0
16347,baja,1,1.8364528545823171e-06,1,2.2780963315814773e-06,0,0
16348,corolla,1,1.8364528545823171e-06,1,2.2780963315814773e-06,0,0
16351,beginningkeep,1,1.8364528545823171e-06,1,2.2780963315814773e-06,0,0
16353,evanchos,1,1.8364528545823171e-06,1,2.2780963315814773e-06,0,0
16352,album,1,1.8364528545823171e-06,1,2.2780963315814773e-06,0,0
16354,performancesome,1,1.8364528545823171e-06,1,2.2780963315814773e-06,0,0
16356,scrapping,1,1.8364528545823171e-06,1,2.2780963315814773e-06,0,0
16358,careless,1,1.8364528545823171e-06,1,2.2780963315814773e-06,0,0
16359,eleventh,1,1.8364528545823171e-06,1,2.2780963315814773e-06,0,0
16360,@danscavino,1,1.8364528545823171e-06,1,2.2780963315814773e-06,0,0
16361,scrap,1,1.8364528545823171e-06,1,2.2780963315814773e-06,0,0
16362,#dts,1,1.8364528545823171e-06,1,2.2780963315814773e-06,0,0
16364,governorof,1,1.8364528545823171e-06,1,2.2780963315814773e-06,0,0
16365,chevy,1,1.8364528545823171e-06,1,2.2780963315814773e-06,0,0
16366,cruze,1,1.8364528545823171e-06,1,2.2780963315814773e-06,0,0
16367,dealers-tax,1,1.8364528545823171e-06,1,2.2780963315814773e-06,0,0
16368,usaor,1,1.8364528545823171e-06,1,2.2780963315814773e-06,0,0
16369,explores,1,1.8364528545823171e-06,1,2.2780963315814773e-06,0,0
16370,4331,1,1.8364528545823171e-06,1,2.2780963315814773e-06,0,0
16371,762,1,1.8364528545823171e-06,1,2.2780963315814773e-06,0,0
16373,americans-,1,1.8364528545823171e-06,1,2.2780963315814773e-06,0,0
16374,360,1,1.8364528545823171e-06,1,2.2780963315814773e-06,0,0
16377,immoral-,1,1.8364528545823171e-06,1,2.2780963315814773e-06,0,0
16379,3013,1,1.8364528545823171e-06,1,2.2780963315814773e-06,0,0
16381,builthas,1,1.8364528545823171e-06,1,2.2780963315814773e-06,0,0
16382,mansioncompound,1,1.8364528545823171e-06,1,2.2780963315814773e-06,0,0
16383,#schumershutdown,1,1.8364528545823171e-06,1,2.2780963315814773e-06,0,0
16384,screws,1,1.8364528545823171e-06,1,2.2780963315814773e-06,0,0
16386,co-author,1,1.8364528545823171e-06,1,2.2780963315814773e-06,0,0
16387,trumponomics,1,1.8364528545823171e-06,1,2.2780963315814773e-06,0,0
16388,naively,1,1.8364528545823171e-06,1,2.2780963315814773e-06,0,0
16390,trek,1,1.8364528545823171e-06,1,2.2780963315814773e-06,0,0
16394,looses,1,1.8364528545823171e-06,1,2.2780963315814773e-06,0,0
16396,pesident,1,1.8364528545823171e-06,1,2.2780963315814773e-06,0,0
16397,manhunt,1,1.8364528545823171e-06,1,2.2780963315814773e-06,0,0
16398,exceeded,1,1.8364528545823171e-06,1,2.2780963315814773e-06,0,0
16399,supteme,1,1.8364528545823171e-06,1,2.2780963315814773e-06,0,0
16400,traffickinggang,1,1.8364528545823171e-06,1,2.2780963315814773e-06,0,0
16402,asad,1,1.8364528545823171e-06,1,2.2780963315814773e-06,0,0
16403,115,1,1.8364528545823171e-06,1,2.2780963315814773e-06,0,0
16405,immensely,1,1.8364528545823171e-06,1,2.2780963315814773e-06,0,0
16406,lashed,1,1.8364528545823171e-06,1,2.2780963315814773e-06,0,0
16409,appointee,1,1.8364528545823171e-06,1,2.2780963315814773e-06,0,0
16411,militaries,1,1.8364528545823171e-06,1,2.2780963315814773e-06,0,0
16413,syriaand,1,1.8364528545823171e-06,1,2.2780963315814773e-06,0,0
16415,populism,1,1.8364528545823171e-06,1,2.2780963315814773e-06,0,0
16419,rightthe,1,1.8364528545823171e-06,1,2.2780963315814773e-06,0,0
16421,placesspent,1,1.8364528545823171e-06,1,2.2780963315814773e-06,0,0
16420,differentthats,1,1.8364528545823171e-06,1,2.2780963315814773e-06,0,0
16422,badmouths,1,1.8364528545823171e-06,1,2.2780963315814773e-06,0,0
16423,priveledged,1,1.8364528545823171e-06,1,2.2780963315814773e-06,0,0
16424,tsunami,1,1.8364528545823171e-06,1,2.2780963315814773e-06,0,0
16430,ingloriously,1,1.8364528545823171e-06,1,2.2780963315814773e-06,0,0
16431,relationship-but,1,1.8364528545823171e-06,1,2.2780963315814773e-06,0,0
16429,important-but,1,1.8364528545823171e-06,1,2.2780963315814773e-06,0,0
16433,adjourns,1,1.8364528545823171e-06,1,2.2780963315814773e-06,0,0
16435,slat,1,1.8364528545823171e-06,1,2.2780963315814773e-06,0,0
16436,7213,1,1.8364528545823171e-06,1,2.2780963315814773e-06,0,0
16438,detection,1,1.8364528545823171e-06,1,2.2780963315814773e-06,0,0
16441,presidentsnot,1,1.8364528545823171e-06,1,2.2780963315814773e-06,0,0
16442,cooked,1,1.8364528545823171e-06,1,2.2780963315814773e-06,0,0
16451,#emmys,1,1.8364528545823171e-06,1,2.2780963315814773e-06,0,0
16455,policeman,1,1.8364528545823171e-06,1,2.2780963315814773e-06,0,0
16457,carafano,1,1.8364528545823171e-06,1,2.2780963315814773e-06,0,0
16456,amuck,1,1.8364528545823171e-06,1,2.2780963315814773e-06,0,0
16459,rave,1,1.8364528545823171e-06,1,2.2780963315814773e-06,0,0
16458,politic,1,1.8364528545823171e-06,1,2.2780963315814773e-06,0,0
16463,cats,1,1.8364528545823171e-06,1,2.2780963315814773e-06,0,0
16464,artistically,1,1.8364528545823171e-06,1,2.2780963315814773e-06,0,0
16466,reputations,1,1.8364528545823171e-06,1,2.2780963315814773e-06,0,0
16467,yahoo,1,1.8364528545823171e-06,1,2.2780963315814773e-06,0,0
16468,dopey,1,1.8364528545823171e-06,1,2.2780963315814773e-06,0,0
16469,sensational,1,1.8364528545823171e-06,1,2.2780963315814773e-06,0,0
16472,slowed,1,1.8364528545823171e-06,1,2.2780963315814773e-06,0,0
16471,acknowledged-done,1,1.8364528545823171e-06,1,2.2780963315814773e-06,0,0
16473,illiquid,1,1.8364528545823171e-06,1,2.2780963315814773e-06,0,0
16475,unjustified,1,1.8364528545823171e-06,1,2.2780963315814773e-06,0,0
16474,facilitation,1,1.8364528545823171e-06,1,2.2780963315814773e-06,0,0
16476,useable,1,1.8364528545823171e-06,1,2.2780963315814773e-06,0,0
16477,entrapping,1,1.8364528545823171e-06,1,2.2780963315814773e-06,0,0
16482,incidental,1,1.8364528545823171e-06,1,2.2780963315814773e-06,0,0
16484,@rodblagojevich,1,1.8364528545823171e-06,1,2.2780963315814773e-06,0,0
16494,erased,1,1.8364528545823171e-06,1,2.2780963315814773e-06,0,0
16498,prognosticator,1,1.8364528545823171e-06,1,2.2780963315814773e-06,0,0
16497,kristol,1,1.8364528545823171e-06,1,2.2780963315814773e-06,0,0
16500,@ryanzinke,1,1.8364528545823171e-06,1,2.2780963315814773e-06,0,0
16501,@timcook,1,1.8364528545823171e-06,1,2.2780963315814773e-06,0,0
16503,382nd,1,1.8364528545823171e-06,1,2.2780963315814773e-06,0,0
16502,#guard382,1,1.8364528545823171e-06,1,2.2780963315814773e-06,0,0
16505,airing,1,1.8364528545823171e-06,1,2.2780963315814773e-06,0,0
16504,1pme,1,1.8364528545823171e-06,1,2.2780963315814773e-06,0,0
16506,brzezinski,1,1.8364528545823171e-06,1,2.2780963315814773e-06,0,0
16514,presidentit,1,1.8364528545823171e-06,1,2.2780963315814773e-06,0,0
16512,bleed,1,1.8364528545823171e-06,1,2.2780963315814773e-06,0,0
16513,fbicomey,1,1.8364528545823171e-06,1,2.2780963315814773e-06,0,0
16511,-chris,1,1.8364528545823171e-06,1,2.2780963315814773e-06,0,0
16516,exploded,1,1.8364528545823171e-06,1,2.2780963315814773e-06,0,0
16517,vying,1,1.8364528545823171e-06,1,2.2780963315814773e-06,0,0
16519,makeshift,1,1.8364528545823171e-06,1,2.2780963315814773e-06,0,0
16521,gunno,1,1.8364528545823171e-06,1,2.2780963315814773e-06,0,0
16525,ayers,1,1.8364528545823171e-06,1,2.2780963315814773e-06,0,0
16527,mind-truly,1,1.8364528545823171e-06,1,2.2780963315814773e-06,0,0
16531,#armynavygame🇺🇸,1,1.8364528545823171e-06,1,2.2780963315814773e-06,0,0
16534,bullets,1,1.8364528545823171e-06,1,2.2780963315814773e-06,0,0
16536,whizzed,1,1.8364528545823171e-06,1,2.2780963315814773e-06,0,0
16535,dicks,1,1.8364528545823171e-06,1,2.2780963315814773e-06,0,0
16538,dunford,1,1.8364528545823171e-06,1,2.2780963315814773e-06,0,0
16540,ww,1,1.8364528545823171e-06,1,2.2780963315814773e-06,0,0
16542,questionably,1,1.8364528545823171e-06,1,2.2780963315814773e-06,0,0
16543,clears,1,1.8364528545823171e-06,1,2.2780963315814773e-06,0,0
16544,lazy,1,1.8364528545823171e-06,1,2.2780963315814773e-06,0,0
16547,nauert,1,1.8364528545823171e-06,1,2.2780963315814773e-06,0,0
16549,spokeswoman,1,1.8364528545823171e-06,1,2.2780963315814773e-06,0,0
16550,exposedand,1,1.8364528545823171e-06,1,2.2780963315814773e-06,0,0
16557,weissmans,1,1.8364528545823171e-06,1,2.2780963315814773e-06,0,0
16558,prosecuting,1,1.8364528545823171e-06,1,2.2780963315814773e-06,0,0
16559,bracing,1,1.8364528545823171e-06,1,2.2780963315814773e-06,0,0
16560,non-walled,1,1.8364528545823171e-06,1,2.2780963315814773e-06,0,0
16563,trishregan,1,1.8364528545823171e-06,1,2.2780963315814773e-06,0,0
16562,protocol,1,1.8364528545823171e-06,1,2.2780963315814773e-06,0,0
16564,weaponizing,1,1.8364528545823171e-06,1,2.2780963315814773e-06,0,0
16566,violate,1,1.8364528545823171e-06,1,2.2780963315814773e-06,0,0
16569,mid-air,1,1.8364528545823171e-06,1,2.2780963315814773e-06,0,0
16567,@iiimef,1,1.8364528545823171e-06,1,2.2780963315814773e-06,0,0
16573,addictive,1,1.8364528545823171e-06,1,2.2780963315814773e-06,0,0
16572,77000,1,1.8364528545823171e-06,1,2.2780963315814773e-06,0,0
16574,cracks,1,1.8364528545823171e-06,1,2.2780963315814773e-06,0,0
16576,pushers,1,1.8364528545823171e-06,1,2.2780963315814773e-06,0,0
16578,criminalize,1,1.8364528545823171e-06,1,2.2780963315814773e-06,0,0
16579,echoed,1,1.8364528545823171e-06,1,2.2780963315814773e-06,0,0
16580,liquified,1,1.8364528545823171e-06,1,2.2780963315814773e-06,0,0
16583,fatally,1,1.8364528545823171e-06,1,2.2780963315814773e-06,0,0
16584,whitewashing,1,1.8364528545823171e-06,1,2.2780963315814773e-06,0,0
16585,lighthizer,1,1.8364528545823171e-06,1,2.2780963315814773e-06,0,0
16587,blair,1,1.8364528545823171e-06,1,2.2780963315814773e-06,0,0
16588,decorations,1,1.8364528545823171e-06,1,2.2780963315814773e-06,0,0
16589,elegance,1,1.8364528545823171e-06,1,2.2780963315814773e-06,0,0
16590,#remembering41,1,1.8364528545823171e-06,1,2.2780963315814773e-06,0,0
16592,taxis,1,1.8364528545823171e-06,1,2.2780963315814773e-06,0,0
16593,beneficiary,1,1.8364528545823171e-06,1,2.2780963315814773e-06,0,0
16595,leap,1,1.8364528545823171e-06,1,2.2780963315814773e-06,0,0
16597,buenos,1,1.8364528545823171e-06,1,2.2780963315814773e-06,0,0
16596,aires,1,1.8364528545823171e-06,1,2.2780963315814773e-06,0,0
16598,crafting,1,1.8364528545823171e-06,1,2.2780963315814773e-06,0,0
16599,#usmca🇺🇸🇲🇽🇨🇦,1,1.8364528545823171e-06,1,2.2780963315814773e-06,0,0
16600,business-very,1,1.8364528545823171e-06,1,2.2780963315814773e-06,0,0
16601,demonstrates,1,1.8364528545823171e-06,1,2.2780963315814773e-06,0,0
16604,whiff,1,1.8364528545823171e-06,1,2.2780963315814773e-06,0,0
16606,originals,1,1.8364528545823171e-06,1,2.2780963315814773e-06,0,0
16607,@dbonginos,1,1.8364528545823171e-06,1,2.2780963315814773e-06,0,0
16610,long-held,1,1.8364528545823171e-06,1,2.2780963315814773e-06,0,0
16611,#trumponomics,1,1.8364528545823171e-06,1,2.2780963315814773e-06,0,0
16615,end-or,1,1.8364528545823171e-06,1,2.2780963315814773e-06,0,0
16616,thing-there,1,1.8364528545823171e-06,1,2.2780963315814773e-06,0,0
16617,bmw,1,1.8364528545823171e-06,1,2.2780963315814773e-06,0,0
16620,#nctl2018🎄,1,1.8364528545823171e-06,1,2.2780963315814773e-06,0,0
16622,pops,1,1.8364528545823171e-06,1,2.2780963315814773e-06,0,0
16623,brenda,1,1.8364528545823171e-06,1,2.2780963315814773e-06,0,0
16626,tactician,1,1.8364528545823171e-06,1,2.2780963315814773e-06,0,0
16628,@votebradraff,1,1.8364528545823171e-06,1,2.2780963315814773e-06,0,0
16629,portraying,1,1.8364528545823171e-06,1,2.2780963315814773e-06,0,0
16634,ten-year,1,1.8364528545823171e-06,1,2.2780963315814773e-06,0,0
16630,166,1,1.8364528545823171e-06,1,2.2780963315814773e-06,0,0
16631,innocents,1,1.8364528545823171e-06,1,2.2780963315814773e-06,0,0
16636,preamble,1,1.8364528545823171e-06,1,2.2780963315814773e-06,0,0
16637,sidewhatever,1,1.8364528545823171e-06,1,2.2780963315814773e-06,0,0
16642,monetized,1,1.8364528545823171e-06,1,2.2780963315814773e-06,0,0
16644,originating,1,1.8364528545823171e-06,1,2.2780963315814773e-06,0,0
16647,gulfport,1,1.8364528545823171e-06,1,2.2780963315814773e-06,0,0
16648,tupelo,1,1.8364528545823171e-06,1,2.2780963315814773e-06,0,0
16650,touted,1,1.8364528545823171e-06,1,2.2780963315814773e-06,0,0
16652,individually,1,1.8364528545823171e-06,1,2.2780963315814773e-06,0,0
16653,@senchuckschumer,1,1.8364528545823171e-06,1,2.2780963315814773e-06,0,0
16655,thanksgivings,1,1.8364528545823171e-06,1,2.2780963315814773e-06,0,0
16656,bedlam,1,1.8364528545823171e-06,1,2.2780963315814773e-06,0,0
16659,epstein,1,1.8364528545823171e-06,1,2.2780963315814773e-06,0,0
16662,shatter,1,1.8364528545823171e-06,1,2.2780963315814773e-06,0,0
16663,circuits,1,1.8364528545823171e-06,1,2.2780963315814773e-06,0,0
16665,hector,1,1.8364528545823171e-06,1,2.2780963315814773e-06,0,0
16664,garza,1,1.8364528545823171e-06,1,2.2780963315814773e-06,0,0
16667,unwise,1,1.8364528545823171e-06,1,2.2780963315814773e-06,0,0
16668,loudon,1,1.8364528545823171e-06,1,2.2780963315814773e-06,0,0
16672,imitation,1,1.8364528545823171e-06,1,2.2780963315814773e-06,0,0
16671,afflicting,1,1.8364528545823171e-06,1,2.2780963315814773e-06,0,0
16670,@mgoodwinnypost,1,1.8364528545823171e-06,1,2.2780963315814773e-06,0,0
16675,eventual,1,1.8364528545823171e-06,1,2.2780963315814773e-06,0,0
16674,argentine,1,1.8364528545823171e-06,1,2.2780963315814773e-06,0,0
16676,climbers,1,1.8364528545823171e-06,1,2.2780963315814773e-06,0,0
16678,waged,1,1.8364528545823171e-06,1,2.2780963315814773e-06,0,0
16683,tijuana,1,1.8364528545823171e-06,1,2.2780963315814773e-06,0,0
16680,backlog,1,1.8364528545823171e-06,1,2.2780963315814773e-06,0,0
16684,d-ca,1,1.8364528545823171e-06,1,2.2780963315814773e-06,0,0
16687,@replamalfa,1,1.8364528545823171e-06,1,2.2780963315814773e-06,0,0
16686,@kencalvert,1,1.8364528545823171e-06,1,2.2780963315814773e-06,0,0
16689,reckon,1,1.8364528545823171e-06,1,2.2780963315814773e-06,0,0
16690,@tomreedcongress,1,1.8364528545823171e-06,1,2.2780963315814773e-06,0,0
16691,@jerrybrowngov,1,1.8364528545823171e-06,1,2.2780963315814773e-06,0,0
16695,mistreat,1,1.8364528545823171e-06,1,2.2780963315814773e-06,0,0
16696,familiesto,1,1.8364528545823171e-06,1,2.2780963315814773e-06,0,0
16697,@mbwdc,1,1.8364528545823171e-06,1,2.2780963315814773e-06,0,0
16699,workings,1,1.8364528545823171e-06,1,2.2780963315814773e-06,0,0
16701,contains,1,1.8364528545823171e-06,1,2.2780963315814773e-06,0,0
16705,hindu,1,1.8364528545823171e-06,1,2.2780963315814773e-06,0,0
16713,nationalist,1,1.8364528545823171e-06,1,2.2780963315814773e-06,0,0
16714,people-and,1,1.8364528545823171e-06,1,2.2780963315814773e-06,0,0
16717,alleviate,1,1.8364528545823171e-06,1,2.2780963315814773e-06,0,0
16719,at&t-time,1,1.8364528545823171e-06,1,2.2780963315814773e-06,0,0
16720,gasparino,1,1.8364528545823171e-06,1,2.2780963315814773e-06,0,0
16724,possible-ballots,1,1.8364528545823171e-06,1,2.2780963315814773e-06,0,0
16725,themselvesand,1,1.8364528545823171e-06,1,2.2780963315814773e-06,0,0
16726,portions,1,1.8364528545823171e-06,1,2.2780963315814773e-06,0,0
16727,1918,1,1.8364528545823171e-06,1,2.2780963315814773e-06,0,0
16728,resting,1,1.8364528545823171e-06,1,2.2780963315814773e-06,0,0
16729,suresnes,1,1.8364528545823171e-06,1,2.2780963315814773e-06,0,0
16730,80-100,1,1.8364528545823171e-06,1,2.2780963315814773e-06,0,0
16731,evacuate,1,1.8364528545823171e-06,1,2.2780963315814773e-06,0,0
16732,overtaken,1,1.8364528545823171e-06,1,2.2780963315814773e-06,0,0
16736,woolsey,1,1.8364528545823171e-06,1,2.2780963315814773e-06,0,0
16734,52000,1,1.8364528545823171e-06,1,2.2780963315814773e-06,0,0
16735,evacuated,1,1.8364528545823171e-06,1,2.2780963315814773e-06,0,0
16738,corps🇺🇸,1,1.8364528545823171e-06,1,2.2780963315814773e-06,0,0
16739,bloodiest,1,1.8364528545823171e-06,1,2.2780963315814773e-06,0,0
16740,mismanagement,1,1.8364528545823171e-06,1,2.2780963315814773e-06,0,0
16741,@terrybranstad,1,1.8364528545823171e-06,1,2.2780963315814773e-06,0,0
16743,primarily,1,1.8364528545823171e-06,1,2.2780963315814773e-06,0,0
16745,falsify,1,1.8364528545823171e-06,1,2.2780963315814773e-06,0,0
16746,non-senate,1,1.8364528545823171e-06,1,2.2780963315814773e-06,0,0
16747,elias,1,1.8364528545823171e-06,1,2.2780963315814773e-06,0,0
16748,#magarally🇺🇸tonight,1,1.8364528545823171e-06,1,2.2780963315814773e-06,0,0
16749,#broward,1,1.8364528545823171e-06,1,2.2780963315814773e-06,0,0
16750,disapprove,1,1.8364528545823171e-06,1,2.2780963315814773e-06,0,0
16753,embracing,1,1.8364528545823171e-06,1,2.2780963315814773e-06,0,0
16754,improves-all,1,1.8364528545823171e-06,1,2.2780963315814773e-06,0,0
16757,campaigner,1,1.8364528545823171e-06,1,2.2780963315814773e-06,0,0
16758,hultgren,1,1.8364528545823171e-06,1,2.2780963315814773e-06,0,0
16760,hugin,1,1.8364528545823171e-06,1,2.2780963315814773e-06,0,0
16761,gem,1,1.8364528545823171e-06,1,2.2780963315814773e-06,0,0
16768,democrat-led,1,1.8364528545823171e-06,1,2.2780963315814773e-06,0,0
16770,screeching,1,1.8364528545823171e-06,1,2.2780963315814773e-06,0,0
16772,radar,1,1.8364528545823171e-06,1,2.2780963315814773e-06,0,0
16774,#ny22,1,1.8364528545823171e-06,1,2.2780963315814773e-06,0,0
16775,@andrewgillum,1,1.8364528545823171e-06,1,2.2780963315814773e-06,0,0
16778,ridden,1,1.8364528545823171e-06,1,2.2780963315814773e-06,0,0
16777,overtaxed,1,1.8364528545823171e-06,1,2.2780963315814773e-06,0,0
16780,@debbiestabenow,1,1.8364528545823171e-06,1,2.2780963315814773e-06,0,0
16781,cal,1,1.8364528545823171e-06,1,2.2780963315814773e-06,0,0
16784,@votemarsha,1,1.8364528545823171e-06,1,2.2780963315814773e-06,0,0
16786,mckenzie,1,1.8364528545823171e-06,1,2.2780963315814773e-06,0,0
16787,4pme,1,1.8364528545823171e-06,1,2.2780963315814773e-06,0,0
16792,libertarian,1,1.8364528545823171e-06,1,2.2780963315814773e-06,0,0
16793,krysten,1,1.8364528545823171e-06,1,2.2780963315814773e-06,0,0
16795,job-killing,1,1.8364528545823171e-06,1,2.2780963315814773e-06,0,0
16796,mines,1,1.8364528545823171e-06,1,2.2780963315814773e-06,0,0
16798,@johnfasony,1,1.8364528545823171e-06,1,2.2780963315814773e-06,0,0
16800,pro-iran,1,1.8364528545823171e-06,1,2.2780963315814773e-06,0,0
16803,kavanough,1,1.8364528545823171e-06,1,2.2780963315814773e-06,0,0
16808,southport,1,1.8364528545823171e-06,1,2.2780963315814773e-06,0,0
16809,#magarally🇺🇸in,1,1.8364528545823171e-06,1,2.2780963315814773e-06,0,0
16810,@morriseywv,1,1.8364528545823171e-06,1,2.2780963315814773e-06,0,0
16812,strain,1,1.8364528545823171e-06,1,2.2780963315814773e-06,0,0
16813,polis,1,1.8364528545823171e-06,1,2.2780963315814773e-06,0,0
16815,@walkerstapleton,1,1.8364528545823171e-06,1,2.2780963315814773e-06,0,0
16816,breckenridge,1,1.8364528545823171e-06,1,2.2780963315814773e-06,0,0
16817,fairly@foxnews,1,1.8364528545823171e-06,1,2.2780963315814773e-06,0,0
16820,sorrow,1,1.8364528545823171e-06,1,2.2780963315814773e-06,0,0
16823,thereof,1,1.8364528545823171e-06,1,2.2780963315814773e-06,0,0
16827,mobilized,1,1.8364528545823171e-06,1,2.2780963315814773e-06,0,0
16828,clone,1,1.8364528545823171e-06,1,2.2780963315814773e-06,0,0
16830,dovish,1,1.8364528545823171e-06,1,2.2780963315814773e-06,0,0
16829,2800,1,1.8364528545823171e-06,1,2.2780963315814773e-06,0,0
16831,wren,1,1.8364528545823171e-06,1,2.2780963315814773e-06,0,0
16835,@cathymcmorris,1,1.8364528545823171e-06,1,2.2780963315814773e-06,0,0
16836,@rodblum,1,1.8364528545823171e-06,1,2.2780963315814773e-06,0,0
16837,@erikpaulson,1,1.8364528545823171e-06,1,2.2780963315814773e-06,0,0
16838,@jasonlewis,1,1.8364528545823171e-06,1,2.2780963315814773e-06,0,0
16839,@denverriggleman,1,1.8364528545823171e-06,1,2.2780963315814773e-06,0,0
16840,disillusioned,1,1.8364528545823171e-06,1,2.2780963315814773e-06,0,0
16841,harvardyale,1,1.8364528545823171e-06,1,2.2780963315814773e-06,0,0
16842,thief,1,1.8364528545823171e-06,1,2.2780963315814773e-06,0,0
16844,jair,1,1.8364528545823171e-06,1,2.2780963315814773e-06,0,0
16845,harmony,1,1.8364528545823171e-06,1,2.2780963315814773e-06,0,0
16846,flame,1,1.8364528545823171e-06,1,2.2780963315814773e-06,0,0
16848,@jaketapper,1,1.8364528545823171e-06,1,2.2780963315814773e-06,0,0
16849,ret,1,1.8364528545823171e-06,1,2.2780963315814773e-06,0,0
16851,dodgersred,1,1.8364528545823171e-06,1,2.2780963315814773e-06,0,0
16853,loose,1,1.8364528545823171e-06,1,2.2780963315814773e-06,0,0
16850,dodgers,1,1.8364528545823171e-06,1,2.2780963315814773e-06,0,0
16854,relievers,1,1.8364528545823171e-06,1,2.2780963315814773e-06,0,0
16859,sustained,1,1.8364528545823171e-06,1,2.2780963315814773e-06,0,0
16864,squirrel,1,1.8364528545823171e-06,1,2.2780963315814773e-06,0,0
16863,sheltered,1,1.8364528545823171e-06,1,2.2780963315814773e-06,0,0
16862,fatalities,1,1.8364528545823171e-06,1,2.2780963315814773e-06,0,0
16865,#walkaway,1,1.8364528545823171e-06,1,2.2780963315814773e-06,0,0
16867,walkaway,1,1.8364528545823171e-06,1,2.2780963315814773e-06,0,0
16866,straka,1,1.8364528545823171e-06,1,2.2780963315814773e-06,0,0
16868,budd,1,1.8364528545823171e-06,1,2.2780963315814773e-06,0,0
16871,thunders,1,1.8364528545823171e-06,1,2.2780963315814773e-06,0,0
16870,scares,1,1.8364528545823171e-06,1,2.2780963315814773e-06,0,0
16872,@buddforcongress,1,1.8364528545823171e-06,1,2.2780963315814773e-06,0,0
16873,@markharrisnc9,1,1.8364528545823171e-06,1,2.2780963315814773e-06,0,0
16874,#ybls2018,1,1.8364528545823171e-06,1,2.2780963315814773e-06,0,0
16875,fills,1,1.8364528545823171e-06,1,2.2780963315814773e-06,0,0
16878,high-profile,1,1.8364528545823171e-06,1,2.2780963315814773e-06,0,0
16879,slows,1,1.8364528545823171e-06,1,2.2780963315814773e-06,0,0
16882,stifled,1,1.8364528545823171e-06,1,2.2780963315814773e-06,0,0
16881,blimp,1,1.8364528545823171e-06,1,2.2780963315814773e-06,0,0
16884,lowly,1,1.8364528545823171e-06,1,2.2780963315814773e-06,0,0
16885,spate,1,1.8364528545823171e-06,1,2.2780963315814773e-06,0,0
16883,comparing,1,1.8364528545823171e-06,1,2.2780963315814773e-06,0,0
16886,enlisted,1,1.8364528545823171e-06,1,2.2780963315814773e-06,0,0
16888,1983,1,1.8364528545823171e-06,1,2.2780963315814773e-06,0,0
16889,reverent,1,1.8364528545823171e-06,1,2.2780963315814773e-06,0,0
16890,@brucepoliquin,1,1.8364528545823171e-06,1,2.2780963315814773e-06,0,0
16891,@mikedunleavygov,1,1.8364528545823171e-06,1,2.2780963315814773e-06,0,0
16892,@johnchrin,1,1.8364528545823171e-06,1,2.2780963315814773e-06,0,0
16894,armistice,1,1.8364528545823171e-06,1,2.2780963315814773e-06,0,0
16895,centennial,1,1.8364528545823171e-06,1,2.2780963315814773e-06,0,0
16898,cellphones,1,1.8364528545823171e-06,1,2.2780963315814773e-06,0,0
16899,chanded,1,1.8364528545823171e-06,1,2.2780963315814773e-06,0,0
16903,wholeheartedly,1,1.8364528545823171e-06,1,2.2780963315814773e-06,0,0
16905,548,1,1.8364528545823171e-06,1,2.2780963315814773e-06,0,0
16907,faso,1,1.8364528545823171e-06,1,2.2780963315814773e-06,0,0
16908,hurricanedisaster,1,1.8364528545823171e-06,1,2.2780963315814773e-06,0,0
16909,unpaid,1,1.8364528545823171e-06,1,2.2780963315814773e-06,0,0
16911,webber,1,1.8364528545823171e-06,1,2.2780963315814773e-06,0,0
16910,done-and,1,1.8364528545823171e-06,1,2.2780963315814773e-06,0,0
16913,paulsen,1,1.8364528545823171e-06,1,2.2780963315814773e-06,0,0
16914,@reploubarletta,1,1.8364528545823171e-06,1,2.2780963315814773e-06,0,0
16917,@toyotacenter,1,1.8364528545823171e-06,1,2.2780963315814773e-06,0,0
16918,@andrewsjba,1,1.8364528545823171e-06,1,2.2780963315814773e-06,0,0
16919,births,1,1.8364528545823171e-06,1,2.2780963315814773e-06,0,0
16921,attempting,1,1.8364528545823171e-06,1,2.2780963315814773e-06,0,0
16923,easterners,1,1.8364528545823171e-06,1,2.2780963315814773e-06,0,0
16924,emergy,1,1.8364528545823171e-06,1,2.2780963315814773e-06,0,0
16928,souther,1,1.8364528545823171e-06,1,2.2780963315814773e-06,0,0
16927,doable,1,1.8364528545823171e-06,1,2.2780963315814773e-06,0,0
16930,dakotas,1,1.8364528545823171e-06,1,2.2780963315814773e-06,0,0
16932,heitkamp,1,1.8364528545823171e-06,1,2.2780963315814773e-06,0,0
16933,violators,1,1.8364528545823171e-06,1,2.2780963315814773e-06,0,0
16934,elko,1,1.8364528545823171e-06,1,2.2780963315814773e-06,0,0
16936,@repmcsally,1,1.8364528545823171e-06,1,2.2780963315814773e-06,0,0
16938,achievement-the,1,1.8364528545823171e-06,1,2.2780963315814773e-06,0,0
16939,foundations,1,1.8364528545823171e-06,1,2.2780963315814773e-06,0,0
16940,horrors,1,1.8364528545823171e-06,1,2.2780963315814773e-06,0,0
16942,#magarally🇺🇸replay,1,1.8364528545823171e-06,1,2.2780963315814773e-06,0,0
16943,hangar,1,1.8364528545823171e-06,1,2.2780963315814773e-06,0,0
16945,desires,1,1.8364528545823171e-06,1,2.2780963315814773e-06,0,0
16949,biggs,1,1.8364528545823171e-06,1,2.2780963315814773e-06,0,0
16950,america-first,1,1.8364528545823171e-06,1,2.2780963315814773e-06,0,0
16954,saudis,1,1.8364528545823171e-06,1,2.2780963315814773e-06,0,0
16955,wherein,1,1.8364528545823171e-06,1,2.2780963315814773e-06,0,0
16957,canley,1,1.8364528545823171e-06,1,2.2780963315814773e-06,0,0
16959,dunn,1,1.8364528545823171e-06,1,2.2780963315814773e-06,0,0
16958,@dunncampaign,1,1.8364528545823171e-06,1,2.2780963315814773e-06,0,0
16961,burdensome,1,1.8364528545823171e-06,1,2.2780963315814773e-06,0,0
16962,economyread,1,1.8364528545823171e-06,1,2.2780963315814773e-06,0,0
16963,unimpeded,1,1.8364528545823171e-06,1,2.2780963315814773e-06,0,0
16964,714,1,1.8364528545823171e-06,1,2.2780963315814773e-06,0,0
16965,barometer,1,1.8364528545823171e-06,1,2.2780963315814773e-06,0,0
16967,truthfulness,1,1.8364528545823171e-06,1,2.2780963315814773e-06,0,0
16968,wpost,1,1.8364528545823171e-06,1,2.2780963315814773e-06,0,0
16972,trish,1,1.8364528545823171e-06,1,2.2780963315814773e-06,0,0
16971,regan,1,1.8364528545823171e-06,1,2.2780963315814773e-06,0,0
16974,hindrance,1,1.8364528545823171e-06,1,2.2780963315814773e-06,0,0
16978,pawn,1,1.8364528545823171e-06,1,2.2780963315814773e-06,0,0
16980,glen,1,1.8364528545823171e-06,1,2.2780963315814773e-06,0,0
16981,simpsons,1,1.8364528545823171e-06,1,2.2780963315814773e-06,0,0
16979,channel,1,1.8364528545823171e-06,1,2.2780963315814773e-06,0,0
16984,stormy,1,1.8364528545823171e-06,1,2.2780963315814773e-06,0,0
16982,danials,1,1.8364528545823171e-06,1,2.2780963315814773e-06,0,0
16983,horseface,1,1.8364528545823171e-06,1,2.2780963315814773e-06,0,0
16986,7036000,1,1.8364528545823171e-06,1,2.2780963315814773e-06,0,0
16987,8x,1,1.8364528545823171e-06,1,2.2780963315814773e-06,0,0
16990,unaccompanied,1,1.8364528545823171e-06,1,2.2780963315814773e-06,0,0
16992,11024,1,1.8364528545823171e-06,1,2.2780963315814773e-06,0,0
16994,lower-priced,1,1.8364528545823171e-06,1,2.2780963315814773e-06,0,0
16995,arabian,1,1.8364528545823171e-06,1,2.2780963315814773e-06,0,0
16997,shapiro,1,1.8364528545823171e-06,1,2.2780963315814773e-06,0,0
16999,@lesleyrstahl,1,1.8364528545823171e-06,1,2.2780963315814773e-06,0,0
17002,princess,1,1.8364528545823171e-06,1,2.2780963315814773e-06,0,0
17001,eugenie,1,1.8364528545823171e-06,1,2.2780963315814773e-06,0,0
17000,bride,1,1.8364528545823171e-06,1,2.2780963315814773e-06,0,0
17004,ulysses,1,1.8364528545823171e-06,1,2.2780963315814773e-06,0,0
17003,shoutout,1,1.8364528545823171e-06,1,2.2780963315814773e-06,0,0
17005,puppet-weak,1,1.8364528545823171e-06,1,2.2780963315814773e-06,0,0
17007,kristin,1,1.8364528545823171e-06,1,2.2780963315814773e-06,0,0
17006,fisher,1,1.8364528545823171e-06,1,2.2780963315814773e-06,0,0
17008,#243navybday,1,1.8364528545823171e-06,1,2.2780963315814773e-06,0,0
17009,lacrosse,1,1.8364528545823171e-06,1,2.2780963315814773e-06,0,0
17010,#nationalfarmersday,1,1.8364528545823171e-06,1,2.2780963315814773e-06,0,0
17011,chants,1,1.8364528545823171e-06,1,2.2780963315814773e-06,0,0
17012,nepotism,1,1.8364528545823171e-06,1,2.2780963315814773e-06,0,0
17016,troopers,1,1.8364528545823171e-06,1,2.2780963315814773e-06,0,0
17014,en,1,1.8364528545823171e-06,1,2.2780963315814773e-06,0,0
17019,reseach,1,1.8364528545823171e-06,1,2.2780963315814773e-06,0,0
17020,yesterday-a17,1,1.8364528545823171e-06,1,2.2780963315814773e-06,0,0
17021,stapleton,1,1.8364528545823171e-06,1,2.2780963315814773e-06,0,0
17022,algae,1,1.8364528545823171e-06,1,2.2780963315814773e-06,0,0
17023,reservoir,1,1.8364528545823171e-06,1,2.2780963315814773e-06,0,0
17024,cat,1,1.8364528545823171e-06,1,2.2780963315814773e-06,0,0
17029,@agpambondi,1,1.8364528545823171e-06,1,2.2780963315814773e-06,0,0
17028,#fortifyfl,1,1.8364528545823171e-06,1,2.2780963315814773e-06,0,0
17030,darkened,1,1.8364528545823171e-06,1,2.2780963315814773e-06,0,0
17032,doorsteps,1,1.8364528545823171e-06,1,2.2780963315814773e-06,0,0
17034,leos,1,1.8364528545823171e-06,1,2.2780963315814773e-06,0,0
17037,columbuss,1,1.8364528545823171e-06,1,2.2780963315814773e-06,0,0
17036,adventure,1,1.8364528545823171e-06,1,2.2780963315814773e-06,0,0
17039,navigator,1,1.8364528545823171e-06,1,2.2780963315814773e-06,0,0
17040,voyage,1,1.8364528545823171e-06,1,2.2780963315814773e-06,0,0
17038,expanse,1,1.8364528545823171e-06,1,2.2780963315814773e-06,0,0
17041,pyongyang,1,1.8364528545823171e-06,1,2.2780963315814773e-06,0,0
17042,arsonist,1,1.8364528545823171e-06,1,2.2780963315814773e-06,0,0
17043,govern,1,1.8364528545823171e-06,1,2.2780963315814773e-06,0,0
17044,topeka,1,1.8364528545823171e-06,1,2.2780963315814773e-06,0,0
17045,formidable,1,1.8364528545823171e-06,1,2.2780963315814773e-06,0,0
17046,onlookers,1,1.8364528545823171e-06,1,2.2780963315814773e-06,0,0
17047,rows,1,1.8364528545823171e-06,1,2.2780963315814773e-06,0,0
17048,annies,1,1.8364528545823171e-06,1,2.2780963315814773e-06,0,0
17049,congratulations-have,1,1.8364528545823171e-06,1,2.2780963315814773e-06,0,0
17054,elevator,1,1.8364528545823171e-06,1,2.2780963315814773e-06,0,0
17055,identical,1,1.8364528545823171e-06,1,2.2780963315814773e-06,0,0
17056,soros,1,1.8364528545823171e-06,1,2.2780963315814773e-06,0,0
17053,#troublemakers,1,1.8364528545823171e-06,1,2.2780963315814773e-06,0,0
17057,@karinhousley,1,1.8364528545823171e-06,1,2.2780963315814773e-06,0,0
17061,uncorroborated,1,1.8364528545823171e-06,1,2.2780963315814773e-06,0,0
17064,102nd,1,1.8364528545823171e-06,1,2.2780963315814773e-06,0,0
17065,@sandyhook,1,1.8364528545823171e-06,1,2.2780963315814773e-06,0,0
17066,glassdoor,1,1.8364528545823171e-06,1,2.2780963315814773e-06,0,0
17067,workers➡️,1,1.8364528545823171e-06,1,2.2780963315814773e-06,0,0
17069,shurer,1,1.8364528545823171e-06,1,2.2780963315814773e-06,0,0
17068,braved,1,1.8364528545823171e-06,1,2.2780963315814773e-06,0,0
17070,tristan,1,1.8364528545823171e-06,1,2.2780963315814773e-06,0,0
17074,charm,1,1.8364528545823171e-06,1,2.2780963315814773e-06,0,0
17076,deem,1,1.8364528545823171e-06,1,2.2780963315814773e-06,0,0
17077,riveting,1,1.8364528545823171e-06,1,2.2780963315814773e-06,0,0
17078,wheeling,1,1.8364528545823171e-06,1,2.2780963315814773e-06,0,0
17081,avenatti,1,1.8364528545823171e-06,1,2.2780963315814773e-06,0,0
17085,boards,1,1.8364528545823171e-06,1,2.2780963315814773e-06,0,0
17084,1384,1,1.8364528545823171e-06,1,2.2780963315814773e-06,0,0
17083,1347,1,1.8364528545823171e-06,1,2.2780963315814773e-06,0,0
17088,hassan,1,1.8364528545823171e-06,1,2.2780963315814773e-06,0,0
17090,favorability,1,1.8364528545823171e-06,1,2.2780963315814773e-06,0,0
17092,acquisitions,1,1.8364528545823171e-06,1,2.2780963315814773e-06,0,0
17094,states-korea,1,1.8364528545823171e-06,1,2.2780963315814773e-06,0,0
17095,us-korea,1,1.8364528545823171e-06,1,2.2780963315814773e-06,0,0
17096,@moonriver365,1,1.8364528545823171e-06,1,2.2780963315814773e-06,0,0
17098,#unga➡️,1,1.8364528545823171e-06,1,2.2780963315814773e-06,0,0
17099,minster,1,1.8364528545823171e-06,1,2.2780963315814773e-06,0,0
17101,5895,1,1.8364528545823171e-06,1,2.2780963315814773e-06,0,0
17105,perceived,1,1.8364528545823171e-06,1,2.2780963315814773e-06,0,0
17110,pfc,1,1.8364528545823171e-06,1,2.2780963315814773e-06,0,0
17109,nash,1,1.8364528545823171e-06,1,2.2780963315814773e-06,0,0
17111,week🇺🇸🇯🇵,1,1.8364528545823171e-06,1,2.2780963315814773e-06,0,0
17112,@jaywebbernj,1,1.8364528545823171e-06,1,2.2780963315814773e-06,0,0
17115,recommits,1,1.8364528545823171e-06,1,2.2780963315814773e-06,0,0
17116,ferrara,1,1.8364528545823171e-06,1,2.2780963315814773e-06,0,0
17117,2032,1,1.8364528545823171e-06,1,2.2780963315814773e-06,0,0
17118,pad,1,1.8364528545823171e-06,1,2.2780963315814773e-06,0,0
17119,@prezydentpl,1,1.8364528545823171e-06,1,2.2780963315814773e-06,0,0
17122,biodefense,1,1.8364528545823171e-06,1,2.2780963315814773e-06,0,0
17125,71st,1,1.8364528545823171e-06,1,2.2780963315814773e-06,0,0
17129,pharmacist,1,1.8364528545823171e-06,1,2.2780963315814773e-06,0,0
17131,chargeable,1,1.8364528545823171e-06,1,2.2780963315814773e-06,0,0
17134,testimony-,1,1.8364528545823171e-06,1,2.2780963315814773e-06,0,0
17136,unnoticeable,1,1.8364528545823171e-06,1,2.2780963315814773e-06,0,0
17138,profits-there,1,1.8364528545823171e-06,1,2.2780963315814773e-06,0,0
17139,#trumptime,1,1.8364528545823171e-06,1,2.2780963315814773e-06,0,0
17140,newfound,1,1.8364528545823171e-06,1,2.2780963315814773e-06,0,0
17142,recede,1,1.8364528545823171e-06,1,2.2780963315814773e-06,0,0
17143,dipping,1,1.8364528545823171e-06,1,2.2780963315814773e-06,0,0
17144,fiddle,1,1.8364528545823171e-06,1,2.2780963315814773e-06,0,0
17146,brock,1,1.8364528545823171e-06,1,2.2780963315814773e-06,0,0
17147,honorwe,1,1.8364528545823171e-06,1,2.2780963315814773e-06,0,0
17148,thatstory,1,1.8364528545823171e-06,1,2.2780963315814773e-06,0,0
17149,gwu,1,1.8364528545823171e-06,1,2.2780963315814773e-06,0,0
17152,evelyn,1,1.8364528545823171e-06,1,2.2780963315814773e-06,0,0
17153,rodriguez,1,1.8364528545823171e-06,1,2.2780963315814773e-06,0,0
17151,#ripevelyn,1,1.8364528545823171e-06,1,2.2780963315814773e-06,0,0
17155,couched,1,1.8364528545823171e-06,1,2.2780963315814773e-06,0,0
17156,#florencehurricane2018,1,1.8364528545823171e-06,1,2.2780963315814773e-06,0,0
17157,undercut,1,1.8364528545823171e-06,1,2.2780963315814773e-06,0,0
17160,collapsing,1,1.8364528545823171e-06,1,2.2780963315814773e-06,0,0
17161,banker,1,1.8364528545823171e-06,1,2.2780963315814773e-06,0,0
17162,bankers,1,1.8364528545823171e-06,1,2.2780963315814773e-06,0,0
17167,relates,1,1.8364528545823171e-06,1,2.2780963315814773e-06,0,0
17169,unappreciated,1,1.8364528545823171e-06,1,2.2780963315814773e-06,0,0
17173,laundered,1,1.8364528545823171e-06,1,2.2780963315814773e-06,0,0
17175,snuck,1,1.8364528545823171e-06,1,2.2780963315814773e-06,0,0
17172,collaborated,1,1.8364528545823171e-06,1,2.2780963315814773e-06,0,0
17177,shanksville,1,1.8364528545823171e-06,1,2.2780963315814773e-06,0,0
17178,holder,1,1.8364528545823171e-06,1,2.2780963315814773e-06,0,0
17181,documentation,1,1.8364528545823171e-06,1,2.2780963315814773e-06,0,0
17186,precautions,1,1.8364528545823171e-06,1,2.2780963315814773e-06,0,0
17185,mobilizing,1,1.8364528545823171e-06,1,2.2780963315814773e-06,0,0
17189,flailing,1,1.8364528545823171e-06,1,2.2780963315814773e-06,0,0
17188,endure-and,1,1.8364528545823171e-06,1,2.2780963315814773e-06,0,0
17190,@savannahguthrie,1,1.8364528545823171e-06,1,2.2780963315814773e-06,0,0
17191,@todayshow,1,1.8364528545823171e-06,1,2.2780963315814773e-06,0,0
17195,katelyn,1,1.8364528545823171e-06,1,2.2780963315814773e-06,0,0
17193,caralle,1,1.8364528545823171e-06,1,2.2780963315814773e-06,0,0
17199,choking,1,1.8364528545823171e-06,1,2.2780963315814773e-06,0,0
17202,shana,1,1.8364528545823171e-06,1,2.2780963315814773e-06,0,0
17203,customary,1,1.8364528545823171e-06,1,2.2780963315814773e-06,0,0
17205,feats,1,1.8364528545823171e-06,1,2.2780963315814773e-06,0,0
17206,percent-plus,1,1.8364528545823171e-06,1,2.2780963315814773e-06,0,0
17204,cnbcalso,1,1.8364528545823171e-06,1,2.2780963315814773e-06,0,0
17207,ripped-off,1,1.8364528545823171e-06,1,2.2780963315814773e-06,0,0
17209,chinese-made,1,1.8364528545823171e-06,1,2.2780963315814773e-06,0,0
17212,playbook-call,1,1.8364528545823171e-06,1,2.2780963315814773e-06,0,0
17217,fealty,1,1.8364528545823171e-06,1,2.2780963315814773e-06,0,0
17214,buoy,1,1.8364528545823171e-06,1,2.2780963315814773e-06,0,0
17215,commodity,1,1.8364528545823171e-06,1,2.2780963315814773e-06,0,0
17218,nicholas,1,1.8364528545823171e-06,1,2.2780963315814773e-06,0,0
17216,fandos,1,1.8364528545823171e-06,1,2.2780963315814773e-06,0,0
17219,incentive,1,1.8364528545823171e-06,1,2.2780963315814773e-06,0,0
17221,hughes,1,1.8364528545823171e-06,1,2.2780963315814773e-06,0,0
17220,amendmen,1,1.8364528545823171e-06,1,2.2780963315814773e-06,0,0
17222,petterson,1,1.8364528545823171e-06,1,2.2780963315814773e-06,0,0
17225,frequently,1,1.8364528545823171e-06,1,2.2780963315814773e-06,0,0
17226,quoted,1,1.8364528545823171e-06,1,2.2780963315814773e-06,0,0
17228,faithfully,1,1.8364528545823171e-06,1,2.2780963315814773e-06,0,0
17229,cosumer,1,1.8364528545823171e-06,1,2.2780963315814773e-06,0,0
17232,unnerving,1,1.8364528545823171e-06,1,2.2780963315814773e-06,0,0
17230,detractors,1,1.8364528545823171e-06,1,2.2780963315814773e-06,0,0
17234,himher,1,1.8364528545823171e-06,1,2.2780963315814773e-06,0,0
17236,mdt,1,1.8364528545823171e-06,1,2.2780963315814773e-06,0,0
17235,billings,1,1.8364528545823171e-06,1,2.2780963315814773e-06,0,0
17238,boycotts,1,1.8364528545823171e-06,1,2.2780963315814773e-06,0,0
17239,#farmbill,1,1.8364528545823171e-06,1,2.2780963315814773e-06,0,0
17240,bolster,1,1.8364528545823171e-06,1,2.2780963315814773e-06,0,0
17242,everything-which,1,1.8364528545823171e-06,1,2.2780963315814773e-06,0,0
17246,retarded,1,1.8364528545823171e-06,1,2.2780963315814773e-06,0,0
17251,inflict,1,1.8364528545823171e-06,1,2.2780963315814773e-06,0,0
17253,renowned,1,1.8364528545823171e-06,1,2.2780963315814773e-06,0,0
17252,jurists,1,1.8364528545823171e-06,1,2.2780963315814773e-06,0,0
17254,kyl,1,1.8364528545823171e-06,1,2.2780963315814773e-06,0,0
17255,#gordon,1,1.8364528545823171e-06,1,2.2780963315814773e-06,0,0
17257,fumbling,1,1.8364528545823171e-06,1,2.2780963315814773e-06,0,0
17260,unethical,1,1.8364528545823171e-06,1,2.2780963315814773e-06,0,0
17259,standards-worse,1,1.8364528545823171e-06,1,2.2780963315814773e-06,0,0
17265,2014-2016,1,1.8364528545823171e-06,1,2.2780963315814773e-06,0,0
17267,assembling,1,1.8364528545823171e-06,1,2.2780963315814773e-06,0,0
17269,publicized,1,1.8364528545823171e-06,1,2.2780963315814773e-06,0,0
17272,againt,1,1.8364528545823171e-06,1,2.2780963315814773e-06,0,0
17273,africanamerican,1,1.8364528545823171e-06,1,2.2780963315814773e-06,0,0
17274,foreman,1,1.8364528545823171e-06,1,2.2780963315814773e-06,0,0
17277,connections,1,1.8364528545823171e-06,1,2.2780963315814773e-06,0,0
17278,exchanged,1,1.8364528545823171e-06,1,2.2780963315814773e-06,0,0
17275,blinded,1,1.8364528545823171e-06,1,2.2780963315814773e-06,0,0
17279,intermediary,1,1.8364528545823171e-06,1,2.2780963315814773e-06,0,0
17282,weissman,1,1.8364528545823171e-06,1,2.2780963315814773e-06,0,0
17284,vat,1,1.8364528545823171e-06,1,2.2780963315814773e-06,0,0
17286,filters,1,1.8364528545823171e-06,1,2.2780963315814773e-06,0,0
17289,documentsit,1,1.8364528545823171e-06,1,2.2780963315814773e-06,0,0
17290,@rasmussenpoll,1,1.8364528545823171e-06,1,2.2780963315814773e-06,0,0
17291,stitt,1,1.8364528545823171e-06,1,2.2780963315814773e-06,0,0
17292,frantically,1,1.8364528545823171e-06,1,2.2780963315814773e-06,0,0
17293,evansville,1,1.8364528545823171e-06,1,2.2780963315814773e-06,0,0
17295,fluent,1,1.8364528545823171e-06,1,2.2780963315814773e-06,0,0
17298,mcgahnthe,1,1.8364528545823171e-06,1,2.2780963315814773e-06,0,0
17299,purposelyso,1,1.8364528545823171e-06,1,2.2780963315814773e-06,0,0
17297,exist-just,1,1.8364528545823171e-06,1,2.2780963315814773e-06,0,0
17302,lacky,1,1.8364528545823171e-06,1,2.2780963315814773e-06,0,0
17301,fudging,1,1.8364528545823171e-06,1,2.2780963315814773e-06,0,0
17303,function,1,1.8364528545823171e-06,1,2.2780963315814773e-06,0,0
17307,rosemary,1,1.8364528545823171e-06,1,2.2780963315814773e-06,0,0
17305,collier,1,1.8364528545823171e-06,1,2.2780963315814773e-06,0,0
17306,referral,1,1.8364528545823171e-06,1,2.2780963315814773e-06,0,0
17308,perpetrate,1,1.8364528545823171e-06,1,2.2780963315814773e-06,0,0
17310,@carlbernstein,1,1.8364528545823171e-06,1,2.2780963315814773e-06,0,0
17315,us-south,1,1.8364528545823171e-06,1,2.2780963315814773e-06,0,0
17316,uschina,1,1.8364528545823171e-06,1,2.2780963315814773e-06,0,0
17318,fertilizer,1,1.8364528545823171e-06,1,2.2780963315814773e-06,0,0
17317,commodities,1,1.8364528545823171e-06,1,2.2780963315814773e-06,0,0
17319,nonetheless,1,1.8364528545823171e-06,1,2.2780963315814773e-06,0,0
17320,housepresident,1,1.8364528545823171e-06,1,2.2780963315814773e-06,0,0
17321,morphing,1,1.8364528545823171e-06,1,2.2780963315814773e-06,0,0
17322,donethey,1,1.8364528545823171e-06,1,2.2780963315814773e-06,0,0
17323,scary,1,1.8364528545823171e-06,1,2.2780963315814773e-06,0,0
17324,dreama,1,1.8364528545823171e-06,1,2.2780963315814773e-06,0,0
17325,flakeand,1,1.8364528545823171e-06,1,2.2780963315814773e-06,0,0
17326,clearances,1,1.8364528545823171e-06,1,2.2780963315814773e-06,0,0
17333,dealsand,1,1.8364528545823171e-06,1,2.2780963315814773e-06,0,0
17335,kenya,1,1.8364528545823171e-06,1,2.2780963315814773e-06,0,0
17334,@ukenyatta,1,1.8364528545823171e-06,1,2.2780963315814773e-06,0,0
17336,kenyatta,1,1.8364528545823171e-06,1,2.2780963315814773e-06,0,0
17337,states-mexico,1,1.8364528545823171e-06,1,2.2780963315814773e-06,0,0
17338,ducey,1,1.8364528545823171e-06,1,2.2780963315814773e-06,0,0
17339,floridastrong,1,1.8364528545823171e-06,1,2.2780963315814773e-06,0,0
17340,@jimbrownnfl32,1,1.8364528545823171e-06,1,2.2780963315814773e-06,0,0
17341,rewrite,1,1.8364528545823171e-06,1,2.2780963315814773e-06,0,0
17342,togethera,1,1.8364528545823171e-06,1,2.2780963315814773e-06,0,0
17343,675000,1,1.8364528545823171e-06,1,2.2780963315814773e-06,0,0
17345,untouched,1,1.8364528545823171e-06,1,2.2780963315814773e-06,0,0
17348,michaels,1,1.8364528545823171e-06,1,2.2780963315814773e-06,0,0
17350,#statedinner2018,1,1.8364528545823171e-06,1,2.2780963315814773e-06,0,0
17352,australian,1,1.8364528545823171e-06,1,2.2780963315814773e-06,0,0
17355,ige,1,1.8364528545823171e-06,1,2.2780963315814773e-06,0,0
17358,silencing,1,1.8364528545823171e-06,1,2.2780963315814773e-06,0,0
17357,gravely,1,1.8364528545823171e-06,1,2.2780963315814773e-06,0,0
17359,ex-nsa,1,1.8364528545823171e-06,1,2.2780963315814773e-06,0,0
17360,redaction,1,1.8364528545823171e-06,1,2.2780963315814773e-06,0,0
17364,raves,1,1.8364528545823171e-06,1,2.2780963315814773e-06,0,0
17368,@mikepompeo4usa,1,1.8364528545823171e-06,1,2.2780963315814773e-06,0,0
17369,bull,1,1.8364528545823171e-06,1,2.2780963315814773e-06,0,0
17370,@nwshonolulu,1,1.8364528545823171e-06,1,2.2780963315814773e-06,0,0
17371,assemblyman,1,1.8364528545823171e-06,1,2.2780963315814773e-06,0,0
17375,friess,1,1.8364528545823171e-06,1,2.2780963315814773e-06,0,0
17378,admonished,1,1.8364528545823171e-06,1,2.2780963315814773e-06,0,0
17381,stamina-i,1,1.8364528545823171e-06,1,2.2780963315814773e-06,0,0
17386,phillip,1,1.8364528545823171e-06,1,2.2780963315814773e-06,0,0
17387,unglued,1,1.8364528545823171e-06,1,2.2780963315814773e-06,0,0
17382,@parisdennard,1,1.8364528545823171e-06,1,2.2780963315814773e-06,0,0
17384,dennard,1,1.8364528545823171e-06,1,2.2780963315814773e-06,0,0
17388,@dianeharkey,1,1.8364528545823171e-06,1,2.2780963315814773e-06,0,0
17389,issa-with,1,1.8364528545823171e-06,1,2.2780963315814773e-06,0,0
17390,vets-has,1,1.8364528545823171e-06,1,2.2780963315814773e-06,0,0
17392,synthetic,1,1.8364528545823171e-06,1,2.2780963315814773e-06,0,0
17396,firings,1,1.8364528545823171e-06,1,2.2780963315814773e-06,0,0
17397,resignations,1,1.8364528545823171e-06,1,2.2780963315814773e-06,0,0
17400,loudmouth,1,1.8364528545823171e-06,1,2.2780963315814773e-06,0,0
17402,weeding,1,1.8364528545823171e-06,1,2.2780963315814773e-06,0,0
17406,gratuity,1,1.8364528545823171e-06,1,2.2780963315814773e-06,0,0
17407,violationall,1,1.8364528545823171e-06,1,2.2780963315814773e-06,0,0
17405,crimesbecause,1,1.8364528545823171e-06,1,2.2780963315814773e-06,0,0
17410,astonishingthat,1,1.8364528545823171e-06,1,2.2780963315814773e-06,0,0
17411,blinders,1,1.8364528545823171e-06,1,2.2780963315814773e-06,0,0
17413,blunder,1,1.8364528545823171e-06,1,2.2780963315814773e-06,0,0
17414,hightax,1,1.8364528545823171e-06,1,2.2780963315814773e-06,0,0
17415,resign-he,1,1.8364528545823171e-06,1,2.2780963315814773e-06,0,0
17419,celebratory,1,1.8364528545823171e-06,1,2.2780963315814773e-06,0,0
17420,breach,1,1.8364528545823171e-06,1,2.2780963315814773e-06,0,0
17421,cmte,1,1.8364528545823171e-06,1,2.2780963315814773e-06,0,0
17423,purport,1,1.8364528545823171e-06,1,2.2780963315814773e-06,0,0
17427,sobbingly,1,1.8364528545823171e-06,1,2.2780963315814773e-06,0,0
17428,intellectually,1,1.8364528545823171e-06,1,2.2780963315814773e-06,0,0
17429,dojs,1,1.8364528545823171e-06,1,2.2780963315814773e-06,0,0
17431,shopped,1,1.8364528545823171e-06,1,2.2780963315814773e-06,0,0
17432,aretha,1,1.8364528545823171e-06,1,2.2780963315814773e-06,0,0
17433,countrybut,1,1.8364528545823171e-06,1,2.2780963315814773e-06,0,0
17434,koreans,1,1.8364528545823171e-06,1,2.2780963315814773e-06,0,0
17435,gong,1,1.8364528545823171e-06,1,2.2780963315814773e-06,0,0
17439,wrongs,1,1.8364528545823171e-06,1,2.2780963315814773e-06,0,0
17441,originators,1,1.8364528545823171e-06,1,2.2780963315814773e-06,0,0
17444,stefanowski,1,1.8364528545823171e-06,1,2.2780963315814773e-06,0,0
17446,leah,1,1.8364528545823171e-06,1,2.2780963315814773e-06,0,0
17447,vukmir,1,1.8364528545823171e-06,1,2.2780963315814773e-06,0,0
17448,enters,1,1.8364528545823171e-06,1,2.2780963315814773e-06,0,0
17451,londonthese,1,1.8364528545823171e-06,1,2.2780963315814773e-06,0,0
17452,underpinnings,1,1.8364528545823171e-06,1,2.2780963315814773e-06,0,0
17453,animus,1,1.8364528545823171e-06,1,2.2780963315814773e-06,0,0
17454,criminally,1,1.8364528545823171e-06,1,2.2780963315814773e-06,0,0
17456,machinations,1,1.8364528545823171e-06,1,2.2780963315814773e-06,0,0
17459,vocabulary,1,1.8364528545823171e-06,1,2.2780963315814773e-06,0,0
17460,jobs-and,1,1.8364528545823171e-06,1,2.2780963315814773e-06,0,0
17461,stauber,1,1.8364528545823171e-06,1,2.2780963315814773e-06,0,0
17462,koepka,1,1.8364528545823171e-06,1,2.2780963315814773e-06,0,0
17465,formerly,1,1.8364528545823171e-06,1,2.2780963315814773e-06,0,0
17466,redone,1,1.8364528545823171e-06,1,2.2780963315814773e-06,0,0
17468,baldersons,1,1.8364528545823171e-06,1,2.2780963315814773e-06,0,0
17470,tamping,1,1.8364528545823171e-06,1,2.2780963315814773e-06,0,0
17469,kasichs,1,1.8364528545823171e-06,1,2.2780963315814773e-06,0,0
17471,unpopularity,1,1.8364528545823171e-06,1,2.2780963315814773e-06,0,0
17473,@harleydavidson,1,1.8364528545823171e-06,1,2.2780963315814773e-06,0,0
17475,premised,1,1.8364528545823171e-06,1,2.2780963315814773e-06,0,0
17476,resulted,1,1.8364528545823171e-06,1,2.2780963315814773e-06,0,0
17478,massages,1,1.8364528545823171e-06,1,2.2780963315814773e-06,0,0
17480,veered,1,1.8364528545823171e-06,1,2.2780963315814773e-06,0,0
17481,lira,1,1.8364528545823171e-06,1,2.2780963315814773e-06,0,0
17482,slides,1,1.8364528545823171e-06,1,2.2780963315814773e-06,0,0
17483,overt,1,1.8364528545823171e-06,1,2.2780963315814773e-06,0,0
17484,entrapment,1,1.8364528545823171e-06,1,2.2780963315814773e-06,0,0
17485,yoho,1,1.8364528545823171e-06,1,2.2780963315814773e-06,0,0
17487,@lenaepstein,1,1.8364528545823171e-06,1,2.2780963315814773e-06,0,0
17490,236th,1,1.8364528545823171e-06,1,2.2780963315814773e-06,0,0
17491,vanguard,1,1.8364528545823171e-06,1,2.2780963315814773e-06,0,0
17489,#purpleheartday,1,1.8364528545823171e-06,1,2.2780963315814773e-06,0,0
17493,ratchet,1,1.8364528545823171e-06,1,2.2780963315814773e-06,0,0
17497,happenalso,1,1.8364528545823171e-06,1,2.2780963315814773e-06,0,0
17498,priority-and,1,1.8364528545823171e-06,1,2.2780963315814773e-06,0,0
17501,cometax,1,1.8364528545823171e-06,1,2.2780963315814773e-06,0,0
17503,oconnor,1,1.8364528545823171e-06,1,2.2780963315814773e-06,0,0
17504,ohios,1,1.8364528545823171e-06,1,2.2780963315814773e-06,0,0
17505,tariffs-,1,1.8364528545823171e-06,1,2.2780963315814773e-06,0,0
17506,4months,1,1.8364528545823171e-06,1,2.2780963315814773e-06,0,0
17508,amendment-and,1,1.8364528545823171e-06,1,2.2780963315814773e-06,0,0
17509,pelosihigh,1,1.8364528545823171e-06,1,2.2780963315814773e-06,0,0
17514,extinguishers,1,1.8364528545823171e-06,1,2.2780963315814773e-06,0,0
17513,@thefive,1,1.8364528545823171e-06,1,2.2780963315814773e-06,0,0
17516,1970,1,1.8364528545823171e-06,1,2.2780963315814773e-06,0,0
17517,pro-black,1,1.8364528545823171e-06,1,2.2780963315814773e-06,0,0
17520,stivers,1,1.8364528545823171e-06,1,2.2780963315814773e-06,0,0
17519,@nrcc,1,1.8364528545823171e-06,1,2.2780963315814773e-06,0,0
17521,predictable,1,1.8364528545823171e-06,1,2.2780963315814773e-06,0,0
17522,honolulu,1,1.8364528545823171e-06,1,2.2780963315814773e-06,0,0
17526,payrolls,1,1.8364528545823171e-06,1,2.2780963315814773e-06,0,0
17524,219000,1,1.8364528545823171e-06,1,2.2780963315814773e-06,0,0
17525,adp,1,1.8364528545823171e-06,1,2.2780963315814773e-06,0,0
17528,wilkes-barre,1,1.8364528545823171e-06,1,2.2780963315814773e-06,0,0
17529,#pledgetoamericasworkers,1,1.8364528545823171e-06,1,2.2780963315814773e-06,0,0
17531,alfonse,1,1.8364528545823171e-06,1,2.2780963315814773e-06,0,0
17533,reagandole,1,1.8364528545823171e-06,1,2.2780963315814773e-06,0,0
17532,darling,1,1.8364528545823171e-06,1,2.2780963315814773e-06,0,0
17535,objectivity,1,1.8364528545823171e-06,1,2.2780963315814773e-06,0,0
17536,improper,1,1.8364528545823171e-06,1,2.2780963315814773e-06,0,0
17537,viability,1,1.8364528545823171e-06,1,2.2780963315814773e-06,0,0
17540,@repdesantis,1,1.8364528545823171e-06,1,2.2780963315814773e-06,0,0
17541,3-d,1,1.8364528545823171e-06,1,2.2780963315814773e-06,0,0
17542,plastic,1,1.8364528545823171e-06,1,2.2780963315814773e-06,0,0
17543,31174,1,1.8364528545823171e-06,1,2.2780963315814773e-06,0,0
17544,reuniting,1,1.8364528545823171e-06,1,2.2780963315814773e-06,0,0
17546,best-selling,1,1.8364528545823171e-06,1,2.2780963315814773e-06,0,0
17548,🇺🇸🇮🇹,1,1.8364528545823171e-06,1,2.2780963315814773e-06,0,0
17549,200pme,1,1.8364528545823171e-06,1,2.2780963315814773e-06,0,0
17550,obamaand,1,1.8364528545823171e-06,1,2.2780963315814773e-06,0,0
17551,side-podesta,1,1.8364528545823171e-06,1,2.2780963315814773e-06,0,0
17552,contentious,1,1.8364528545823171e-06,1,2.2780963315814773e-06,0,0
17553,deliberations,1,1.8364528545823171e-06,1,2.2780963315814773e-06,0,0
17554,unpatriotic,1,1.8364528545823171e-06,1,2.2780963315814773e-06,0,0
17556,morphed,1,1.8364528545823171e-06,1,2.2780963315814773e-06,0,0
17557,recheck,1,1.8364528545823171e-06,1,2.2780963315814773e-06,0,0
17559,@usnavys,1,1.8364528545823171e-06,1,2.2780963315814773e-06,0,0
17561,duerk,1,1.8364528545823171e-06,1,2.2780963315814773e-06,0,0
17562,notoriety,1,1.8364528545823171e-06,1,2.2780963315814773e-06,0,0
17563,@johnjamesmi,1,1.8364528545823171e-06,1,2.2780963315814773e-06,0,0
17565,jam,1,1.8364528545823171e-06,1,2.2780963315814773e-06,0,0
17566,taxi,1,1.8364528545823171e-06,1,2.2780963315814773e-06,0,0
17564,cabs,1,1.8364528545823171e-06,1,2.2780963315814773e-06,0,0
17569,reopening,1,1.8364528545823171e-06,1,2.2780963315814773e-06,0,0
17570,clarity,1,1.8364528545823171e-06,1,2.2780963315814773e-06,0,0
17572,detainment,1,1.8364528545823171e-06,1,2.2780963315814773e-06,0,0
17575,believers,1,1.8364528545823171e-06,1,2.2780963315814773e-06,0,0
17577,marchionne,1,1.8364528545823171e-06,1,2.2780963315814773e-06,0,0
17578,#irfministerial,1,1.8364528545823171e-06,1,2.2780963315814773e-06,0,0
17579,#religiousfreedom,1,1.8364528545823171e-06,1,2.2780963315814773e-06,0,0
17580,@irfambassador,1,1.8364528545823171e-06,1,2.2780963315814773e-06,0,0
17581,69-30,1,1.8364528545823171e-06,1,2.2780963315814773e-06,0,0
17582,presumably,1,1.8364528545823171e-06,1,2.2780963315814773e-06,0,0
17583,taped,1,1.8364528545823171e-06,1,2.2780963315814773e-06,0,0
17584,517,1,1.8364528545823171e-06,1,2.2780963315814773e-06,0,0
17586,snipping,1,1.8364528545823171e-06,1,2.2780963315814773e-06,0,0
17587,817,1,1.8364528545823171e-06,1,2.2780963315814773e-06,0,0
17588,merger,1,1.8364528545823171e-06,1,2.2780963315814773e-06,0,0
17590,tribune,1,1.8364528545823171e-06,1,2.2780963315814773e-06,0,0
17594,#perkinscte,1,1.8364528545823171e-06,1,2.2780963315814773e-06,0,0
17593,#jobs,1,1.8364528545823171e-06,1,2.2780963315814773e-06,0,0
17595,#workforce,1,1.8364528545823171e-06,1,2.2780963315814773e-06,0,0
17596,vfw,1,1.8364528545823171e-06,1,2.2780963315814773e-06,0,0
17597,negotiates,1,1.8364528545823171e-06,1,2.2780963315814773e-06,0,0
17599,butas,1,1.8364528545823171e-06,1,2.2780963315814773e-06,0,0
17600,cooperated,1,1.8364528545823171e-06,1,2.2780963315814773e-06,0,0
17602,pretext,1,1.8364528545823171e-06,1,2.2780963315814773e-06,0,0
17601,pagewas,1,1.8364528545823171e-06,1,2.2780963315814773e-06,0,0
17603,615,1,1.8364528545823171e-06,1,2.2780963315814773e-06,0,0
17604,cautious,1,1.8364528545823171e-06,1,2.2780963315814773e-06,0,0
17607,barricaded,1,1.8364528545823171e-06,1,2.2780963315814773e-06,0,0
17608,lapd,1,1.8364528545823171e-06,1,2.2780963315814773e-06,0,0
17609,@mikepencevp,1,1.8364528545823171e-06,1,2.2780963315814773e-06,0,0
17612,seasonno,1,1.8364528545823171e-06,1,2.2780963315814773e-06,0,0
17613,275,1,1.8364528545823171e-06,1,2.2780963315814773e-06,0,0
17614,penalized,1,1.8364528545823171e-06,1,2.2780963315814773e-06,0,0
17615,recapture,1,1.8364528545823171e-06,1,2.2780963315814773e-06,0,0
17616,problemsbut,1,1.8364528545823171e-06,1,2.2780963315814773e-06,0,0
17617,slapped,1,1.8364528545823171e-06,1,2.2780963315814773e-06,0,0
17619,novartis,1,1.8364528545823171e-06,1,2.2780963315814773e-06,0,0
17621,yoder,1,1.8364528545823171e-06,1,2.2780963315814773e-06,0,0
17620,@repkevinyoder,1,1.8364528545823171e-06,1,2.2780963315814773e-06,0,0
17622,fruition,1,1.8364528545823171e-06,1,2.2780963315814773e-06,0,0
17623,gates,1,1.8364528545823171e-06,1,2.2780963315814773e-06,0,0
17629,possession,1,1.8364528545823171e-06,1,2.2780963315814773e-06,0,0
17632,gaetz,1,1.8364528545823171e-06,1,2.2780963315814773e-06,0,0
17633,#nato2018,1,1.8364528545823171e-06,1,2.2780963315814773e-06,0,0
17634,#natosummit2018,1,1.8364528545823171e-06,1,2.2780963315814773e-06,0,0
17636,loveragent,1,1.8364528545823171e-06,1,2.2780963315814773e-06,0,0
17635,dodging,1,1.8364528545823171e-06,1,2.2780963315814773e-06,0,0
17637,agentlover,1,1.8364528545823171e-06,1,2.2780963315814773e-06,0,0
17639,ex-fbi,1,1.8364528545823171e-06,1,2.2780963315814773e-06,0,0
17640,layer,1,1.8364528545823171e-06,1,2.2780963315814773e-06,0,0
17638,defied,1,1.8364528545823171e-06,1,2.2780963315814773e-06,0,0
17642,soy,1,1.8364528545823171e-06,1,2.2780963315814773e-06,0,0
17641,beans,1,1.8364528545823171e-06,1,2.2780963315814773e-06,0,0
17644,epoll,1,1.8364528545823171e-06,1,2.2780963315814773e-06,0,0
17645,reimburse,1,1.8364528545823171e-06,1,2.2780963315814773e-06,0,0
17648,thai,1,1.8364528545823171e-06,1,2.2780963315814773e-06,0,0
17647,seals,1,1.8364528545823171e-06,1,2.2780963315814773e-06,0,0
17650,treacherous,1,1.8364528545823171e-06,1,2.2780963315814773e-06,0,0
17652,indispensable,1,1.8364528545823171e-06,1,2.2780963315814773e-06,0,0
17651,#centuryofservice,1,1.8364528545823171e-06,1,2.2780963315814773e-06,0,0
17654,malnutrition,1,1.8364528545823171e-06,1,2.2780963315814773e-06,0,0
17655,exerting,1,1.8364528545823171e-06,1,2.2780963315814773e-06,0,0
17656,posture,1,1.8364528545823171e-06,1,2.2780963315814773e-06,0,0
17657,trade-hope,1,1.8364528545823171e-06,1,2.2780963315814773e-06,0,0
17663,warships2015,1,1.8364528545823171e-06,1,2.2780963315814773e-06,0,0
17661,222016,1,1.8364528545823171e-06,1,2.2780963315814773e-06,0,0
17662,362017,1,1.8364528545823171e-06,1,2.2780963315814773e-06,0,0
17660,142018,1,1.8364528545823171e-06,1,2.2780963315814773e-06,0,0
17659,0source,1,1.8364528545823171e-06,1,2.2780963315814773e-06,0,0
17665,liberating,1,1.8364528545823171e-06,1,2.2780963315814773e-06,0,0
17669,julyour,1,1.8364528545823171e-06,1,2.2780963315814773e-06,0,0
17671,sweat,1,1.8364528545823171e-06,1,2.2780963315814773e-06,0,0
17675,introduction,1,1.8364528545823171e-06,1,2.2780963315814773e-06,0,0
17677,pore,1,1.8364528545823171e-06,1,2.2780963315814773e-06,0,0
17679,discgrace,1,1.8364528545823171e-06,1,2.2780963315814773e-06,0,0
17680,685,1,1.8364528545823171e-06,1,2.2780963315814773e-06,0,0
17683,korea-it,1,1.8364528545823171e-06,1,2.2780963315814773e-06,0,0
17685,elelments,1,1.8364528545823171e-06,1,2.2780963315814773e-06,0,0
17690,rutte,1,1.8364528545823171e-06,1,2.2780963315814773e-06,0,0
17689,netherlands,1,1.8364528545823171e-06,1,2.2780963315814773e-06,0,0
17691,escort,1,1.8364528545823171e-06,1,2.2780963315814773e-06,0,0
17693,630pmtickets➜,1,1.8364528545823171e-06,1,2.2780963315814773e-06,0,0
17694,differenceprices,1,1.8364528545823171e-06,1,2.2780963315814773e-06,0,0
17695,eradicating,1,1.8364528545823171e-06,1,2.2780963315814773e-06,0,0
17696,grasp,1,1.8364528545823171e-06,1,2.2780963315814773e-06,0,0
17697,situations,1,1.8364528545823171e-06,1,2.2780963315814773e-06,0,0
17701,22000000,1,1.8364528545823171e-06,1,2.2780963315814773e-06,0,0
17703,gig,1,1.8364528545823171e-06,1,2.2780963315814773e-06,0,0
17704,muellercomey,1,1.8364528545823171e-06,1,2.2780963315814773e-06,0,0
17705,@sharkgregnorman,1,1.8364528545823171e-06,1,2.2780963315814773e-06,0,0
17706,@amykremer,1,1.8364528545823171e-06,1,2.2780963315814773e-06,0,0
17708,hillaryrussia,1,1.8364528545823171e-06,1,2.2780963315814773e-06,0,0
17712,shameless,1,1.8364528545823171e-06,1,2.2780963315814773e-06,0,0
17711,leftwing,1,1.8364528545823171e-06,1,2.2780963315814773e-06,0,0
17713,scheels,1,1.8364528545823171e-06,1,2.2780963315814773e-06,0,0
17717,rebelo,1,1.8364528545823171e-06,1,2.2780963315814773e-06,0,0
17718,sousa,1,1.8364528545823171e-06,1,2.2780963315814773e-06,0,0
17716,portugal,1,1.8364528545823171e-06,1,2.2780963315814773e-06,0,0
17714,@whitehouse🇺🇸🇵🇹,1,1.8364528545823171e-06,1,2.2780963315814773e-06,0,0
17719,#ndsen,1,1.8364528545823171e-06,1,2.2780963315814773e-06,0,0
17720,non-union,1,1.8364528545823171e-06,1,2.2780963315814773e-06,0,0
17721,rants,1,1.8364528545823171e-06,1,2.2780963315814773e-06,0,0
17722,crowley,1,1.8364528545823171e-06,1,2.2780963315814773e-06,0,0
17729,lieutenant,1,1.8364528545823171e-06,1,2.2780963315814773e-06,0,0
17728,garlin,1,1.8364528545823171e-06,1,2.2780963315814773e-06,0,0
17730,murl,1,1.8364528545823171e-06,1,2.2780963315814773e-06,0,0
17727,conner,1,1.8364528545823171e-06,1,2.2780963315814773e-06,0,0
17726,chronicle,1,1.8364528545823171e-06,1,2.2780963315814773e-06,0,0
17732,futureand,1,1.8364528545823171e-06,1,2.2780963315814773e-06,0,0
17734,country-never,1,1.8364528545823171e-06,1,2.2780963315814773e-06,0,0
17733,aura,1,1.8364528545823171e-06,1,2.2780963315814773e-06,0,0
17736,finishing,1,1.8364528545823171e-06,1,2.2780963315814773e-06,0,0
17737,chided,1,1.8364528545823171e-06,1,2.2780963315814773e-06,0,0
17738,tariffstrade,1,1.8364528545823171e-06,1,2.2780963315814773e-06,0,0
17739,unbalanced,1,1.8364528545823171e-06,1,2.2780963315814773e-06,0,0
17741,d-va,1,1.8364528545823171e-06,1,2.2780963315814773e-06,0,0
17742,drunken,1,1.8364528545823171e-06,1,2.2780963315814773e-06,0,0
17745,manythousands,1,1.8364528545823171e-06,1,2.2780963315814773e-06,0,0
17744,disfunctional,1,1.8364528545823171e-06,1,2.2780963315814773e-06,0,0
17746,uninvolved,1,1.8364528545823171e-06,1,2.2780963315814773e-06,0,0
17748,hen,1,1.8364528545823171e-06,1,2.2780963315814773e-06,0,0
17747,canopies,1,1.8364528545823171e-06,1,2.2780963315814773e-06,0,0
17750,mukasey,1,1.8364528545823171e-06,1,2.2780963315814773e-06,0,0
17751,@repclayhiggins,1,1.8364528545823171e-06,1,2.2780963315814773e-06,0,0
17753,@clayhiggins18,1,1.8364528545823171e-06,1,2.2780963315814773e-06,0,0
17754,@jimmyfallon,1,1.8364528545823171e-06,1,2.2780963315814773e-06,0,0
17755,humanized,1,1.8364528545823171e-06,1,2.2780963315814773e-06,0,0
17756,me-he,1,1.8364528545823171e-06,1,2.2780963315814773e-06,0,0
17758,insisting,1,1.8364528545823171e-06,1,2.2780963315814773e-06,0,0
17760,@nvgop,1,1.8364528545823171e-06,1,2.2780963315814773e-06,0,0
17761,clarence,1,1.8364528545823171e-06,1,2.2780963315814773e-06,0,0
17762,sidekick,1,1.8364528545823171e-06,1,2.2780963315814773e-06,0,0
17765,@rothfusforpa,1,1.8364528545823171e-06,1,2.2780963315814773e-06,0,0
17764,#lambthesham,1,1.8364528545823171e-06,1,2.2780963315814773e-06,0,0
17766,foil,1,1.8364528545823171e-06,1,2.2780963315814773e-06,0,0
17768,disability,1,1.8364528545823171e-06,1,2.2780963315814773e-06,0,0
17769,951,1,1.8364528545823171e-06,1,2.2780963315814773e-06,0,0
17770,associations,1,1.8364528545823171e-06,1,2.2780963315814773e-06,0,0
17771,plummet,1,1.8364528545823171e-06,1,2.2780963315814773e-06,0,0
17773,ric,1,1.8364528545823171e-06,1,2.2780963315814773e-06,0,0
17772,grenell,1,1.8364528545823171e-06,1,2.2780963315814773e-06,0,0
17774,ignores,1,1.8364528545823171e-06,1,2.2780963315814773e-06,0,0
17776,run-off,1,1.8364528545823171e-06,1,2.2780963315814773e-06,0,0
17777,congressmenwomen,1,1.8364528545823171e-06,1,2.2780963315814773e-06,0,0
17778,fairest,1,1.8364528545823171e-06,1,2.2780963315814773e-06,0,0
17780,melanias,1,1.8364528545823171e-06,1,2.2780963315814773e-06,0,0
17779,jacket,1,1.8364528545823171e-06,1,2.2780963315814773e-06,0,0
17781,@potuss,1,1.8364528545823171e-06,1,2.2780963315814773e-06,0,0
17782,democratsand,1,1.8364528545823171e-06,1,2.2780963315814773e-06,0,0
17784,endrosement,1,1.8364528545823171e-06,1,2.2780963315814773e-06,0,0
17785,rule-it,1,1.8364528545823171e-06,1,2.2780963315814773e-06,0,0
17786,mititary,1,1.8364528545823171e-06,1,2.2780963315814773e-06,0,0
17787,reciprocating,1,1.8364528545823171e-06,1,2.2780963315814773e-06,0,0
17788,password,1,1.8364528545823171e-06,1,2.2780963315814773e-06,0,0
17789,applauded,1,1.8364528545823171e-06,1,2.2780963315814773e-06,0,0
17790,breeds,1,1.8364528545823171e-06,1,2.2780963315814773e-06,0,0
17791,obstruct-want,1,1.8364528545823171e-06,1,2.2780963315814773e-06,0,0
17793,felipe,1,1.8364528545823171e-06,1,2.2780963315814773e-06,0,0
17795,vi,1,1.8364528545823171e-06,1,2.2780963315814773e-06,0,0
17794,letizia,1,1.8364528545823171e-06,1,2.2780963315814773e-06,0,0
17792,@whitehouse🇺🇸🇪🇸,1,1.8364528545823171e-06,1,2.2780963315814773e-06,0,0
17796,borderit,1,1.8364528545823171e-06,1,2.2780963315814773e-06,0,0
17798,@nfib,1,1.8364528545823171e-06,1,2.2780963315814773e-06,0,0
17797,#nfib75,1,1.8364528545823171e-06,1,2.2780963315814773e-06,0,0
17799,#changethelaws,1,1.8364528545823171e-06,1,2.2780963315814773e-06,0,0
17800,infest,1,1.8364528545823171e-06,1,2.2780963315814773e-06,0,0
17801,huntp,1,1.8364528545823171e-06,1,2.2780963315814773e-06,0,0
17802,strozk,1,1.8364528545823171e-06,1,2.2780963315814773e-06,0,0
17804,tenuous,1,1.8364528545823171e-06,1,2.2780963315814773e-06,0,0
17803,berlin,1,1.8364528545823171e-06,1,2.2780963315814773e-06,0,0
17805,violently,1,1.8364528545823171e-06,1,2.2780963315814773e-06,0,0
17808,counterparts,1,1.8364528545823171e-06,1,2.2780963315814773e-06,0,0
17810,hostagesremains,1,1.8364528545823171e-06,1,2.2780963315814773e-06,0,0
17811,#singaporesummit➡️,1,1.8364528545823171e-06,1,2.2780963315814773e-06,0,0
17813,rosensteins,1,1.8364528545823171e-06,1,2.2780963315814773e-06,0,0
17814,unquestionably,1,1.8364528545823171e-06,1,2.2780963315814773e-06,0,0
17815,cattle,1,1.8364528545823171e-06,1,2.2780963315814773e-06,0,0
17817,distroys,1,1.8364528545823171e-06,1,2.2780963315814773e-06,0,0
17819,jean-claude,1,1.8364528545823171e-06,1,2.2780963315814773e-06,0,0
17820,juncker,1,1.8364528545823171e-06,1,2.2780963315814773e-06,0,0
17821,tusk,1,1.8364528545823171e-06,1,2.2780963315814773e-06,0,0
17824,#flagday🇺🇸,1,1.8364528545823171e-06,1,2.2780963315814773e-06,0,0
17826,lingered,1,1.8364528545823171e-06,1,2.2780963315814773e-06,0,0
17825,disciples,1,1.8364528545823171e-06,1,2.2780963315814773e-06,0,0
17827,18800000,1,1.8364528545823171e-06,1,2.2780963315814773e-06,0,0
17828,19200000,1,1.8364528545823171e-06,1,2.2780963315814773e-06,0,0
17829,@kevincramer,1,1.8364528545823171e-06,1,2.2780963315814773e-06,0,0
17831,luxurious,1,1.8364528545823171e-06,1,2.2780963315814773e-06,0,0
17832,rvs,1,1.8364528545823171e-06,1,2.2780963315814773e-06,0,0
17834,downplay,1,1.8364528545823171e-06,1,2.2780963315814773e-06,0,0
17833,deal-looked,1,1.8364528545823171e-06,1,2.2780963315814773e-06,0,0
17835,promulgated,1,1.8364528545823171e-06,1,2.2780963315814773e-06,0,0
17837,kaine,1,1.8364528545823171e-06,1,2.2780963315814773e-06,0,0
17841,conciliation,1,1.8364528545823171e-06,1,2.2780963315814773e-06,0,0
17842,contained,1,1.8364528545823171e-06,1,2.2780963315814773e-06,0,0
17844,embraces,1,1.8364528545823171e-06,1,2.2780963315814773e-06,0,0
17846,ushered,1,1.8364528545823171e-06,1,2.2780963315814773e-06,0,0
17847,#singaporesummit,1,1.8364528545823171e-06,1,2.2780963315814773e-06,0,0
17849,unhelpful,1,1.8364528545823171e-06,1,2.2780963315814773e-06,0,0
17848,mia,1,1.8364528545823171e-06,1,2.2780963315814773e-06,0,0
17850,missle,1,1.8364528545823171e-06,1,2.2780963315814773e-06,0,0
17852,staffs,1,1.8364528545823171e-06,1,2.2780963315814773e-06,0,0
17853,hsien,1,1.8364528545823171e-06,1,2.2780963315814773e-06,0,0
17854,loong,1,1.8364528545823171e-06,1,2.2780963315814773e-06,0,0
17856,nato-protecting,1,1.8364528545823171e-06,1,2.2780963315814773e-06,0,0
17855,cost-and,1,1.8364528545823171e-06,1,2.2780963315814773e-06,0,0
17857,surplus-should,1,1.8364528545823171e-06,1,2.2780963315814773e-06,0,0
17858,surpluses,1,1.8364528545823171e-06,1,2.2780963315814773e-06,0,0
17859,17b,1,1.8364528545823171e-06,1,2.2780963315814773e-06,0,0
17861,meek,1,1.8364528545823171e-06,1,2.2780963315814773e-06,0,0
17862,mild,1,1.8364528545823171e-06,1,2.2780963315814773e-06,0,0
17864,justins,1,1.8364528545823171e-06,1,2.2780963315814773e-06,0,0
17863,communique,1,1.8364528545823171e-06,1,2.2780963315814773e-06,0,0
17866,charlevoix,1,1.8364528545823171e-06,1,2.2780963315814773e-06,0,0
17868,somolia,1,1.8364528545823171e-06,1,2.2780963315814773e-06,0,0
17871,ovechkin,1,1.8364528545823171e-06,1,2.2780963315814773e-06,0,0
17872,straightening,1,1.8364528545823171e-06,1,2.2780963315814773e-06,0,0
17874,thingsbut,1,1.8364528545823171e-06,1,2.2780963315814773e-06,0,0
17876,@whitehouse🇺🇸🇯🇵,1,1.8364528545823171e-06,1,2.2780963315814773e-06,0,0
17877,101,1,1.8364528545823171e-06,1,2.2780963315814773e-06,0,0
17878,utilities,1,1.8364528545823171e-06,1,2.2780963315814773e-06,0,0
17879,divert,1,1.8364528545823171e-06,1,2.2780963315814773e-06,0,0
17880,awan,1,1.8364528545823171e-06,1,2.2780963315814773e-06,0,0
17881,humiliatingly,1,1.8364528545823171e-06,1,2.2780963315814773e-06,0,0
17882,counselall,1,1.8364528545823171e-06,1,2.2780963315814773e-06,0,0
17884,councelall,1,1.8364528545823171e-06,1,2.2780963315814773e-06,0,0
17885,problembut,1,1.8364528545823171e-06,1,2.2780963315814773e-06,0,0
17886,federally,1,1.8364528545823171e-06,1,2.2780963315814773e-06,0,0
17887,#vamissionact,1,1.8364528545823171e-06,1,2.2780963315814773e-06,0,0
17889,74th,1,1.8364528545823171e-06,1,2.2780963315814773e-06,0,0
17888,1944,1,1.8364528545823171e-06,1,2.2780963315814773e-06,0,0
17891,merrily,1,1.8364528545823171e-06,1,2.2780963315814773e-06,0,0
17892,sighting,1,1.8364528545823171e-06,1,2.2780963315814773e-06,0,0
17893,facelift,1,1.8364528545823171e-06,1,2.2780963315814773e-06,0,0
17894,ceejay,1,1.8364528545823171e-06,1,2.2780963315814773e-06,0,0
17895,metcalf,1,1.8364528545823171e-06,1,2.2780963315814773e-06,0,0
17898,pale,1,1.8364528545823171e-06,1,2.2780963315814773e-06,0,0
17896,burglary,1,1.8364528545823171e-06,1,2.2780963315814773e-06,0,0
17899,tradecraft,1,1.8364528545823171e-06,1,2.2780963315814773e-06,0,0
17901,dating,1,1.8364528545823171e-06,1,2.2780963315814773e-06,0,0
17902,busted,1,1.8364528545823171e-06,1,2.2780963315814773e-06,0,0
17904,rescissions,1,1.8364528545823171e-06,1,2.2780963315814773e-06,0,0
17903,15000000000,1,1.8364528545823171e-06,1,2.2780963315814773e-06,0,0
17905,faulkner,1,1.8364528545823171e-06,1,2.2780963315814773e-06,0,0
17906,@rogerwicker,1,1.8364528545823171e-06,1,2.2780963315814773e-06,0,0
17908,worldhe,1,1.8364528545823171e-06,1,2.2780963315814773e-06,0,0
17909,separating,1,1.8364528545823171e-06,1,2.2780963315814773e-06,0,0
17912,bigwe,1,1.8364528545823171e-06,1,2.2780963315814773e-06,0,0
17913,himselfi,1,1.8364528545823171e-06,1,2.2780963315814773e-06,0,0
17914,ruinedand,1,1.8364528545823171e-06,1,2.2780963315814773e-06,0,0
17915,astros,1,1.8364528545823171e-06,1,2.2780963315814773e-06,0,0
17917,escaping,1,1.8364528545823171e-06,1,2.2780963315814773e-06,0,0
17919,#500days,1,1.8364528545823171e-06,1,2.2780963315814773e-06,0,0
17920,500th,1,1.8364528545823171e-06,1,2.2780963315814773e-06,0,0
17924,counseljustice,1,1.8364528545823171e-06,1,2.2780963315814773e-06,0,0
17925,counceljustice,1,1.8364528545823171e-06,1,2.2780963315814773e-06,0,0
17926,anti-trumpers,1,1.8364528545823171e-06,1,2.2780963315814773e-06,0,0
17927,irwin,1,1.8364528545823171e-06,1,2.2780963315814773e-06,0,0
17928,lumber,1,1.8364528545823171e-06,1,2.2780963315814773e-06,0,0
17931,bee,1,1.8364528545823171e-06,1,2.2780963315814773e-06,0,0
17932,dinesh,1,1.8364528545823171e-06,1,2.2780963315814773e-06,0,0
17933,dsouza,1,1.8364528545823171e-06,1,2.2780963315814773e-06,0,0
17934,infiltration,1,1.8364528545823171e-06,1,2.2780963315814773e-06,0,0
17937,offended,1,1.8364528545823171e-06,1,2.2780963315814773e-06,0,0
17942,novemberand,1,1.8364528545823171e-06,1,2.2780963315814773e-06,0,0
17943,@kimkardashian,1,1.8364528545823171e-06,1,2.2780963315814773e-06,0,0
17944,sentencing,1,1.8364528545823171e-06,1,2.2780963315814773e-06,0,0
17948,rockin,1,1.8364528545823171e-06,1,2.2780963315814773e-06,0,0
17949,tooand,1,1.8364528545823171e-06,1,2.2780963315814773e-06,0,0
17952,reptrey,1,1.8364528545823171e-06,1,2.2780963315814773e-06,0,0
17951,expressing,1,1.8364528545823171e-06,1,2.2780963315814773e-06,0,0
17950,afterward,1,1.8364528545823171e-06,1,2.2780963315814773e-06,0,0
17953,clintonrussiafbijusticeobamacomeylynch,1,1.8364528545823171e-06,1,2.2780963315814773e-06,0,0
17960,wiretap,1,1.8364528545823171e-06,1,2.2780963315814773e-06,0,0
17955,aideit,1,1.8364528545823171e-06,1,2.2780963315814773e-06,0,0
17956,campaignpeople,1,1.8364528545823171e-06,1,2.2780963315814773e-06,0,0
17959,spyingthis,1,1.8364528545823171e-06,1,2.2780963315814773e-06,0,0
17958,scandalous,1,1.8364528545823171e-06,1,2.2780963315814773e-06,0,0
17961,chol,1,1.8364528545823171e-06,1,2.2780963315814773e-06,0,0
17962,backfires,1,1.8364528545823171e-06,1,2.2780963315814773e-06,0,0
17963,countrybipartisan,1,1.8364528545823171e-06,1,2.2780963315814773e-06,0,0
17965,lawmaker,1,1.8364528545823171e-06,1,2.2780963315814773e-06,0,0
17967,republicansremember,1,1.8364528545823171e-06,1,2.2780963315814773e-06,0,0
17966,membersnot,1,1.8364528545823171e-06,1,2.2780963315814773e-06,0,0
17969,cemeteries,1,1.8364528545823171e-06,1,2.2780963315814773e-06,0,0
17968,burial,1,1.8364528545823171e-06,1,2.2780963315814773e-06,0,0
17973,tapestry,1,1.8364528545823171e-06,1,2.2780963315814773e-06,0,0
17972,swept,1,1.8364528545823171e-06,1,2.2780963315814773e-06,0,0
17971,prairies,1,1.8364528545823171e-06,1,2.2780963315814773e-06,0,0
17975,oddthis,1,1.8364528545823171e-06,1,2.2780963315814773e-06,0,0
17977,18years,1,1.8364528545823171e-06,1,2.2780963315814773e-06,0,0
17978,cart,1,1.8364528545823171e-06,1,2.2780963315814773e-06,0,0
17980,artie,1,1.8364528545823171e-06,1,2.2780963315814773e-06,0,0
17981,muller,1,1.8364528545823171e-06,1,2.2780963315814773e-06,0,0
17982,journeyed,1,1.8364528545823171e-06,1,2.2780963315814773e-06,0,0
17983,nationthey,1,1.8364528545823171e-06,1,2.2780963315814773e-06,0,0
17984,@whitehouse🇺🇸🇰🇷,1,1.8364528545823171e-06,1,2.2780963315814773e-06,0,0
17985,indelibly,1,1.8364528545823171e-06,1,2.2780963315814773e-06,0,0
17988,koreaand,1,1.8364528545823171e-06,1,2.2780963315814773e-06,0,0
17990,seaman,1,1.8364528545823171e-06,1,2.2780963315814773e-06,0,0
17989,noblesville,1,1.8364528545823171e-06,1,2.2780963315814773e-06,0,0
17991,separates,1,1.8364528545823171e-06,1,2.2780963315814773e-06,0,0
17993,billionyear,1,1.8364528545823171e-06,1,2.2780963315814773e-06,0,0
17994,fastthe,1,1.8364528545823171e-06,1,2.2780963315814773e-06,0,0
17997,congratulationsgood,1,1.8364528545823171e-06,1,2.2780963315814773e-06,0,0
17996,aweigh,1,1.8364528545823171e-06,1,2.2780963315814773e-06,0,0
17998,nurtured,1,1.8364528545823171e-06,1,2.2780963315814773e-06,0,0
17999,spywidespread,1,1.8364528545823171e-06,1,2.2780963315814773e-06,0,0
18001,alluding,1,1.8364528545823171e-06,1,2.2780963315814773e-06,0,0
18003,commencment,1,1.8364528545823171e-06,1,2.2780963315814773e-06,0,0
18004,#medalofhonor,1,1.8364528545823171e-06,1,2.2780963315814773e-06,0,0
18006,operator,1,1.8364528545823171e-06,1,2.2780963315814773e-06,0,0
18005,britt,1,1.8364528545823171e-06,1,2.2780963315814773e-06,0,0
18007,slabinski,1,1.8364528545823171e-06,1,2.2780963315814773e-06,0,0
18008,#s2155,1,1.8364528545823171e-06,1,2.2780963315814773e-06,0,0
18010,jung,1,1.8364528545823171e-06,1,2.2780963315814773e-06,0,0
18012,farmagricultural,1,1.8364528545823171e-06,1,2.2780963315814773e-06,0,0
18014,infiltrate,1,1.8364528545823171e-06,1,2.2780963315814773e-06,0,0
18016,@sbalist,1,1.8364528545823171e-06,1,2.2780963315814773e-06,0,0
18015,#sbagala,1,1.8364528545823171e-06,1,2.2780963315814773e-06,0,0
18017,dodd,1,1.8364528545823171e-06,1,2.2780963315814773e-06,0,0
18019,boot,1,1.8364528545823171e-06,1,2.2780963315814773e-06,0,0
18021,tomi,1,1.8364528545823171e-06,1,2.2780963315814773e-06,0,0
18020,lahren,1,1.8364528545823171e-06,1,2.2780963315814773e-06,0,0
18024,genesis,1,1.8364528545823171e-06,1,2.2780963315814773e-06,0,0
18027,dossierhe,1,1.8364528545823171e-06,1,2.2780963315814773e-06,0,0
18025,briefs,1,1.8364528545823171e-06,1,2.2780963315814773e-06,0,0
18028,filtering,1,1.8364528545823171e-06,1,2.2780963315814773e-06,0,0
18029,fbidoj,1,1.8364528545823171e-06,1,2.2780963315814773e-06,0,0
18030,infiltrated,1,1.8364528545823171e-06,1,2.2780963315814773e-06,0,0
18031,145000000,1,1.8364528545823171e-06,1,2.2780963315814773e-06,0,0
18033,collussion,1,1.8364528545823171e-06,1,2.2780963315814773e-06,0,0
18035,#armedforcesday,1,1.8364528545823171e-06,1,2.2780963315814773e-06,0,0
18036,abundance,1,1.8364528545823171e-06,1,2.2780963315814773e-06,0,0
18037,antónio,1,1.8364528545823171e-06,1,2.2780963315814773e-06,0,0
18038,guterres,1,1.8364528545823171e-06,1,2.2780963315814773e-06,0,0
18039,#prisonreform,1,1.8364528545823171e-06,1,2.2780963315814773e-06,0,0
18040,implanted,1,1.8364528545823171e-06,1,2.2780963315814773e-06,0,0
18041,mauricio,1,1.8364528545823171e-06,1,2.2780963315814773e-06,0,0
18045,embedded,1,1.8364528545823171e-06,1,2.2780963315814773e-06,0,0
18046,imbedded,1,1.8364528545823171e-06,1,2.2780963315814773e-06,0,0
18048,#confirmgina,1,1.8364528545823171e-06,1,2.2780963315814773e-06,0,0
18049,mirziyoyev,1,1.8364528545823171e-06,1,2.2780963315814773e-06,0,0
18050,uzbekistan,1,1.8364528545823171e-06,1,2.2780963315814773e-06,0,0
18052,choicemission,1,1.8364528545823171e-06,1,2.2780963315814773e-06,0,0
18051,caregivers,1,1.8364528545823171e-06,1,2.2780963315814773e-06,0,0
18053,folding,1,1.8364528545823171e-06,1,2.2780963315814773e-06,0,0
18057,@cortessteve,1,1.8364528545823171e-06,1,2.2780963315814773e-06,0,0
18059,well-wishers,1,1.8364528545823171e-06,1,2.2780963315814773e-06,0,0
18064,#usembassyjerusalem,1,1.8364528545823171e-06,1,2.2780963315814773e-06,0,0
18065,compatible,1,1.8364528545823171e-06,1,2.2780963315814773e-06,0,0
18066,reachedjust,1,1.8364528545823171e-06,1,2.2780963315814773e-06,0,0
18068,anti-trust,1,1.8364528545823171e-06,1,2.2780963315814773e-06,0,0
18069,medication,1,1.8364528545823171e-06,1,2.2780963315814773e-06,0,0
18071,gentlemen,1,1.8364528545823171e-06,1,2.2780963315814773e-06,0,0
18072,dewine,1,1.8364528545823171e-06,1,2.2780963315814773e-06,0,0
18073,onso,1,1.8364528545823171e-06,1,2.2780963315814773e-06,0,0
18076,sponsor,1,1.8364528545823171e-06,1,2.2780963315814773e-06,0,0
18075,acquiring,1,1.8364528545823171e-06,1,2.2780963315814773e-06,0,0
18077,alway,1,1.8364528545823171e-06,1,2.2780963315814773e-06,0,0
18078,200pm,1,1.8364528545823171e-06,1,2.2780963315814773e-06,0,0
18083,shortest,1,1.8364528545823171e-06,1,2.2780963315814773e-06,0,0
18082,probers,1,1.8364528545823171e-06,1,2.2780963315814773e-06,0,0
18084,revolt,1,1.8364528545823171e-06,1,2.2780963315814773e-06,0,0
18085,salena,1,1.8364528545823171e-06,1,2.2780963315814773e-06,0,0
18086,zito,1,1.8364528545823171e-06,1,2.2780963315814773e-06,0,0
18087,injusticeand,1,1.8364528545823171e-06,1,2.2780963315814773e-06,0,0
18088,unrevealed,1,1.8364528545823171e-06,1,2.2780963315814773e-06,0,0
18089,crimethere,1,1.8364528545823171e-06,1,2.2780963315814773e-06,0,0
18090,blankenship,1,1.8364528545823171e-06,1,2.2780963315814773e-06,0,0
18091,stateno,1,1.8364528545823171e-06,1,2.2780963315814773e-06,0,0
18092,spoiled,1,1.8364528545823171e-06,1,2.2780963315814773e-06,0,0
18094,disarm,1,1.8364528545823171e-06,1,2.2780963315814773e-06,0,0
18096,4yrs,1,1.8364528545823171e-06,1,2.2780963315814773e-06,0,0
18099,celebrities,1,1.8364528545823171e-06,1,2.2780963315814773e-06,0,0
18098,arbitration,1,1.8364528545823171e-06,1,2.2780963315814773e-06,0,0
18100,extortionist,1,1.8364528545823171e-06,1,2.2780963315814773e-06,0,0
18101,retainer,1,1.8364528545823171e-06,1,2.2780963315814773e-06,0,0
18102,ainsley,1,1.8364528545823171e-06,1,2.2780963315814773e-06,0,0
18104,earnhardt,1,1.8364528545823171e-06,1,2.2780963315814773e-06,0,0
18103,bookbring,1,1.8364528545823171e-06,1,2.2780963315814773e-06,0,0
18106,screwing,1,1.8364528545823171e-06,1,2.2780963315814773e-06,0,0
18107,c-130,1,1.8364528545823171e-06,1,2.2780963315814773e-06,0,0
18108,hercules,1,1.8364528545823171e-06,1,2.2780963315814773e-06,0,0
18109,savannah,1,1.8364528545823171e-06,1,2.2780963315814773e-06,0,0
18110,redacting,1,1.8364528545823171e-06,1,2.2780963315814773e-06,0,0
18111,unequal,1,1.8364528545823171e-06,1,2.2780963315814773e-06,0,0
18113,employeewhat,1,1.8364528545823171e-06,1,2.2780963315814773e-06,0,0
18114,outrageousas,1,1.8364528545823171e-06,1,2.2780963315814773e-06,0,0
18115,unfettered,1,1.8364528545823171e-06,1,2.2780963315814773e-06,0,0
18117,1380,1,1.8364528545823171e-06,1,2.2780963315814773e-06,0,0
18118,@mbuhari,1,1.8364528545823171e-06,1,2.2780963315814773e-06,0,0
18119,@whitehouse🇺🇸🇳🇬,1,1.8364528545823171e-06,1,2.2780963315814773e-06,0,0
18120,naftabut,1,1.8364528545823171e-06,1,2.2780963315814773e-06,0,0
18121,seeyou,1,1.8364528545823171e-06,1,2.2780963315814773e-06,0,0
18123,stamina,1,1.8364528545823171e-06,1,2.2780963315814773e-06,0,0
18126,housefreedom,1,1.8364528545823171e-06,1,2.2780963315814773e-06,0,0
18127,lines-much,1,1.8364528545823171e-06,1,2.2780963315814773e-06,0,0
18128,meyers,1,1.8364528545823171e-06,1,2.2780963315814773e-06,0,0
18130,triumphs,1,1.8364528545823171e-06,1,2.2780963315814773e-06,0,0
18131,timewell,1,1.8364528545823171e-06,1,2.2780963315814773e-06,0,0
18132,bustthe,1,1.8364528545823171e-06,1,2.2780963315814773e-06,0,0
18134,testers,1,1.8364528545823171e-06,1,2.2780963315814773e-06,0,0
18135,foxnews,1,1.8364528545823171e-06,1,2.2780963315814773e-06,0,0
18137,admiraldoctor,1,1.8364528545823171e-06,1,2.2780963315814773e-06,0,0
18138,octobers,1,1.8364528545823171e-06,1,2.2780963315814773e-06,0,0
18139,russia-,1,1.8364528545823171e-06,1,2.2780963315814773e-06,0,0
18140,nevins,1,1.8364528545823171e-06,1,2.2780963315814773e-06,0,0
18141,abuzz,1,1.8364528545823171e-06,1,2.2780963315814773e-06,0,0
18144,donehe,1,1.8364528545823171e-06,1,2.2780963315814773e-06,0,0
18146,republics,1,1.8364528545823171e-06,1,2.2780963315814773e-06,0,0
18145,linked,1,1.8364528545823171e-06,1,2.2780963315814773e-06,0,0
18148,us-france,1,1.8364528545823171e-06,1,2.2780963315814773e-06,0,0
18149,#az08,1,1.8364528545823171e-06,1,2.2780963315814773e-06,0,0
18151,#torontostrong,1,1.8364528545823171e-06,1,2.2780963315814773e-06,0,0
18152,stat,1,1.8364528545823171e-06,1,2.2780963315814773e-06,0,0
18153,maxing,1,1.8364528545823171e-06,1,2.2780963315814773e-06,0,0
18154,matalin,1,1.8364528545823171e-06,1,2.2780963315814773e-06,0,0
18155,tellbut,1,1.8364528545823171e-06,1,2.2780963315814773e-06,0,0
18157,magoo,1,1.8364528545823171e-06,1,2.2780963315814773e-06,0,0
18158,peepers,1,1.8364528545823171e-06,1,2.2780963315814773e-06,0,0
18156,charactersjust,1,1.8364528545823171e-06,1,2.2780963315814773e-06,0,0
18161,sylvester,1,1.8364528545823171e-06,1,2.2780963315814773e-06,0,0
18160,stallone,1,1.8364528545823171e-06,1,2.2780963315814773e-06,0,0
18159,heavyweight,1,1.8364528545823171e-06,1,2.2780963315814773e-06,0,0
18162,tribulations,1,1.8364528545823171e-06,1,2.2780963315814773e-06,0,0
18168,habberman,1,1.8364528545823171e-06,1,2.2780963315814773e-06,0,0
18169,intercontinental,1,1.8364528545823171e-06,1,2.2780963315814773e-06,0,0
18170,missilesalso,1,1.8364528545823171e-06,1,2.2780963315814773e-06,0,0
18171,vow,1,1.8364528545823171e-06,1,2.2780963315814773e-06,0,0
18172,wendy,1,1.8364528545823171e-06,1,2.2780963315814773e-06,0,0
18173,artificially,1,1.8364528545823171e-06,1,2.2780963315814773e-06,0,0
18174,republicansgot,1,1.8364528545823171e-06,1,2.2780963315814773e-06,0,0
18175,shadey,1,1.8364528545823171e-06,1,2.2780963315814773e-06,0,0
18177,@gcsoflorida,1,1.8364528545823171e-06,1,2.2780963315814773e-06,0,0
18178,#jiatfsouth,1,1.8364528545823171e-06,1,2.2780963315814773e-06,0,0
18179,@noradnorthcom,1,1.8364528545823171e-06,1,2.2780963315814773e-06,0,0
18180,@southcomwatch,1,1.8364528545823171e-06,1,2.2780963315814773e-06,0,0
18181,@naskeywest,1,1.8364528545823171e-06,1,2.2780963315814773e-06,0,0
18182,interagency,1,1.8364528545823171e-06,1,2.2780963315814773e-06,0,0
18183,northcom,1,1.8364528545823171e-06,1,2.2780963315814773e-06,0,0
18184,southcom,1,1.8364528545823171e-06,1,2.2780963315814773e-06,0,0
18185,browns,1,1.8364528545823171e-06,1,2.2780963315814773e-06,0,0
18187,depth,1,1.8364528545823171e-06,1,2.2780963315814773e-06,0,0
18188,#success🇺🇸🇯🇵,1,1.8364528545823171e-06,1,2.2780963315814773e-06,0,0
18191,sketch,1,1.8364528545823171e-06,1,2.2780963315814773e-06,0,0
18192,breeding,1,1.8364528545823171e-06,1,2.2780963315814773e-06,0,0
18193,contingencies,1,1.8364528545823171e-06,1,2.2780963315814773e-06,0,0
18196,aggravated,1,1.8364528545823171e-06,1,2.2780963315814773e-06,0,0
18197,take-home,1,1.8364528545823171e-06,1,2.2780963315814773e-06,0,0
18200,nursultan,1,1.8364528545823171e-06,1,2.2780963315814773e-06,0,0
18199,nazarbayev,1,1.8364528545823171e-06,1,2.2780963315814773e-06,0,0
18198,kazakhstan,1,1.8364528545823171e-06,1,2.2780963315814773e-06,0,0
18201,whack,1,1.8364528545823171e-06,1,2.2780963315814773e-06,0,0
18202,deflated,1,1.8364528545823171e-06,1,2.2780963315814773e-06,0,0
18203,grandkids,1,1.8364528545823171e-06,1,2.2780963315814773e-06,0,0
18204,den,1,1.8364528545823171e-06,1,2.2780963315814773e-06,0,0
18205,botch,1,1.8364528545823171e-06,1,2.2780963315814773e-06,0,0
18206,did-until,1,1.8364528545823171e-06,1,2.2780963315814773e-06,0,0
18207,cradling,1,1.8364528545823171e-06,1,2.2780963315814773e-06,0,0
18210,memembers,1,1.8364528545823171e-06,1,2.2780963315814773e-06,0,0
18209,governorsi,1,1.8364528545823171e-06,1,2.2780963315814773e-06,0,0
18213,disciplined,1,1.8364528545823171e-06,1,2.2780963315814773e-06,0,0
18215,#neveragain,1,1.8364528545823171e-06,1,2.2780963315814773e-06,0,0
18214,#holocaustremembranceday,1,1.8364528545823171e-06,1,2.2780963315814773e-06,0,0
18219,partnering,1,1.8364528545823171e-06,1,2.2780963315814773e-06,0,0
18218,@nscsafetys,1,1.8364528545823171e-06,1,2.2780963315814773e-06,0,0
18220,prescribed,1,1.8364528545823171e-06,1,2.2780963315814773e-06,0,0
18221,enjoys,1,1.8364528545823171e-06,1,2.2780963315814773e-06,0,0
18223,calculated,1,1.8364528545823171e-06,1,2.2780963315814773e-06,0,0
18225,skype,1,1.8364528545823171e-06,1,2.2780963315814773e-06,0,0
18226,ukraine-another,1,1.8364528545823171e-06,1,2.2780963315814773e-06,0,0
18228,crimson,1,1.8364528545823171e-06,1,2.2780963315814773e-06,0,0
18227,#rolltide,1,1.8364528545823171e-06,1,2.2780963315814773e-06,0,0
18232,tarrifs,1,1.8364528545823171e-06,1,2.2780963315814773e-06,0,0
18233,attorneyclient,1,1.8364528545823171e-06,1,2.2780963315814773e-06,0,0
18236,mindless,1,1.8364528545823171e-06,1,2.2780963315814773e-06,0,0
18235,encircled,1,1.8364528545823171e-06,1,2.2780963315814773e-06,0,0
18238,truejust,1,1.8364528545823171e-06,1,2.2780963315814773e-06,0,0
18240,relating,1,1.8364528545823171e-06,1,2.2780963315814773e-06,0,0
18241,sealing,1,1.8364528545823171e-06,1,2.2780963315814773e-06,0,0
18242,humboldt,1,1.8364528545823171e-06,1,2.2780963315814773e-06,0,0
18244,@bernieandsid,1,1.8364528545823171e-06,1,2.2780963315814773e-06,0,0
18243,@77wabcradio,1,1.8364528545823171e-06,1,2.2780963315814773e-06,0,0
18245,perks,1,1.8364528545823171e-06,1,2.2780963315814773e-06,0,0
18249,willingness,1,1.8364528545823171e-06,1,2.2780963315814773e-06,0,0
18251,uniting,1,1.8364528545823171e-06,1,2.2780963315814773e-06,0,0
18250,#mlk50,1,1.8364528545823171e-06,1,2.2780963315814773e-06,0,0
18252,uncheckedcrime,1,1.8364528545823171e-06,1,2.2780963315814773e-06,0,0
18254,youtubes,1,1.8364528545823171e-06,1,2.2780963315814773e-06,0,0
18260,estonia,1,1.8364528545823171e-06,1,2.2780963315814773e-06,0,0
18257,@kerstikaljulaid,1,1.8364528545823171e-06,1,2.2780963315814773e-06,0,0
18262,lithuania,1,1.8364528545823171e-06,1,2.2780963315814773e-06,0,0
18256,@grybauskaitelt,1,1.8364528545823171e-06,1,2.2780963315814773e-06,0,0
18261,latvia,1,1.8364528545823171e-06,1,2.2780963315814773e-06,0,0
18258,@vejonis,1,1.8364528545823171e-06,1,2.2780963315814773e-06,0,0
18259,anniversaries,1,1.8364528545823171e-06,1,2.2780963315814773e-06,0,0
18255,#balticsummit,1,1.8364528545823171e-06,1,2.2780963315814773e-06,0,0
18263,bourne,1,1.8364528545823171e-06,1,2.2780963315814773e-06,0,0
18265,zuker,1,1.8364528545823171e-06,1,2.2780963315814773e-06,0,0
18267,#autismawarenessday,1,1.8364528545823171e-06,1,2.2780963315814773e-06,0,0
18268,#lightitupblue,1,1.8364528545823171e-06,1,2.2780963315814773e-06,0,0
18269,@annagiaritelli,1,1.8364528545823171e-06,1,2.2780963315814773e-06,0,0
18271,countrynot,1,1.8364528545823171e-06,1,2.2780963315814773e-06,0,0
18272,naftathey,1,1.8364528545823171e-06,1,2.2780963315814773e-06,0,0
18274,moonbeam,1,1.8364528545823171e-06,1,2.2780963315814773e-06,0,0
18273,kidnapping,1,1.8364528545823171e-06,1,2.2780963315814773e-06,0,0
18275,robbery,1,1.8364528545823171e-06,1,2.2780963315814773e-06,0,0
18276,terrorize,1,1.8364528545823171e-06,1,2.2780963315814773e-06,0,0
18277,parcel,1,1.8364528545823171e-06,1,2.2780963315814773e-06,0,0
18279,companys,1,1.8364528545823171e-06,1,2.2780963315814773e-06,0,0
18278,ballooned,1,1.8364528545823171e-06,1,2.2780963315814773e-06,0,0
18281,disrepair,1,1.8364528545823171e-06,1,2.2780963315814773e-06,0,0
18282,refined,1,1.8364528545823171e-06,1,2.2780963315814773e-06,0,0
18284,hon,1,1.8364528545823171e-06,1,2.2780963315814773e-06,0,0
18283,dod,1,1.8364528545823171e-06,1,2.2780963315814773e-06,0,0
18286,shulkins,1,1.8364528545823171e-06,1,2.2780963315814773e-06,0,0
18288,md,1,1.8364528545823171e-06,1,2.2780963315814773e-06,0,0
18289,orange,1,1.8364528545823171e-06,1,2.2780963315814773e-06,0,0
18290,@ustraderep,1,1.8364528545823171e-06,1,2.2780963315814773e-06,0,0
18291,korus,1,1.8364528545823171e-06,1,2.2780963315814773e-06,0,0
18292,maintained,1,1.8364528545823171e-06,1,2.2780963315814773e-06,0,0
18294,voluminous,1,1.8364528545823171e-06,1,2.2780963315814773e-06,0,0
18296,@howiecarrshow,1,1.8364528545823171e-06,1,2.2780963315814773e-06,0,0
18298,casedont,1,1.8364528545823171e-06,1,2.2780963315814773e-06,0,0
18299,combatants,1,1.8364528545823171e-06,1,2.2780963315814773e-06,0,0
18301,swapping,1,1.8364528545823171e-06,1,2.2780963315814773e-06,0,0
18302,attacker,1,1.8364528545823171e-06,1,2.2780963315814773e-06,0,0
18303,line-item,1,1.8364528545823171e-06,1,2.2780963315814773e-06,0,0
18305,legalized,1,1.8364528545823171e-06,1,2.2780963315814773e-06,0,0
18307,inconsistent,1,1.8364528545823171e-06,1,2.2780963315814773e-06,0,0
18309,4918,1,1.8364528545823171e-06,1,2.2780963315814773e-06,0,0
18310,@ambjohnbolton,1,1.8364528545823171e-06,1,2.2780963315814773e-06,0,0
18311,handover,1,1.8364528545823171e-06,1,2.2780963315814773e-06,0,0
18312,physically,1,1.8364528545823171e-06,1,2.2780963315814773e-06,0,0
18313,yearmost,1,1.8364528545823171e-06,1,2.2780963315814773e-06,0,0
18314,excoriate,1,1.8364528545823171e-06,1,2.2780963315814773e-06,0,0
18317,wether,1,1.8364528545823171e-06,1,2.2780963315814773e-06,0,0
18318,urged,1,1.8364528545823171e-06,1,2.2780963315814773e-06,0,0
18319,#nationalagricultureday,1,1.8364528545823171e-06,1,2.2780963315814773e-06,0,0
18320,818,1,1.8364528545823171e-06,1,2.2780963315814773e-06,0,0
18321,addeddoes,1,1.8364528545823171e-06,1,2.2780963315814773e-06,0,0
18322,sourceor,1,1.8364528545823171e-06,1,2.2780963315814773e-06,0,0
18323,#stpatricksday,1,1.8364528545823171e-06,1,2.2780963315814773e-06,0,0
18325,sanctimonious,1,1.8364528545823171e-06,1,2.2780963315814773e-06,0,0
18324,choirboy,1,1.8364528545823171e-06,1,2.2780963315814773e-06,0,0
18326,14-year,1,1.8364528545823171e-06,1,2.2780963315814773e-06,0,0
18327,unopposed,1,1.8364528545823171e-06,1,2.2780963315814773e-06,0,0
18328,iraq-syria,1,1.8364528545823171e-06,1,2.2780963315814773e-06,0,0
18329,shamrock☘️bowl,1,1.8364528545823171e-06,1,2.2780963315814773e-06,0,0
18331,fiu,1,1.8364528545823171e-06,1,2.2780963315814773e-06,0,0
18334,usnegotiating,1,1.8364528545823171e-06,1,2.2780963315814773e-06,0,0
18333,dothey,1,1.8364528545823171e-06,1,2.2780963315814773e-06,0,0
18332,doand,1,1.8364528545823171e-06,1,2.2780963315814773e-06,0,0
18335,aviators,1,1.8364528545823171e-06,1,2.2780963315814773e-06,0,0
18337,@senatecommerce,1,1.8364528545823171e-06,1,2.2780963315814773e-06,0,0
18336,#infrastructureinamerica,1,1.8364528545823171e-06,1,2.2780963315814773e-06,0,0
18338,fundamentals,1,1.8364528545823171e-06,1,2.2780963315814773e-06,0,0
18339,unfilled,1,1.8364528545823171e-06,1,2.2780963315814773e-06,0,0
18341,prey,1,1.8364528545823171e-06,1,2.2780963315814773e-06,0,0
18343,tend,1,1.8364528545823171e-06,1,2.2780963315814773e-06,0,0
18345,in-depth,1,1.8364528545823171e-06,1,2.2780963315814773e-06,0,0
18346,demswill,1,1.8364528545823171e-06,1,2.2780963315814773e-06,0,0
18347,conceal,1,1.8364528545823171e-06,1,2.2780963315814773e-06,0,0
18349,governmenta,1,1.8364528545823171e-06,1,2.2780963315814773e-06,0,0
18350,russiajust,1,1.8364528545823171e-06,1,2.2780963315814773e-06,0,0
18354,koreas,1,1.8364528545823171e-06,1,2.2780963315814773e-06,0,0
18355,startled,1,1.8364528545823171e-06,1,2.2780963315814773e-06,0,0
18352,amazedthey,1,1.8364528545823171e-06,1,2.2780963315814773e-06,0,0
18353,fakethey,1,1.8364528545823171e-06,1,2.2780963315814773e-06,0,0
18357,kristian,1,1.8364528545823171e-06,1,2.2780963315814773e-06,0,0
18358,saucier,1,1.8364528545823171e-06,1,2.2780963315814773e-06,0,0
18359,xinping,1,1.8364528545823171e-06,1,2.2780963315814773e-06,0,0
18360,yountville,1,1.8364528545823171e-06,1,2.2780963315814773e-06,0,0
18361,@repbost,1,1.8364528545823171e-06,1,2.2780963315814773e-06,0,0
18362,freeze,1,1.8364528545823171e-06,1,2.2780963315814773e-06,0,0
18364,#internationalwomensdayfirst,1,1.8364528545823171e-06,1,2.2780963315814773e-06,0,0
18366,@realromadowney,1,1.8364528545823171e-06,1,2.2780963315814773e-06,0,0
18367,oscars,1,1.8364528545823171e-06,1,2.2780963315814773e-06,0,0
18369,addicted,1,1.8364528545823171e-06,1,2.2780963315814773e-06,0,0
18370,relocation,1,1.8364528545823171e-06,1,2.2780963315814773e-06,0,0
18371,gridiron,1,1.8364528545823171e-06,1,2.2780963315814773e-06,0,0
18372,deficit-have,1,1.8364528545823171e-06,1,2.2780963315814773e-06,0,0
18381,anymore-we,1,1.8364528545823171e-06,1,2.2780963315814773e-06,0,0
18382,dieing,1,1.8364528545823171e-06,1,2.2780963315814773e-06,0,0
18384,dire,1,1.8364528545823171e-06,1,2.2780963315814773e-06,0,0
18383,#opioidepidemicfull,1,1.8364528545823171e-06,1,2.2780963315814773e-06,0,0
18385,emerged,1,1.8364528545823171e-06,1,2.2780963315814773e-06,0,0
18386,lord,1,1.8364528545823171e-06,1,2.2780963315814773e-06,0,0
18390,yankee,1,1.8364528545823171e-06,1,2.2780963315814773e-06,0,0
18389,sixteen,1,1.8364528545823171e-06,1,2.2780963315814773e-06,0,0
18387,1957,1,1.8364528545823171e-06,1,2.2780963315814773e-06,0,0
18391,binion,1,1.8364528545823171e-06,1,2.2780963315814773e-06,0,0
18399,lc,1,1.8364528545823171e-06,1,2.2780963315814773e-06,0,0
18394,ac,1,1.8364528545823171e-06,1,2.2780963315814773e-06,0,0
18400,sid,1,1.8364528545823171e-06,1,2.2780963315814773e-06,0,0
18396,comptroller,1,1.8364528545823171e-06,1,2.2780963315814773e-06,0,0
18398,hegar,1,1.8364528545823171e-06,1,2.2780963315814773e-06,0,0
18395,christi,1,1.8364528545823171e-06,1,2.2780963315814773e-06,0,0
18397,craddick,1,1.8364528545823171e-06,1,2.2780963315814773e-06,0,0
18401,2000a,1,1.8364528545823171e-06,1,2.2780963315814773e-06,0,0
18402,paxton,1,1.8364528545823171e-06,1,2.2780963315814773e-06,0,0
18403,collusioni,1,1.8364528545823171e-06,1,2.2780963315814773e-06,0,0
18404,exercising,1,1.8364528545823171e-06,1,2.2780963315814773e-06,0,0
18407,skeptical,1,1.8364528545823171e-06,1,2.2780963315814773e-06,0,0
18405,evidencein,1,1.8364528545823171e-06,1,2.2780963315814773e-06,0,0
18406,implausible,1,1.8364528545823171e-06,1,2.2780963315814773e-06,0,0
18408,@judgenapolitano,1,1.8364528545823171e-06,1,2.2780963315814773e-06,0,0
18409,disgraceand,1,1.8364528545823171e-06,1,2.2780963315814773e-06,0,0
18411,straw,1,1.8364528545823171e-06,1,2.2780963315814773e-06,0,0
18413,redrawn,1,1.8364528545823171e-06,1,2.2780963315814773e-06,0,0
18412,appealed,1,1.8364528545823171e-06,1,2.2780963315814773e-06,0,0
18416,firearms,1,1.8364528545823171e-06,1,2.2780963315814773e-06,0,0
18418,turnbull,1,1.8364528545823171e-06,1,2.2780963315814773e-06,0,0
18417,@whitehouse🇺🇸🇦🇺press,1,1.8364528545823171e-06,1,2.2780963315814773e-06,0,0
18420,scripted,1,1.8364528545823171e-06,1,2.2780963315814773e-06,0,0
18421,officialsthere,1,1.8364528545823171e-06,1,2.2780963315814773e-06,0,0
18422,#goteamusa,1,1.8364528545823171e-06,1,2.2780963315814773e-06,0,0
18423,#olympics,1,1.8364528545823171e-06,1,2.2780963315814773e-06,0,0
18425,thereproblem,1,1.8364528545823171e-06,1,2.2780963315814773e-06,0,0
18426,lasts,1,1.8364528545823171e-06,1,2.2780963315814773e-06,0,0
18427,teacherscoaches,1,1.8364528545823171e-06,1,2.2780963315814773e-06,0,0
18428,concealed,1,1.8364528545823171e-06,1,2.2780963315814773e-06,0,0
18429,safefull,1,1.8364528545823171e-06,1,2.2780963315814773e-06,0,0
18430,great-grandchildren,1,1.8364528545823171e-06,1,2.2780963315814773e-06,0,0
18431,ministry,1,1.8364528545823171e-06,1,2.2780963315814773e-06,0,0
18433,decoration,1,1.8364528545823171e-06,1,2.2780963315814773e-06,0,0
18432,#americanheroes,1,1.8364528545823171e-06,1,2.2780963315814773e-06,0,0
18434,religions,1,1.8364528545823171e-06,1,2.2780963315814773e-06,0,0
18436,wall-to-wall,1,1.8364528545823171e-06,1,2.2780963315814773e-06,0,0
18435,newscasters,1,1.8364528545823171e-06,1,2.2780963315814773e-06,0,0
18438,reporteddoesnt,1,1.8364528545823171e-06,1,2.2780963315814773e-06,0,0
18441,somehow,1,1.8364528545823171e-06,1,2.2780963315814773e-06,0,0
18442,brody,1,1.8364528545823171e-06,1,2.2780963315814773e-06,0,0
18444,@orrinhatch,1,1.8364528545823171e-06,1,2.2780963315814773e-06,0,0
18449,kenstarr,1,1.8364528545823171e-06,1,2.2780963315814773e-06,0,0
18450,whitewater,1,1.8364528545823171e-06,1,2.2780963315814773e-06,0,0
18451,asses,1,1.8364528545823171e-06,1,2.2780963315814773e-06,0,0
18453,pound,1,1.8364528545823171e-06,1,2.2780963315814773e-06,0,0
18455,definitively,1,1.8364528545823171e-06,1,2.2780963315814773e-06,0,0
18458,swaying,1,1.8364528545823171e-06,1,2.2780963315814773e-06,0,0
18456,goalrob,1,1.8364528545823171e-06,1,2.2780963315814773e-06,0,0
18457,goldmanvice,1,1.8364528545823171e-06,1,2.2780963315814773e-06,0,0
18459,goldman,1,1.8364528545823171e-06,1,2.2780963315814773e-06,0,0
18463,participant,1,1.8364528545823171e-06,1,2.2780963315814773e-06,0,0
18464,impeachment@stevehiltonx,1,1.8364528545823171e-06,1,2.2780963315814773e-06,0,0
18466,succinctly,1,1.8364528545823171e-06,1,2.2780963315814773e-06,0,0
18465,old-fashioned,1,1.8364528545823171e-06,1,2.2780963315814773e-06,0,0
18467,anti-us,1,1.8364528545823171e-06,1,2.2780963315814773e-06,0,0
18468,democratstotally,1,1.8364528545823171e-06,1,2.2780963315814773e-06,0,0
18469,grassley,1,1.8364528545823171e-06,1,2.2780963315814773e-06,0,0
18470,schumer-rounds-collins,1,1.8364528545823171e-06,1,2.2780963315814773e-06,0,0
18471,sustain,1,1.8364528545823171e-06,1,2.2780963315814773e-06,0,0
18475,expelled,1,1.8364528545823171e-06,1,2.2780963315814773e-06,0,0
18474,erratic,1,1.8364528545823171e-06,1,2.2780963315814773e-06,0,0
18472,classmates,1,1.8364528545823171e-06,1,2.2780963315814773e-06,0,0
18476,reconnect,1,1.8364528545823171e-06,1,2.2780963315814773e-06,0,0
18477,kruczek,1,1.8364528545823171e-06,1,2.2780963315814773e-06,0,0
18479,hikers,1,1.8364528545823171e-06,1,2.2780963315814773e-06,0,0
18480,billand,1,1.8364528545823171e-06,1,2.2780963315814773e-06,0,0
18482,branches,1,1.8364528545823171e-06,1,2.2780963315814773e-06,0,0
18481,2008-2011,1,1.8364528545823171e-06,1,2.2780963315814773e-06,0,0
18483,accuratehe,1,1.8364528545823171e-06,1,2.2780963315814773e-06,0,0
18485,mishandling,1,1.8364528545823171e-06,1,2.2780963315814773e-06,0,0
18484,clintondnc,1,1.8364528545823171e-06,1,2.2780963315814773e-06,0,0
18490,non-military,1,1.8364528545823171e-06,1,2.2780963315814773e-06,0,0
18491,depletion,1,1.8364528545823171e-06,1,2.2780963315814773e-06,0,0
18492,-senator,1,1.8364528545823171e-06,1,2.2780963315814773e-06,0,0
18493,extensive,1,1.8364528545823171e-06,1,2.2780963315814773e-06,0,0
18495,unto,1,1.8364528545823171e-06,1,2.2780963315814773e-06,0,0
18496,kissinger,1,1.8364528545823171e-06,1,2.2780963315814773e-06,0,0
18498,invoked,1,1.8364528545823171e-06,1,2.2780963315814773e-06,0,0
18500,recite,1,1.8364528545823171e-06,1,2.2780963315814773e-06,0,0
18501,@olympics,1,1.8364528545823171e-06,1,2.2780963315814773e-06,0,0
18502,bombshells,1,1.8364528545823171e-06,1,2.2780963315814773e-06,0,0
18503,#falconheavy,1,1.8364528545823171e-06,1,2.2780963315814773e-06,0,0
18504,cancels,1,1.8364528545823171e-06,1,2.2780963315814773e-06,0,0
18505,daca-they,1,1.8364528545823171e-06,1,2.2780963315814773e-06,0,0
18508,linebacker,1,1.8364528545823171e-06,1,2.2780963315814773e-06,0,0
18509,non-personal,1,1.8364528545823171e-06,1,2.2780963315814773e-06,0,0
18510,enforcer,1,1.8364528545823171e-06,1,2.2780963315814773e-06,0,0
18512,lawthe,1,1.8364528545823171e-06,1,2.2780963315814773e-06,0,0
18511,hid,1,1.8364528545823171e-06,1,2.2780963315814773e-06,0,0
18513,aftermaththe,1,1.8364528545823171e-06,1,2.2780963315814773e-06,0,0
18514,wages-,1,1.8364528545823171e-06,1,2.2780963315814773e-06,0,0
18517,@customsborder,1,1.8364528545823171e-06,1,2.2780963315814773e-06,0,0
18518,@uscis,1,1.8364528545823171e-06,1,2.2780963315814773e-06,0,0
18519,orator,1,1.8364528545823171e-06,1,2.2780963315814773e-06,0,0
18522,start✅unemployment,1,1.8364528545823171e-06,1,2.2780963315814773e-06,0,0
18520,41✅average,1,1.8364528545823171e-06,1,2.2780963315814773e-06,0,0
18523,year✅200000,1,1.8364528545823171e-06,1,2.2780963315814773e-06,0,0
18521,jobs✅,1,1.8364528545823171e-06,1,2.2780963315814773e-06,0,0
18525,misleadingly,1,1.8364528545823171e-06,1,2.2780963315814773e-06,0,0
18524,jw,1,1.8364528545823171e-06,1,2.2780963315814773e-06,0,0
18528,456,1,1.8364528545823171e-06,1,2.2780963315814773e-06,0,0
18527,117,1,1.8364528545823171e-06,1,2.2780963315814773e-06,0,0
18529,nearing,1,1.8364528545823171e-06,1,2.2780963315814773e-06,0,0
18531,genocide,1,1.8364528545823171e-06,1,2.2780963315814773e-06,0,0
18532,#davos2018,1,1.8364528545823171e-06,1,2.2780963315814773e-06,0,0
18535,@alainberset,1,1.8364528545823171e-06,1,2.2780963315814773e-06,0,0
18536,confederation,1,1.8364528545823171e-06,1,2.2780963315814773e-06,0,0
18538,rwanda,1,1.8364528545823171e-06,1,2.2780963315814773e-06,0,0
18537,kagame,1,1.8364528545823171e-06,1,2.2780963315814773e-06,0,0
18540,@squawkcnbc,1,1.8364528545823171e-06,1,2.2780963315814773e-06,0,0
18539,600ame,1,1.8364528545823171e-06,1,2.2780963315814773e-06,0,0
18541,boundaries,1,1.8364528545823171e-06,1,2.2780963315814773e-06,0,0
18542,betterour,1,1.8364528545823171e-06,1,2.2780963315814773e-06,0,0
18543,usher,1,1.8364528545823171e-06,1,2.2780963315814773e-06,0,0
18544,#democratshutdown,1,1.8364528545823171e-06,1,2.2780963315814773e-06,0,0
18545,@govmattbevin,1,1.8364528545823171e-06,1,2.2780963315814773e-06,0,0
18546,bailey,1,1.8364528545823171e-06,1,2.2780963315814773e-06,0,0
18548,preston,1,1.8364528545823171e-06,1,2.2780963315814773e-06,0,0
18547,cope,1,1.8364528545823171e-06,1,2.2780963315814773e-06,0,0
18549,disney,1,1.8364528545823171e-06,1,2.2780963315814773e-06,0,0
18550,jp,1,1.8364528545823171e-06,1,2.2780963315814773e-06,0,0
18551,samsung,1,1.8364528545823171e-06,1,2.2780963315814773e-06,0,0
18552,tryingwith,1,1.8364528545823171e-06,1,2.2780963315814773e-06,0,0
18553,againschumer,1,1.8364528545823171e-06,1,2.2780963315814773e-06,0,0
18554,cavedgambled,1,1.8364528545823171e-06,1,2.2780963315814773e-06,0,0
18558,grading,1,1.8364528545823171e-06,1,2.2780963315814773e-06,0,0
18557,a-and,1,1.8364528545823171e-06,1,2.2780963315814773e-06,0,0
18559,crs,1,1.8364528545823171e-06,1,2.2780963315814773e-06,0,0
18561,#weneedmorerepublicansin18,1,1.8364528545823171e-06,1,2.2780963315814773e-06,0,0
18562,preliminary,1,1.8364528545823171e-06,1,2.2780963315814773e-06,0,0
18563,702,1,1.8364528545823171e-06,1,2.2780963315814773e-06,0,0
18565,45th,1,1.8364528545823171e-06,1,2.2780963315814773e-06,0,0
18566,@marchforlife,1,1.8364528545823171e-06,1,2.2780963315814773e-06,0,0
18564,#lovesaveslives,1,1.8364528545823171e-06,1,2.2780963315814773e-06,0,0
18567,accidents,1,1.8364528545823171e-06,1,2.2780963315814773e-06,0,0
18569,oksen,1,1.8364528545823171e-06,1,2.2780963315814773e-06,0,0
18568,d-calif,1,1.8364528545823171e-06,1,2.2780963315814773e-06,0,0
18570,militarysomething,1,1.8364528545823171e-06,1,2.2780963315814773e-06,0,0
18573,evolved,1,1.8364528545823171e-06,1,2.2780963315814773e-06,0,0
18572,conceived,1,1.8364528545823171e-06,1,2.2780963315814773e-06,0,0
18575,wastelands,1,1.8364528545823171e-06,1,2.2780963315814773e-06,0,0
18576,overcome--even,1,1.8364528545823171e-06,1,2.2780963315814773e-06,0,0
18577,#congressionalgoldmedal,1,1.8364528545823171e-06,1,2.2780963315814773e-06,0,0
18579,terrorism-related,1,1.8364528545823171e-06,1,2.2780963315814773e-06,0,0
18578,foreign-born,1,1.8364528545823171e-06,1,2.2780963315814773e-06,0,0
18580,-and,1,1.8364528545823171e-06,1,2.2780963315814773e-06,0,0
18581,contrived@foxandfriends,1,1.8364528545823171e-06,1,2.2780963315814773e-06,0,0
18582,dicky,1,1.8364528545823171e-06,1,2.2780963315814773e-06,0,0
18585,helpwe,1,1.8364528545823171e-06,1,2.2780963315814773e-06,0,0
18586,26000,1,1.8364528545823171e-06,1,2.2780963315814773e-06,0,0
18587,grounded,1,1.8364528545823171e-06,1,2.2780963315814773e-06,0,0
18588,profitability,1,1.8364528545823171e-06,1,2.2780963315814773e-06,0,0
18589,lotteries,1,1.8364528545823171e-06,1,2.2780963315814773e-06,0,0
18590,derogatory,1,1.8364528545823171e-06,1,2.2780963315814773e-06,0,0
18592,sweetheart,1,1.8364528545823171e-06,1,2.2780963315814773e-06,0,0
18593,outlandish,1,1.8364528545823171e-06,1,2.2780963315814773e-06,0,0
18594,ribbon-no,1,1.8364528545823171e-06,1,2.2780963315814773e-06,0,0
18595,risking,1,1.8364528545823171e-06,1,2.2780963315814773e-06,0,0
18598,relocating,1,1.8364528545823171e-06,1,2.2780963315814773e-06,0,0
18597,heavy-truck,1,1.8364528545823171e-06,1,2.2780963315814773e-06,0,0
18599,levine,1,1.8364528545823171e-06,1,2.2780963315814773e-06,0,0
18600,#interdictact,1,1.8364528545823171e-06,1,2.2780963315814773e-06,0,0
18601,2142,1,1.8364528545823171e-06,1,2.2780963315814773e-06,0,0
18602,overdose,1,1.8364528545823171e-06,1,2.2780963315814773e-06,0,0
18603,smashed,1,1.8364528545823171e-06,1,2.2780963315814773e-06,0,0
18604,suvs,1,1.8364528545823171e-06,1,2.2780963315814773e-06,0,0
18605,simplifying,1,1.8364528545823171e-06,1,2.2780963315814773e-06,0,0
18606,erna,1,1.8364528545823171e-06,1,2.2780963315814773e-06,0,0
18607,solberg,1,1.8364528545823171e-06,1,2.2780963315814773e-06,0,0
18608,sneaky,1,1.8364528545823171e-06,1,2.2780963315814773e-06,0,0
18609,underhanded,1,1.8364528545823171e-06,1,2.2780963315814773e-06,0,0
18612,hsi,1,1.8364528545823171e-06,1,2.2780963315814773e-06,0,0
18611,ero,1,1.8364528545823171e-06,1,2.2780963315814773e-06,0,0
18610,#lawenforcementappreciationdaypresident,1,1.8364528545823171e-06,1,2.2780963315814773e-06,0,0
18613,@parisac,1,1.8364528545823171e-06,1,2.2780963315814773e-06,0,0
18614,anti-bengahzi,1,1.8364528545823171e-06,1,2.2780963315814773e-06,0,0
18616,orchestrating,1,1.8364528545823171e-06,1,2.2780963315814773e-06,0,0
18618,congregation,1,1.8364528545823171e-06,1,2.2780963315814773e-06,0,0
18619,parishioners,1,1.8364528545823171e-06,1,2.2780963315814773e-06,0,0
18620,worshippers,1,1.8364528545823171e-06,1,2.2780963315814773e-06,0,0
18622,monsey,1,1.8364528545823171e-06,1,2.2780963315814773e-06,0,0
18623,juliet,1,1.8364528545823171e-06,1,2.2780963315814773e-06,0,0
18624,inocent,1,1.8364528545823171e-06,1,2.2780963315814773e-06,0,0
18628,mickey,1,1.8364528545823171e-06,1,2.2780963315814773e-06,0,0
18626,cowboy,1,1.8364528545823171e-06,1,2.2780963315814773e-06,0,0
18627,deliverance,1,1.8364528545823171e-06,1,2.2780963315814773e-06,0,0
18629,alowed,1,1.8364528545823171e-06,1,2.2780963315814773e-06,0,0
18630,complicating,1,1.8364528545823171e-06,1,2.2780963315814773e-06,0,0
18631,crisp,1,1.8364528545823171e-06,1,2.2780963315814773e-06,0,0
18635,722,1,1.8364528545823171e-06,1,2.2780963315814773e-06,0,0
18634,558,1,1.8364528545823171e-06,1,2.2780963315814773e-06,0,0
18637,inpeachment,1,1.8364528545823171e-06,1,2.2780963315814773e-06,0,0
18639,commence,1,1.8364528545823171e-06,1,2.2780963315814773e-06,0,0
18638,8-day,1,1.8364528545823171e-06,1,2.2780963315814773e-06,0,0
18640,dictate,1,1.8364528545823171e-06,1,2.2780963315814773e-06,0,0
18641,striped,1,1.8364528545823171e-06,1,2.2780963315814773e-06,0,0
18645,thornberry,1,1.8364528545823171e-06,1,2.2780963315814773e-06,0,0
18643,@mactxpress,1,1.8364528545823171e-06,1,2.2780963315814773e-06,0,0
18642,@hascrepublicans,1,1.8364528545823171e-06,1,2.2780963315814773e-06,0,0
18647,@jiminhofes,1,1.8364528545823171e-06,1,2.2780963315814773e-06,0,0
18650,tenacious,1,1.8364528545823171e-06,1,2.2780963315814773e-06,0,0
18649,establishes,1,1.8364528545823171e-06,1,2.2780963315814773e-06,0,0
18646,1947,1,1.8364528545823171e-06,1,2.2780963315814773e-06,0,0
18648,@sascmajority,1,1.8364528545823171e-06,1,2.2780963315814773e-06,0,0
18652,telehealth,1,1.8364528545823171e-06,1,2.2780963315814773e-06,0,0
18651,#ruralprosperity,1,1.8364528545823171e-06,1,2.2780963315814773e-06,0,0
18653,widows,1,1.8364528545823171e-06,1,2.2780963315814773e-06,0,0
18656,domenech,1,1.8364528545823171e-06,1,2.2780963315814773e-06,0,0
18658,reflexes,1,1.8364528545823171e-06,1,2.2780963315814773e-06,0,0
18660,modulating,1,1.8364528545823171e-06,1,2.2780963315814773e-06,0,0
18659,microphone,1,1.8364528545823171e-06,1,2.2780963315814773e-06,0,0
18661,stumbles,1,1.8364528545823171e-06,1,2.2780963315814773e-06,0,0
18666,militsry,1,1.8364528545823171e-06,1,2.2780963315814773e-06,0,0
18667,teeth,1,1.8364528545823171e-06,1,2.2780963315814773e-06,0,0
18669,@foxnewpolls,1,1.8364528545823171e-06,1,2.2780963315814773e-06,0,0
18670,@repmikejohnson,1,1.8364528545823171e-06,1,2.2780963315814773e-06,0,0
18672,#magakag,1,1.8364528545823171e-06,1,2.2780963315814773e-06,0,0
18674,armynavy,1,1.8364528545823171e-06,1,2.2780963315814773e-06,0,0
18675,120th,1,1.8364528545823171e-06,1,2.2780963315814773e-06,0,0
18676,@armynavygame,1,1.8364528545823171e-06,1,2.2780963315814773e-06,0,0
18678,commiecast,1,1.8364528545823171e-06,1,2.2780963315814773e-06,0,0
18680,granting,1,1.8364528545823171e-06,1,2.2780963315814773e-06,0,0
18681,@jasonmeister,1,1.8364528545823171e-06,1,2.2780963315814773e-06,0,0
18688,@brettkavanaugh,1,1.8364528545823171e-06,1,2.2780963315814773e-06,0,0
18690,disciplinary,1,1.8364528545823171e-06,1,2.2780963315814773e-06,0,0
18691,#guard383,1,1.8364528545823171e-06,1,2.2780963315814773e-06,0,0
18693,vandyke,1,1.8364528545823171e-06,1,2.2780963315814773e-06,0,0
18696,allege,1,1.8364528545823171e-06,1,2.2780963315814773e-06,0,0
18697,pa-11,1,1.8364528545823171e-06,1,2.2780963315814773e-06,0,0
18698,@amimagazine,1,1.8364528545823171e-06,1,2.2780963315814773e-06,0,0
18699,@jaketurx,1,1.8364528545823171e-06,1,2.2780963315814773e-06,0,0
18701,sergey,1,1.8364528545823171e-06,1,2.2780963315814773e-06,0,0
18700,inf,1,1.8364528545823171e-06,1,2.2780963315814773e-06,0,0
18703,shootout,1,1.8364528545823171e-06,1,2.2780963315814773e-06,0,0
18705,cited,1,1.8364528545823171e-06,1,2.2780963315814773e-06,0,0
18706,fown,1,1.8364528545823171e-06,1,2.2780963315814773e-06,0,0
18707,gigot,1,1.8364528545823171e-06,1,2.2780963315814773e-06,0,0
18709,everthing,1,1.8364528545823171e-06,1,2.2780963315814773e-06,0,0
18710,impossibly,1,1.8364528545823171e-06,1,2.2780963315814773e-06,0,0
18711,nonstop,1,1.8364528545823171e-06,1,2.2780963315814773e-06,0,0
18716,pramila,1,1.8364528545823171e-06,1,2.2780963315814773e-06,0,0
18714,jayapal,1,1.8364528545823171e-06,1,2.2780963315814773e-06,0,0
18713,cicilline,1,1.8364528545823171e-06,1,2.2780963315814773e-06,0,0
18715,panders,1,1.8364528545823171e-06,1,2.2780963315814773e-06,0,0
18718,83000,1,1.8364528545823171e-06,1,2.2780963315814773e-06,0,0
18719,@titoortiz,1,1.8364528545823171e-06,1,2.2780963315814773e-06,0,0
18721,logs,1,1.8364528545823171e-06,1,2.2780963315814773e-06,0,0
18722,ornato,1,1.8364528545823171e-06,1,2.2780963315814773e-06,0,0
18723,pivoting,1,1.8364528545823171e-06,1,2.2780963315814773e-06,0,0
18725,repeated,1,1.8364528545823171e-06,1,2.2780963315814773e-06,0,0
18726,substancecountry,1,1.8364528545823171e-06,1,2.2780963315814773e-06,0,0
18727,paperwork,1,1.8364528545823171e-06,1,2.2780963315814773e-06,0,0
18728,@senalexander,1,1.8364528545823171e-06,1,2.2780963315814773e-06,0,0
18729,@lancegooden,1,1.8364528545823171e-06,1,2.2780963315814773e-06,0,0
18732,designation,1,1.8364528545823171e-06,1,2.2780963315814773e-06,0,0
18734,angered,1,1.8364528545823171e-06,1,2.2780963315814773e-06,0,0
18735,barbaric,1,1.8364528545823171e-06,1,2.2780963315814773e-06,0,0
18736,nas,1,1.8364528545823171e-06,1,2.2780963315814773e-06,0,0
18737,bettered,1,1.8364528545823171e-06,1,2.2780963315814773e-06,0,0
18738,1865,1,1.8364528545823171e-06,1,2.2780963315814773e-06,0,0
18739,2436,1,1.8364528545823171e-06,1,2.2780963315814773e-06,0,0
18740,2917,1,1.8364528545823171e-06,1,2.2780963315814773e-06,0,0
18742,prays,1,1.8364528545823171e-06,1,2.2780963315814773e-06,0,0
18743,billion-with,1,1.8364528545823171e-06,1,2.2780963315814773e-06,0,0
18744,maureen,1,1.8364528545823171e-06,1,2.2780963315814773e-06,0,0
18747,domain,1,1.8364528545823171e-06,1,2.2780963315814773e-06,0,0
18748,#natolondon,1,1.8364528545823171e-06,1,2.2780963315814773e-06,0,0
18750,@10downingstreet,1,1.8364528545823171e-06,1,2.2780963315814773e-06,0,0
18751,undercutting,1,1.8364528545823171e-06,1,2.2780963315814773e-06,0,0
18752,@buckmcneely1,1,1.8364528545823171e-06,1,2.2780963315814773e-06,0,0
18753,oliver,1,1.8364528545823171e-06,1,2.2780963315814773e-06,0,0
18754,newsweek,1,1.8364528545823171e-06,1,2.2780963315814773e-06,0,0
18755,omb,1,1.8364528545823171e-06,1,2.2780963315814773e-06,0,0
18757,mcgahns,1,1.8364528545823171e-06,1,2.2780963315814773e-06,0,0
18760,albaghdadi,1,1.8364528545823171e-06,1,2.2780963315814773e-06,0,0
18763,braithwaite,1,1.8364528545823171e-06,1,2.2780963315814773e-06,0,0
18765,contracting,1,1.8364528545823171e-06,1,2.2780963315814773e-06,0,0
18767,spencers,1,1.8364528545823171e-06,1,2.2780963315814773e-06,0,0
18768,eddies,1,1.8364528545823171e-06,1,2.2780963315814773e-06,0,0
18772,agnes,1,1.8364528545823171e-06,1,2.2780963315814773e-06,0,0
18773,stefanik,1,1.8364528545823171e-06,1,2.2780963315814773e-06,0,0
18774,two-week,1,1.8364528545823171e-06,1,2.2780963315814773e-06,0,0
18775,whirlwind,1,1.8364528545823171e-06,1,2.2780963315814773e-06,0,0
18776,unspoken,1,1.8364528545823171e-06,1,2.2780963315814773e-06,0,0
18781,convincing,1,1.8364528545823171e-06,1,2.2780963315814773e-06,0,0
18782,cortuption,1,1.8364528545823171e-06,1,2.2780963315814773e-06,0,0
18784,pointless,1,1.8364528545823171e-06,1,2.2780963315814773e-06,0,0
18785,televised,1,1.8364528545823171e-06,1,2.2780963315814773e-06,0,0
18788,saga,1,1.8364528545823171e-06,1,2.2780963315814773e-06,0,0
18787,henchman,1,1.8364528545823171e-06,1,2.2780963315814773e-06,0,0
18789,yesrs,1,1.8364528545823171e-06,1,2.2780963315814773e-06,0,0
18790,concha,1,1.8364528545823171e-06,1,2.2780963315814773e-06,0,0
18791,compelled,1,1.8364528545823171e-06,1,2.2780963315814773e-06,0,0
18792,enact,1,1.8364528545823171e-06,1,2.2780963315814773e-06,0,0
18793,altering,1,1.8364528545823171e-06,1,2.2780963315814773e-06,0,0
18794,hysteria,1,1.8364528545823171e-06,1,2.2780963315814773e-06,0,0
18798,speakerphone,1,1.8364528545823171e-06,1,2.2780963315814773e-06,0,0
18799,warfighter,1,1.8364528545823171e-06,1,2.2780963315814773e-06,0,0
18801,turf,1,1.8364528545823171e-06,1,2.2780963315814773e-06,0,0
18802,financials,1,1.8364528545823171e-06,1,2.2780963315814773e-06,0,0
18803,cookl,1,1.8364528545823171e-06,1,2.2780963315814773e-06,0,0
18805,attained,1,1.8364528545823171e-06,1,2.2780963315814773e-06,0,0
18807,prizefight,1,1.8364528545823171e-06,1,2.2780963315814773e-06,0,0
18809,abrupt,1,1.8364528545823171e-06,1,2.2780963315814773e-06,0,0
18810,captivity,1,1.8364528545823171e-06,1,2.2780963315814773e-06,0,0
18814,discused,1,1.8364528545823171e-06,1,2.2780963315814773e-06,0,0
18815,@stevescalese,1,1.8364528545823171e-06,1,2.2780963315814773e-06,0,0
18816,womem,1,1.8364528545823171e-06,1,2.2780963315814773e-06,0,0
18819,🚨8,1,1.8364528545823171e-06,1,2.2780963315814773e-06,0,0
18817,close🚨1,1,1.8364528545823171e-06,1,2.2780963315814773e-06,0,0
18818,information3,1,1.8364528545823171e-06,1,2.2780963315814773e-06,0,0
18822,vacancies,1,1.8364528545823171e-06,1,2.2780963315814773e-06,0,0
18824,unfounded,1,1.8364528545823171e-06,1,2.2780963315814773e-06,0,0
18823,juicy,1,1.8364528545823171e-06,1,2.2780963315814773e-06,0,0
18826,marie,1,1.8364528545823171e-06,1,2.2780963315814773e-06,0,0
18827,unfavorably,1,1.8364528545823171e-06,1,2.2780963315814773e-06,0,0
18828,filth,1,1.8364528545823171e-06,1,2.2780963315814773e-06,0,0
18829,hazard,1,1.8364528545823171e-06,1,2.2780963315814773e-06,0,0
18830,slum,1,1.8364528545823171e-06,1,2.2780963315814773e-06,0,0
18832,vadym,1,1.8364528545823171e-06,1,2.2780963315814773e-06,0,0
18831,prystaiko,1,1.8364528545823171e-06,1,2.2780963315814773e-06,0,0
18833,tragically,1,1.8364528545823171e-06,1,2.2780963315814773e-06,0,0
18835,saugus,1,1.8364528545823171e-06,1,2.2780963315814773e-06,0,0
18834,clarita,1,1.8364528545823171e-06,1,2.2780963315814773e-06,0,0
18837,stared,1,1.8364528545823171e-06,1,2.2780963315814773e-06,0,0
18836,remained,1,1.8364528545823171e-06,1,2.2780963315814773e-06,0,0
18838,@franklingraham,1,1.8364528545823171e-06,1,2.2780963315814773e-06,0,0
18839,cudgel,1,1.8364528545823171e-06,1,2.2780963315814773e-06,0,0
18840,specify,1,1.8364528545823171e-06,1,2.2780963315814773e-06,0,0
18842,envisioned,1,1.8364528545823171e-06,1,2.2780963315814773e-06,0,0
18841,envision,1,1.8364528545823171e-06,1,2.2780963315814773e-06,0,0
18844,doemocrat,1,1.8364528545823171e-06,1,2.2780963315814773e-06,0,0
18847,coward,1,1.8364528545823171e-06,1,2.2780963315814773e-06,0,0
18846,congenital,1,1.8364528545823171e-06,1,2.2780963315814773e-06,0,0
18848,psychotic,1,1.8364528545823171e-06,1,2.2780963315814773e-06,0,0
18849,53792,1,1.8364528545823171e-06,1,2.2780963315814773e-06,0,0
18850,angels,1,1.8364528545823171e-06,1,2.2780963315814773e-06,0,0
18851,remedies,1,1.8364528545823171e-06,1,2.2780963315814773e-06,0,0
18853,quarterfinals,1,1.8364528545823171e-06,1,2.2780963315814773e-06,0,0
18855,subverting,1,1.8364528545823171e-06,1,2.2780963315814773e-06,0,0
18854,@billoreilly,1,1.8364528545823171e-06,1,2.2780963315814773e-06,0,0
18856,30th,1,1.8364528545823171e-06,1,2.2780963315814773e-06,0,0
18858,vowing,1,1.8364528545823171e-06,1,2.2780963315814773e-06,0,0
18859,tantalizing,1,1.8364528545823171e-06,1,2.2780963315814773e-06,0,0
18861,risked,1,1.8364528545823171e-06,1,2.2780963315814773e-06,0,0
18862,investigared,1,1.8364528545823171e-06,1,2.2780963315814773e-06,0,0
18865,e-cigarette,1,1.8364528545823171e-06,1,2.2780963315814773e-06,0,0
18864,dilemma,1,1.8364528545823171e-06,1,2.2780963315814773e-06,0,0
18869,kidnapped,1,1.8364528545823171e-06,1,2.2780963315814773e-06,0,0
18870,levinson,1,1.8364528545823171e-06,1,2.2780963315814773e-06,0,0
18872,deepstater,1,1.8364528545823171e-06,1,2.2780963315814773e-06,0,0
18873,👇🏻smart,1,1.8364528545823171e-06,1,2.2780963315814773e-06,0,0
18875,nationalism,1,1.8364528545823171e-06,1,2.2780963315814773e-06,0,0
18874,lowry,1,1.8364528545823171e-06,1,2.2780963315814773e-06,0,0
18877,@bobewashington,1,1.8364528545823171e-06,1,2.2780963315814773e-06,0,0
18878,nails,1,1.8364528545823171e-06,1,2.2780963315814773e-06,0,0
18876,#thefive,1,1.8364528545823171e-06,1,2.2780963315814773e-06,0,0
18879,#magachallenge,1,1.8364528545823171e-06,1,2.2780963315814773e-06,0,0
18882,zapotosky,1,1.8364528545823171e-06,1,2.2780963315814773e-06,0,0
18880,dawsey,1,1.8364528545823171e-06,1,2.2780963315814773e-06,0,0
18881,leonnig,1,1.8364528545823171e-06,1,2.2780963315814773e-06,0,0
18884,monroe,1,1.8364528545823171e-06,1,2.2780963315814773e-06,0,0
18883,#geauxvote➡️,1,1.8364528545823171e-06,1,2.2780963315814773e-06,0,0
18887,#geauxvotepoll,1,1.8364528545823171e-06,1,2.2780963315814773e-06,0,0
18888,finder,1,1.8364528545823171e-06,1,2.2780963315814773e-06,0,0
18889,governorship,1,1.8364528545823171e-06,1,2.2780963315814773e-06,0,0
18890,157,1,1.8364528545823171e-06,1,2.2780963315814773e-06,0,0
18891,momentous,1,1.8364528545823171e-06,1,2.2780963315814773e-06,0,0
18892,eradication,1,1.8364528545823171e-06,1,2.2780963315814773e-06,0,0
18893,hostilities,1,1.8364528545823171e-06,1,2.2780963315814773e-06,0,0
18896,escaped,1,1.8364528545823171e-06,1,2.2780963315814773e-06,0,0
18895,baghdadi,1,1.8364528545823171e-06,1,2.2780963315814773e-06,0,0
18897,ethiopian,1,1.8364528545823171e-06,1,2.2780963315814773e-06,0,0
18898,renaissance,1,1.8364528545823171e-06,1,2.2780963315814773e-06,0,0
18900,volker,1,1.8364528545823171e-06,1,2.2780963315814773e-06,0,0
18899,cetra,1,1.8364528545823171e-06,1,2.2780963315814773e-06,0,0
18902,#electionnight,1,1.8364528545823171e-06,1,2.2780963315814773e-06,0,0
18904,#kygov,1,1.8364528545823171e-06,1,2.2780963315814773e-06,0,0
18905,#msgov,1,1.8364528545823171e-06,1,2.2780963315814773e-06,0,0
18906,ticketpolls,1,1.8364528545823171e-06,1,2.2780963315814773e-06,0,0
18907,#voteonnov5,1,1.8364528545823171e-06,1,2.2780963315814773e-06,0,0
18910,monsters,1,1.8364528545823171e-06,1,2.2780963315814773e-06,0,0
18911,ame,1,1.8364528545823171e-06,1,2.2780963315814773e-06,0,0
18915,consulting,1,1.8364528545823171e-06,1,2.2780963315814773e-06,0,0
18917,suppose,1,1.8364528545823171e-06,1,2.2780963315814773e-06,0,0
18916,esposito,1,1.8364528545823171e-06,1,2.2780963315814773e-06,0,0
18918,whistle,1,1.8364528545823171e-06,1,2.2780963315814773e-06,0,0
18919,mistweet,1,1.8364528545823171e-06,1,2.2780963315814773e-06,0,0
18920,bell,1,1.8364528545823171e-06,1,2.2780963315814773e-06,0,0
18923,english,1,1.8364528545823171e-06,1,2.2780963315814773e-06,0,0
18927,wusses,1,1.8364528545823171e-06,1,2.2780963315814773e-06,0,0
18926,wimps,1,1.8364528545823171e-06,1,2.2780963315814773e-06,0,0
18925,weasels,1,1.8364528545823171e-06,1,2.2780963315814773e-06,0,0
18924,chutzpah,1,1.8364528545823171e-06,1,2.2780963315814773e-06,0,0
18930,rendition,1,1.8364528545823171e-06,1,2.2780963315814773e-06,0,0
18928,freak,1,1.8364528545823171e-06,1,2.2780963315814773e-06,0,0
18932,fixers,1,1.8364528545823171e-06,1,2.2780963315814773e-06,0,0
18933,@pearsonsharp,1,1.8364528545823171e-06,1,2.2780963315814773e-06,0,0
18934,testifies,1,1.8364528545823171e-06,1,2.2780963315814773e-06,0,0
18938,thing-and,1,1.8364528545823171e-06,1,2.2780963315814773e-06,0,0
18937,statesbut,1,1.8364528545823171e-06,1,2.2780963315814773e-06,0,0
18939,floors,1,1.8364528545823171e-06,1,2.2780963315814773e-06,0,0
18940,stoppers,1,1.8364528545823171e-06,1,2.2780963315814773e-06,0,0
18941,@1kkilgore,1,1.8364528545823171e-06,1,2.2780963315814773e-06,0,0
18943,carr,1,1.8364528545823171e-06,1,2.2780963315814773e-06,0,0
18949,@tombrokaw,1,1.8364528545823171e-06,1,2.2780963315814773e-06,0,0
18950,immersed,1,1.8364528545823171e-06,1,2.2780963315814773e-06,0,0
18952,adjusted,1,1.8364528545823171e-06,1,2.2780963315814773e-06,0,0
18953,revisions,1,1.8364528545823171e-06,1,2.2780963315814773e-06,0,0
18951,303000,1,1.8364528545823171e-06,1,2.2780963315814773e-06,0,0
18955,superintendent,1,1.8364528545823171e-06,1,2.2780963315814773e-06,0,0
18956,highjacked,1,1.8364528545823171e-06,1,2.2780963315814773e-06,0,0
18959,selecting,1,1.8364528545823171e-06,1,2.2780963315814773e-06,0,0
18958,apec,1,1.8364528545823171e-06,1,2.2780963315814773e-06,0,0
18963,@cablenewswatch,1,1.8364528545823171e-06,1,2.2780963315814773e-06,0,0
18966,🎉🍾,1,1.8364528545823171e-06,1,2.2780963315814773e-06,0,0
18960,18-49,1,1.8364528545823171e-06,1,2.2780963315814773e-06,0,0
18962,25-54,1,1.8364528545823171e-06,1,2.2780963315814773e-06,0,0
18965,demosalso,1,1.8364528545823171e-06,1,2.2780963315814773e-06,0,0
18961,18m,1,1.8364528545823171e-06,1,2.2780963315814773e-06,0,0
18967,validate,1,1.8364528545823171e-06,1,2.2780963315814773e-06,0,0
18969,selectively,1,1.8364528545823171e-06,1,2.2780963315814773e-06,0,0
18970,tad,1,1.8364528545823171e-06,1,2.2780963315814773e-06,0,0
18968,discreet,1,1.8364528545823171e-06,1,2.2780963315814773e-06,0,0
18971,not-not,1,1.8364528545823171e-06,1,2.2780963315814773e-06,0,0
18972,conan,1,1.8364528545823171e-06,1,2.2780963315814773e-06,0,0
18975,sawbefore,1,1.8364528545823171e-06,1,2.2780963315814773e-06,0,0
18974,beginningso,1,1.8364528545823171e-06,1,2.2780963315814773e-06,0,0
18976,illusions,1,1.8364528545823171e-06,1,2.2780963315814773e-06,0,0
18977,@fiatchryslerna,1,1.8364528545823171e-06,1,2.2780963315814773e-06,0,0
18978,@globlautomkrs,1,1.8364528545823171e-06,1,2.2780963315814773e-06,0,0
18980,@govdunleavy,1,1.8364528545823171e-06,1,2.2780963315814773e-06,0,0
18981,obsess,1,1.8364528545823171e-06,1,2.2780963315814773e-06,0,0
18982,precisely,1,1.8364528545823171e-06,1,2.2780963315814773e-06,0,0
18984,rupublicans,1,1.8364528545823171e-06,1,2.2780963315814773e-06,0,0
18986,infair,1,1.8364528545823171e-06,1,2.2780963315814773e-06,0,0
18985,casual,1,1.8364528545823171e-06,1,2.2780963315814773e-06,0,0
18987,oppidite,1,1.8364528545823171e-06,1,2.2780963315814773e-06,0,0
18988,nunez,1,1.8364528545823171e-06,1,2.2780963315814773e-06,0,0
18990,al-baghdadis,1,1.8364528545823171e-06,1,2.2780963315814773e-06,0,0
18992,ukrain,1,1.8364528545823171e-06,1,2.2780963315814773e-06,0,0
18993,crovatto,1,1.8364528545823171e-06,1,2.2780963315814773e-06,0,0
18997,supporter@realdonaldtrump,1,1.8364528545823171e-06,1,2.2780963315814773e-06,0,0
18995,#trump2016,1,1.8364528545823171e-06,1,2.2780963315814773e-06,0,0
18998,#iacp2019,1,1.8364528545823171e-06,1,2.2780963315814773e-06,0,0
18999,murderer,1,1.8364528545823171e-06,1,2.2780963315814773e-06,0,0
19000,@martharaddatz,1,1.8364528545823171e-06,1,2.2780963315814773e-06,0,0
19001,@terrymoran,1,1.8364528545823171e-06,1,2.2780963315814773e-06,0,0
19003,commences,1,1.8364528545823171e-06,1,2.2780963315814773e-06,0,0
19002,#happydiwali,1,1.8364528545823171e-06,1,2.2780963315814773e-06,0,0
19009,hazardous,1,1.8364528545823171e-06,1,2.2780963315814773e-06,0,0
19011,rots,1,1.8364528545823171e-06,1,2.2780963315814773e-06,0,0
19010,impacting,1,1.8364528545823171e-06,1,2.2780963315814773e-06,0,0
19012,sanitary,1,1.8364528545823171e-06,1,2.2780963315814773e-06,0,0
19013,flynnterrible,1,1.8364528545823171e-06,1,2.2780963315814773e-06,0,0
19016,thing-sick,1,1.8364528545823171e-06,1,2.2780963315814773e-06,0,0
19014,conjures,1,1.8364528545823171e-06,1,2.2780963315814773e-06,0,0
19018,@cnnpolitics,1,1.8364528545823171e-06,1,2.2780963315814773e-06,0,0
19019,destinations,1,1.8364528545823171e-06,1,2.2780963315814773e-06,0,0
19020,havana,1,1.8364528545823171e-06,1,2.2780963315814773e-06,0,0
19023,swipe,1,1.8364528545823171e-06,1,2.2780963315814773e-06,0,0
19024,@lindseygraham,1,1.8364528545823171e-06,1,2.2780963315814773e-06,0,0
19025,condemning,1,1.8364528545823171e-06,1,2.2780963315814773e-06,0,0
19026,@garycoby,1,1.8364528545823171e-06,1,2.2780963315814773e-06,0,0
19027,reformat,1,1.8364528545823171e-06,1,2.2780963315814773e-06,0,0
19028,sa,1,1.8364528545823171e-06,1,2.2780963315814773e-06,0,0
19029,bravado,1,1.8364528545823171e-06,1,2.2780963315814773e-06,0,0
19030,greedy,1,1.8364528545823171e-06,1,2.2780963315814773e-06,0,0
19033,@reparrington,1,1.8364528545823171e-06,1,2.2780963315814773e-06,0,0
19031,#impeachmentinquisition,1,1.8364528545823171e-06,1,2.2780963315814773e-06,0,0
19032,@realdonaldtrumpthis,1,1.8364528545823171e-06,1,2.2780963315814773e-06,0,0
19034,proce,1,1.8364528545823171e-06,1,2.2780963315814773e-06,0,0
19035,@mazloumabdi,1,1.8364528545823171e-06,1,2.2780963315814773e-06,0,0
19037,turkeykurds,1,1.8364528545823171e-06,1,2.2780963315814773e-06,0,0
19036,reconstituted,1,1.8364528545823171e-06,1,2.2780963315814773e-06,0,0
19038,derelict,1,1.8364528545823171e-06,1,2.2780963315814773e-06,0,0
19041,kiddingly,1,1.8364528545823171e-06,1,2.2780963315814773e-06,0,0
19040,coloradothen,1,1.8364528545823171e-06,1,2.2780963315814773e-06,0,0
19042,refered,1,1.8364528545823171e-06,1,2.2780963315814773e-06,0,0
19039,auditorium,1,1.8364528545823171e-06,1,2.2780963315814773e-06,0,0
19044,well-meaning,1,1.8364528545823171e-06,1,2.2780963315814773e-06,0,0
19045,bellinger,1,1.8364528545823171e-06,1,2.2780963315814773e-06,0,0
19046,diplomat,1,1.8364528545823171e-06,1,2.2780963315814773e-06,0,0
19047,respirators,1,1.8364528545823171e-06,1,2.2780963315814773e-06,0,0
19050,mazloum,1,1.8364528545823171e-06,1,2.2780963315814773e-06,0,0
19048,@mustefabali,1,1.8364528545823171e-06,1,2.2780963315814773e-06,0,0
19052,turkeysyria,1,1.8364528545823171e-06,1,2.2780963315814773e-06,0,0
19051,missions,1,1.8364528545823171e-06,1,2.2780963315814773e-06,0,0
19053,interact,1,1.8364528545823171e-06,1,2.2780963315814773e-06,0,0
19054,studends,1,1.8364528545823171e-06,1,2.2780963315814773e-06,0,0
19057,lynching,1,1.8364528545823171e-06,1,2.2780963315814773e-06,0,0
19059,betterment,1,1.8364528545823171e-06,1,2.2780963315814773e-06,0,0
19061,honestare,1,1.8364528545823171e-06,1,2.2780963315814773e-06,0,0
19062,@johnvoight,1,1.8364528545823171e-06,1,2.2780963315814773e-06,0,0
19066,deposition,1,1.8364528545823171e-06,1,2.2780963315814773e-06,0,0
19067,depose,1,1.8364528545823171e-06,1,2.2780963315814773e-06,0,0
19070,esperanto,1,1.8364528545823171e-06,1,2.2780963315814773e-06,0,0
19071,irrational,1,1.8364528545823171e-06,1,2.2780963315814773e-06,0,0
19072,ballrooms,1,1.8364528545823171e-06,1,2.2780963315814773e-06,0,0
19074,environmentalist,1,1.8364528545823171e-06,1,2.2780963315814773e-06,0,0
19075,@repmcclintock,1,1.8364528545823171e-06,1,2.2780963315814773e-06,0,0
19076,kenn,1,1.8364528545823171e-06,1,2.2780963315814773e-06,0,0
19077,@badluckjones,1,1.8364528545823171e-06,1,2.2780963315814773e-06,0,0
19078,beacon,1,1.8364528545823171e-06,1,2.2780963315814773e-06,0,0
19080,lefty,1,1.8364528545823171e-06,1,2.2780963315814773e-06,0,0
19079,brewer,1,1.8364528545823171e-06,1,2.2780963315814773e-06,0,0
19081,wags,1,1.8364528545823171e-06,1,2.2780963315814773e-06,0,0
19082,#stopthecoup,1,1.8364528545823171e-06,1,2.2780963315814773e-06,0,0
19085,mccaul,1,1.8364528545823171e-06,1,2.2780963315814773e-06,0,0
19084,defies,1,1.8364528545823171e-06,1,2.2780963315814773e-06,0,0
19086,brouillette,1,1.8364528545823171e-06,1,2.2780963315814773e-06,0,0
19087,dans,1,1.8364528545823171e-06,1,2.2780963315814773e-06,0,0
19088,bandaids,1,1.8364528545823171e-06,1,2.2780963315814773e-06,0,0
19090,sniper,1,1.8364528545823171e-06,1,2.2780963315814773e-06,0,0
19089,mortar,1,1.8364528545823171e-06,1,2.2780963315814773e-06,0,0
19092,forcefully,1,1.8364528545823171e-06,1,2.2780963315814773e-06,0,0
19096,tolerates,1,1.8364528545823171e-06,1,2.2780963315814773e-06,0,0
19094,accepts,1,1.8364528545823171e-06,1,2.2780963315814773e-06,0,0
19098,unconventional,1,1.8364528545823171e-06,1,2.2780963315814773e-06,0,0
19099,@rwwgop,1,1.8364528545823171e-06,1,2.2780963315814773e-06,0,0
19100,baseless,1,1.8364528545823171e-06,1,2.2780963315814773e-06,0,0
19101,su,1,1.8364528545823171e-06,1,2.2780963315814773e-06,0,0
19105,outraged,1,1.8364528545823171e-06,1,2.2780963315814773e-06,0,0
19106,slaughter,1,1.8364528545823171e-06,1,2.2780963315814773e-06,0,0
19104,bucksexton,1,1.8364528545823171e-06,1,2.2780963315814773e-06,0,0
19108,wiener,1,1.8364528545823171e-06,1,2.2780963315814773e-06,0,0
19109,babin,1,1.8364528545823171e-06,1,2.2780963315814773e-06,0,0
19110,upstairs,1,1.8364528545823171e-06,1,2.2780963315814773e-06,0,0
19112,coercion,1,1.8364528545823171e-06,1,2.2780963315814773e-06,0,0
19113,deprived,1,1.8364528545823171e-06,1,2.2780963315814773e-06,0,0
19114,1929,1,1.8364528545823171e-06,1,2.2780963315814773e-06,0,0
19118,#stlblues,1,1.8364528545823171e-06,1,2.2780963315814773e-06,0,0
19121,zucker,1,1.8364528545823171e-06,1,2.2780963315814773e-06,0,0
19120,resigining,1,1.8364528545823171e-06,1,2.2780963315814773e-06,0,0
19122,#kag2020tickets,1,1.8364528545823171e-06,1,2.2780963315814773e-06,0,0
19123,household,1,1.8364528545823171e-06,1,2.2780963315814773e-06,0,0
19124,recoverable,1,1.8364528545823171e-06,1,2.2780963315814773e-06,0,0
19125,selective,1,1.8364528545823171e-06,1,2.2780963315814773e-06,0,0
19127,veritas-obtained,1,1.8364528545823171e-06,1,2.2780963315814773e-06,0,0
19126,highlight,1,1.8364528545823171e-06,1,2.2780963315814773e-06,0,0
19128,zuckers,1,1.8364528545823171e-06,1,2.2780963315814773e-06,0,0
19129,turks,1,1.8364528545823171e-06,1,2.2780963315814773e-06,0,0
19130,transcrpt,1,1.8364528545823171e-06,1,2.2780963315814773e-06,0,0
19131,hijacked,1,1.8364528545823171e-06,1,2.2780963315814773e-06,0,0
19132,turkeys,1,1.8364528545823171e-06,1,2.2780963315814773e-06,0,0
19133,abuts,1,1.8364528545823171e-06,1,2.2780963315814773e-06,0,0
19135,napoleon,1,1.8364528545823171e-06,1,2.2780963315814773e-06,0,0
19134,bonaparte,1,1.8364528545823171e-06,1,2.2780963315814773e-06,0,0
19138,wrap,1,1.8364528545823171e-06,1,2.2780963315814773e-06,0,0
19137,greasy,1,1.8364528545823171e-06,1,2.2780963315814773e-06,0,0
19141,hapgood,1,1.8364528545823171e-06,1,2.2780963315814773e-06,0,0
19142,justly,1,1.8364528545823171e-06,1,2.2780963315814773e-06,0,0
19139,@steveducey,1,1.8364528545823171e-06,1,2.2780963315814773e-06,0,0
19143,recaptured,1,1.8364528545823171e-06,1,2.2780963315814773e-06,0,0
19144,kilmeade,1,1.8364528545823171e-06,1,2.2780963315814773e-06,0,0
19145,underestimated,1,1.8364528545823171e-06,1,2.2780963315814773e-06,0,0
19146,drunk,1,1.8364528545823171e-06,1,2.2780963315814773e-06,0,0
19147,serial,1,1.8364528545823171e-06,1,2.2780963315814773e-06,0,0
19149,finalized,1,1.8364528545823171e-06,1,2.2780963315814773e-06,0,0
19151,considers,1,1.8364528545823171e-06,1,2.2780963315814773e-06,0,0
19152,pkk,1,1.8364528545823171e-06,1,2.2780963315814773e-06,0,0
19154,buster,1,1.8364528545823171e-06,1,2.2780963315814773e-06,0,0
19155,16-20,1,1.8364528545823171e-06,1,2.2780963315814773e-06,0,0
19158,bombmaker,1,1.8364528545823171e-06,1,2.2780963315814773e-06,0,0
19162,mansion,1,1.8364528545823171e-06,1,2.2780963315814773e-06,0,0
19164,kerr,1,1.8364528545823171e-06,1,2.2780963315814773e-06,0,0
19163,grovel,1,1.8364528545823171e-06,1,2.2780963315814773e-06,0,0
19165,pander,1,1.8364528545823171e-06,1,2.2780963315814773e-06,0,0
19169,@minneapolispd,1,1.8364528545823171e-06,1,2.2780963315814773e-06,0,0
19171,#trumpminneapolis,1,1.8364528545823171e-06,1,2.2780963315814773e-06,0,0
19174,daddy,1,1.8364528545823171e-06,1,2.2780963315814773e-06,0,0
19177,volodymyr,1,1.8364528545823171e-06,1,2.2780963315814773e-06,0,0
19175,blackmail,1,1.8364528545823171e-06,1,2.2780963315814773e-06,0,0
19176,impeachment-minded,1,1.8364528545823171e-06,1,2.2780963315814773e-06,0,0
19180,militants,1,1.8364528545823171e-06,1,2.2780963315814773e-06,0,0
19179,beheadings,1,1.8364528545823171e-06,1,2.2780963315814773e-06,0,0
19178,beetles,1,1.8364528545823171e-06,1,2.2780963315814773e-06,0,0
19181,kiriakou,1,1.8364528545823171e-06,1,2.2780963315814773e-06,0,0
19182,implications,1,1.8364528545823171e-06,1,2.2780963315814773e-06,0,0
19183,frightening,1,1.8364528545823171e-06,1,2.2780963315814773e-06,0,0
19184,premise,1,1.8364528545823171e-06,1,2.2780963315814773e-06,0,0
19186,wirch,1,1.8364528545823171e-06,1,2.2780963315814773e-06,0,0
19188,gibson,1,1.8364528545823171e-06,1,2.2780963315814773e-06,0,0
19189,mandating,1,1.8364528545823171e-06,1,2.2780963315814773e-06,0,0
19191,stifle,1,1.8364528545823171e-06,1,2.2780963315814773e-06,0,0
19190,sell-out,1,1.8364528545823171e-06,1,2.2780963315814773e-06,0,0
19192,leaning,1,1.8364528545823171e-06,1,2.2780963315814773e-06,0,0
19193,kroll,1,1.8364528545823171e-06,1,2.2780963315814773e-06,0,0
19194,shirts,1,1.8364528545823171e-06,1,2.2780963315814773e-06,0,0
19195,uber,1,1.8364528545823171e-06,1,2.2780963315814773e-06,0,0
19197,quos,1,1.8364528545823171e-06,1,2.2780963315814773e-06,0,0
19198,financiallyweapons,1,1.8364528545823171e-06,1,2.2780963315814773e-06,0,0
19200,#endendlesswars,1,1.8364528545823171e-06,1,2.2780963315814773e-06,0,0
19201,72000,1,1.8364528545823171e-06,1,2.2780963315814773e-06,0,0
19202,@seanmdav,1,1.8364528545823171e-06,1,2.2780963315814773e-06,0,0
19204,chambers,1,1.8364528545823171e-06,1,2.2780963315814773e-06,0,0
19205,ic,1,1.8364528545823171e-06,1,2.2780963315814773e-06,0,0
19203,backdated,1,1.8364528545823171e-06,1,2.2780963315814773e-06,0,0
19206,felonies,1,1.8364528545823171e-06,1,2.2780963315814773e-06,0,0
19208,quagmire,1,1.8364528545823171e-06,1,2.2780963315814773e-06,0,0
19209,functions,1,1.8364528545823171e-06,1,2.2780963315814773e-06,0,0
19211,freedomworks,1,1.8364528545823171e-06,1,2.2780963315814773e-06,0,0
19210,disposable,1,1.8364528545823171e-06,1,2.2780963315814773e-06,0,0
19213,blockbusters,1,1.8364528545823171e-06,1,2.2780963315814773e-06,0,0
19214,incomrs,1,1.8364528545823171e-06,1,2.2780963315814773e-06,0,0
19212,4100,1,1.8364528545823171e-06,1,2.2780963315814773e-06,0,0
19216,ajit,1,1.8364528545823171e-06,1,2.2780963315814773e-06,0,0
19217,pai,1,1.8364528545823171e-06,1,2.2780963315814773e-06,0,0
19218,sucker,1,1.8364528545823171e-06,1,2.2780963315814773e-06,0,0
19219,aim,1,1.8364528545823171e-06,1,2.2780963315814773e-06,0,0
19220,evilly,1,1.8364528545823171e-06,1,2.2780963315814773e-06,0,0
19221,ruthless,1,1.8364528545823171e-06,1,2.2780963315814773e-06,0,0
19223,farmer,1,1.8364528545823171e-06,1,2.2780963315814773e-06,0,0
19225,gerry,1,1.8364528545823171e-06,1,2.2780963315814773e-06,0,0
19224,@wsjatlarge,1,1.8364528545823171e-06,1,2.2780963315814773e-06,0,0
19227,reaspected,1,1.8364528545823171e-06,1,2.2780963315814773e-06,0,0
19226,@ronjohnsonwi,1,1.8364528545823171e-06,1,2.2780963315814773e-06,0,0
19228,hostess,1,1.8364528545823171e-06,1,2.2780963315814773e-06,0,0
19229,extorted,1,1.8364528545823171e-06,1,2.2780963315814773e-06,0,0
19231,apparent,1,1.8364528545823171e-06,1,2.2780963315814773e-06,0,0
19232,transactions,1,1.8364528545823171e-06,1,2.2780963315814773e-06,0,0
19233,plusplus,1,1.8364528545823171e-06,1,2.2780963315814773e-06,0,0
19234,🇺🇸🇦🇺,1,1.8364528545823171e-06,1,2.2780963315814773e-06,0,0
19236,negligent,1,1.8364528545823171e-06,1,2.2780963315814773e-06,0,0
19235,empires,1,1.8364528545823171e-06,1,2.2780963315814773e-06,0,0
19238,credibilitybut,1,1.8364528545823171e-06,1,2.2780963315814773e-06,0,0
19239,wash,1,1.8364528545823171e-06,1,2.2780963315814773e-06,0,0
19240,#impeachmittromney,1,1.8364528545823171e-06,1,2.2780963315814773e-06,0,0
19244,@andrewcmccarthy,1,1.8364528545823171e-06,1,2.2780963315814773e-06,0,0
19245,pranksters,1,1.8364528545823171e-06,1,2.2780963315814773e-06,0,0
19246,ex-envoy,1,1.8364528545823171e-06,1,2.2780963315814773e-06,0,0
19248,perpetuated,1,1.8364528545823171e-06,1,2.2780963315814773e-06,0,0
19247,ketay,1,1.8364528545823171e-06,1,2.2780963315814773e-06,0,0
19249,enraged,1,1.8364528545823171e-06,1,2.2780963315814773e-06,0,0
19253,statementthe,1,1.8364528545823171e-06,1,2.2780963315814773e-06,0,0
19255,long-awaited,1,1.8364528545823171e-06,1,2.2780963315814773e-06,0,0
19257,visa-free,1,1.8364528545823171e-06,1,2.2780963315814773e-06,0,0
19256,versa,1,1.8364528545823171e-06,1,2.2780963315814773e-06,0,0
19260,schiffty,1,1.8364528545823171e-06,1,2.2780963315814773e-06,0,0
19262,medicar,1,1.8364528545823171e-06,1,2.2780963315814773e-06,0,0
19264,projecting,1,1.8364528545823171e-06,1,2.2780963315814773e-06,0,0
19265,backfiring,1,1.8364528545823171e-06,1,2.2780963315814773e-06,0,0
19266,gators,1,1.8364528545823171e-06,1,2.2780963315814773e-06,0,0
19269,hugh,1,1.8364528545823171e-06,1,2.2780963315814773e-06,0,0
19270,kellie,1,1.8364528545823171e-06,1,2.2780963315814773e-06,0,0
19272,protectors,1,1.8364528545823171e-06,1,2.2780963315814773e-06,0,0
19273,whistle-blowers,1,1.8364528545823171e-06,1,2.2780963315814773e-06,0,0
19274,223-306,1,1.8364528545823171e-06,1,2.2780963315814773e-06,0,0
19277,camouflage,1,1.8364528545823171e-06,1,2.2780963315814773e-06,0,0
19281,zaino,1,1.8364528545823171e-06,1,2.2780963315814773e-06,0,0
19282,moot,1,1.8364528545823171e-06,1,2.2780963315814773e-06,0,0
19283,#donothingdems,1,1.8364528545823171e-06,1,2.2780963315814773e-06,0,0
19284,specifications,1,1.8364528545823171e-06,1,2.2780963315814773e-06,0,0
19285,hoopla,1,1.8364528545823171e-06,1,2.2780963315814773e-06,0,0
19286,pelosichuck,1,1.8364528545823171e-06,1,2.2780963315814773e-06,0,0
19287,stymie,1,1.8364528545823171e-06,1,2.2780963315814773e-06,0,0
19288,rispone,1,1.8364528545823171e-06,1,2.2780963315814773e-06,0,0
19289,congratulatory,1,1.8364528545823171e-06,1,2.2780963315814773e-06,0,0
19290,@realdonaldtrumps,1,1.8364528545823171e-06,1,2.2780963315814773e-06,0,0
19291,peop,1,1.8364528545823171e-06,1,2.2780963315814773e-06,0,0
19292,euphoria,1,1.8364528545823171e-06,1,2.2780963315814773e-06,0,0
19293,wenti,1,1.8364528545823171e-06,1,2.2780963315814773e-06,0,0
19295,@millerstream,1,1.8364528545823171e-06,1,2.2780963315814773e-06,0,0
19294,@blazetv,1,1.8364528545823171e-06,1,2.2780963315814773e-06,0,0
19296,@freedomcaucus,1,1.8364528545823171e-06,1,2.2780963315814773e-06,0,0
19298,@hyundai,1,1.8364528545823171e-06,1,2.2780963315814773e-06,0,0
19299,@kia,1,1.8364528545823171e-06,1,2.2780963315814773e-06,0,0
19297,@aptiv,1,1.8364528545823171e-06,1,2.2780963315814773e-06,0,0
19300,venture,1,1.8364528545823171e-06,1,2.2780963315814773e-06,0,0
19301,@apple,1,1.8364528545823171e-06,1,2.2780963315814773e-06,0,0
19303,navistar,1,1.8364528545823171e-06,1,2.2780963315814773e-06,0,0
19304,pre-emptive,1,1.8364528545823171e-06,1,2.2780963315814773e-06,0,0
19305,#fakewhistleblower,1,1.8364528545823171e-06,1,2.2780963315814773e-06,0,0
19306,submittal,1,1.8364528545823171e-06,1,2.2780963315814773e-06,0,0
19307,johnathan,1,1.8364528545823171e-06,1,2.2780963315814773e-06,0,0
19310,waking,1,1.8364528545823171e-06,1,2.2780963315814773e-06,0,0
19309,beijings,1,1.8364528545823171e-06,1,2.2780963315814773e-06,0,0
19308,ambitions,1,1.8364528545823171e-06,1,2.2780963315814773e-06,0,0
19311,aloud,1,1.8364528545823171e-06,1,2.2780963315814773e-06,0,0
19312,fracture,1,1.8364528545823171e-06,1,2.2780963315814773e-06,0,0
19313,negate,1,1.8364528545823171e-06,1,2.2780963315814773e-06,0,0
19314,illegitimately,1,1.8364528545823171e-06,1,2.2780963315814773e-06,0,0
19315,yoga,1,1.8364528545823171e-06,1,2.2780963315814773e-06,0,0
19316,trumped-up,1,1.8364528545823171e-06,1,2.2780963315814773e-06,0,0
19317,swirling,1,1.8364528545823171e-06,1,2.2780963315814773e-06,0,0
19318,@jnedster,1,1.8364528545823171e-06,1,2.2780963315814773e-06,0,0
19320,@bobbielocksley,1,1.8364528545823171e-06,1,2.2780963315814773e-06,0,0
19319,#rt,1,1.8364528545823171e-06,1,2.2780963315814773e-06,0,0
19324,@joeledmonson,1,1.8364528545823171e-06,1,2.2780963315814773e-06,0,0
19325,🤦‍♂️🤦‍♂️🤦‍♂️🤦‍♂️😂😂😂😂,1,1.8364528545823171e-06,1,2.2780963315814773e-06,0,0
19326,@robcoltoff,1,1.8364528545823171e-06,1,2.2780963315814773e-06,0,0
19327,shit,1,1.8364528545823171e-06,1,2.2780963315814773e-06,0,0
19328,@rafbo5,1,1.8364528545823171e-06,1,2.2780963315814773e-06,0,0
19329,implies,1,1.8364528545823171e-06,1,2.2780963315814773e-06,0,0
19330,rivalpot,1,1.8364528545823171e-06,1,2.2780963315814773e-06,0,0
19331,@bulldawgderek,1,1.8364528545823171e-06,1,2.2780963315814773e-06,0,0
19332,amen,1,1.8364528545823171e-06,1,2.2780963315814773e-06,0,0
19334,preach,1,1.8364528545823171e-06,1,2.2780963315814773e-06,0,0
19333,fac,1,1.8364528545823171e-06,1,2.2780963315814773e-06,0,0
19335,@duaneinskeep,1,1.8364528545823171e-06,1,2.2780963315814773e-06,0,0
19338,libeling,1,1.8364528545823171e-06,1,2.2780963315814773e-06,0,0
19339,savages,1,1.8364528545823171e-06,1,2.2780963315814773e-06,0,0
19340,sounding,1,1.8364528545823171e-06,1,2.2780963315814773e-06,0,0
19341,discribing,1,1.8364528545823171e-06,1,2.2780963315814773e-06,0,0
19342,hyphen,1,1.8364528545823171e-06,1,2.2780963315814773e-06,0,0
19343,arming,1,1.8364528545823171e-06,1,2.2780963315814773e-06,0,0
19344,5b,1,1.8364528545823171e-06,1,2.2780963315814773e-06,0,0
19345,@senshelby,1,1.8364528545823171e-06,1,2.2780963315814773e-06,0,0
19346,appropriations,1,1.8364528545823171e-06,1,2.2780963315814773e-06,0,0
19347,misdemeanor,1,1.8364528545823171e-06,1,2.2780963315814773e-06,0,0
19348,rd,1,1.8364528545823171e-06,1,2.2780963315814773e-06,0,0
19349,@freebeacon,1,1.8364528545823171e-06,1,2.2780963315814773e-06,0,0
19350,explicit,1,1.8364528545823171e-06,1,2.2780963315814773e-06,0,0
19351,ofunless,1,1.8364528545823171e-06,1,2.2780963315814773e-06,0,0
19353,thiswere,1,1.8364528545823171e-06,1,2.2780963315814773e-06,0,0
19352,pamela,1,1.8364528545823171e-06,1,2.2780963315814773e-06,0,0
19354,@pnjaban,1,1.8364528545823171e-06,1,2.2780963315814773e-06,0,0
19356,scrambling,1,1.8364528545823171e-06,1,2.2780963315814773e-06,0,0
19357,thisthey,1,1.8364528545823171e-06,1,2.2780963315814773e-06,0,0
19355,bizarre,1,1.8364528545823171e-06,1,2.2780963315814773e-06,0,0
19359,ukraines,1,1.8364528545823171e-06,1,2.2780963315814773e-06,0,0
19358,democratadam,1,1.8364528545823171e-06,1,2.2780963315814773e-06,0,0
19360,@repdevinnunes,1,1.8364528545823171e-06,1,2.2780963315814773e-06,0,0
19361,democratcrooked,1,1.8364528545823171e-06,1,2.2780963315814773e-06,0,0
19364,involves,1,1.8364528545823171e-06,1,2.2780963315814773e-06,0,0
19367,malicious,1,1.8364528545823171e-06,1,2.2780963315814773e-06,0,0
19369,seditious,1,1.8364528545823171e-06,1,2.2780963315814773e-06,0,0
19368,obamaclinton,1,1.8364528545823171e-06,1,2.2780963315814773e-06,0,0
19370,@peterscheeizer,1,1.8364528545823171e-06,1,2.2780963315814773e-06,0,0
19371,schemes,1,1.8364528545823171e-06,1,2.2780963315814773e-06,0,0
19373,exquisite,1,1.8364528545823171e-06,1,2.2780963315814773e-06,0,0
19372,between🇺🇸🇦🇺both,1,1.8364528545823171e-06,1,2.2780963315814773e-06,0,0
19374,uncommon,1,1.8364528545823171e-06,1,2.2780963315814773e-06,0,0
19375,unfailing,1,1.8364528545823171e-06,1,2.2780963315814773e-06,0,0
19377,paloma,1,1.8364528545823171e-06,1,2.2780963315814773e-06,0,0
19376,duffy,1,1.8364528545823171e-06,1,2.2780963315814773e-06,0,0
19378,batting,1,1.8364528545823171e-06,1,2.2780963315814773e-06,0,0
19381,grassleys,1,1.8364528545823171e-06,1,2.2780963315814773e-06,0,0
19382,communicator,1,1.8364528545823171e-06,1,2.2780963315814773e-06,0,0
19384,72nd,1,1.8364528545823171e-06,1,2.2780963315814773e-06,0,0
19383,#hbdusaf,1,1.8364528545823171e-06,1,2.2780963315814773e-06,0,0
19385,polluting,1,1.8364528545823171e-06,1,2.2780963315814773e-06,0,0
19386,revoking,1,1.8364528545823171e-06,1,2.2780963315814773e-06,0,0
19387,iihan,1,1.8364528545823171e-06,1,2.2780963315814773e-06,0,0
19388,@morningsmaria,1,1.8364528545823171e-06,1,2.2780963315814773e-06,0,0
19391,rio,1,1.8364528545823171e-06,1,2.2780963315814773e-06,0,0
19390,rancho,1,1.8364528545823171e-06,1,2.2780963315814773e-06,0,0
19392,publishing,1,1.8364528545823171e-06,1,2.2780963315814773e-06,0,0
19394,storied,1,1.8364528545823171e-06,1,2.2780963315814773e-06,0,0
19393,enclaves,1,1.8364528545823171e-06,1,2.2780963315814773e-06,0,0
19395,almighty,1,1.8364528545823171e-06,1,2.2780963315814773e-06,0,0
19396,bound,1,1.8364528545823171e-06,1,2.2780963315814773e-06,0,0
19398,grey,1,1.8364528545823171e-06,1,2.2780963315814773e-06,0,0
19403,sununu,1,1.8364528545823171e-06,1,2.2780963315814773e-06,0,0
19402,goalposts,1,1.8364528545823171e-06,1,2.2780963315814773e-06,0,0
19408,shrank,1,1.8364528545823171e-06,1,2.2780963315814773e-06,0,0
19406,inflationhighest,1,1.8364528545823171e-06,1,2.2780963315814773e-06,0,0
19409,exporter,1,1.8364528545823171e-06,1,2.2780963315814773e-06,0,0
19411,oconnell,1,1.8364528545823171e-06,1,2.2780963315814773e-06,0,0
19413,slush,1,1.8364528545823171e-06,1,2.2780963315814773e-06,0,0
19414,barreling,1,1.8364528545823171e-06,1,2.2780963315814773e-06,0,0
19415,respirator,1,1.8364528545823171e-06,1,2.2780963315814773e-06,0,0
19416,culprit,1,1.8364528545823171e-06,1,2.2780963315814773e-06,0,0
19418,well-supplied,1,1.8364528545823171e-06,1,2.2780963315814773e-06,0,0
19417,permitting,1,1.8364528545823171e-06,1,2.2780963315814773e-06,0,0
19419,to-be-determined,1,1.8364528545823171e-06,1,2.2780963315814773e-06,0,0
19420,kathleen,1,1.8364528545823171e-06,1,2.2780963315814773e-06,0,0
19421,clash,1,1.8364528545823171e-06,1,2.2780963315814773e-06,0,0
19422,havecoalesced,1,1.8364528545823171e-06,1,2.2780963315814773e-06,0,0
19423,resuscitation,1,1.8364528545823171e-06,1,2.2780963315814773e-06,0,0
19424,#protectkavanaugh,1,1.8364528545823171e-06,1,2.2780963315814773e-06,0,0
19426,liable,1,1.8364528545823171e-06,1,2.2780963315814773e-06,0,0
19428,netanyahu,1,1.8364528545823171e-06,1,2.2780963315814773e-06,0,0
19430,joy-ann,1,1.8364528545823171e-06,1,2.2780963315814773e-06,0,0
19431,showbiz,1,1.8364528545823171e-06,1,2.2780963315814773e-06,0,0
19432,cigarettes,1,1.8364528545823171e-06,1,2.2780963315814773e-06,0,0
19433,counterfeits,1,1.8364528545823171e-06,1,2.2780963315814773e-06,0,0
19434,reverberated,1,1.8364528545823171e-06,1,2.2780963315814773e-06,0,0
19435,surp,1,1.8364528545823171e-06,1,2.2780963315814773e-06,0,0
19436,@guypbenson,1,1.8364528545823171e-06,1,2.2780963315814773e-06,0,0
19439,succeeding,1,1.8364528545823171e-06,1,2.2780963315814773e-06,0,0
19437,depreciating,1,1.8364528545823171e-06,1,2.2780963315814773e-06,0,0
19440,andrés,1,1.8364528545823171e-06,1,2.2780963315814773e-06,0,0
19441,lópez,1,1.8364528545823171e-06,1,2.2780963315814773e-06,0,0
19444,uplift,1,1.8364528545823171e-06,1,2.2780963315814773e-06,0,0
19443,#honor911,1,1.8364528545823171e-06,1,2.2780963315814773e-06,0,0
19445,hypothetical,1,1.8364528545823171e-06,1,2.2780963315814773e-06,0,0
19446,postabc,1,1.8364528545823171e-06,1,2.2780963315814773e-06,0,0
19448,naïveté,1,1.8364528545823171e-06,1,2.2780963315814773e-06,0,0
19447,boneheads,1,1.8364528545823171e-06,1,2.2780963315814773e-06,0,0
19449,lengthening,1,1.8364528545823171e-06,1,2.2780963315814773e-06,0,0
19450,chains,1,1.8364528545823171e-06,1,2.2780963315814773e-06,0,0
19452,@alicetweet,1,1.8364528545823171e-06,1,2.2780963315814773e-06,0,0
19453,09,1,1.8364528545823171e-06,1,2.2780963315814773e-06,0,0
19456,@condoleezzarice,1,1.8364528545823171e-06,1,2.2780963315814773e-06,0,0
19457,perspective,1,1.8364528545823171e-06,1,2.2780963315814773e-06,0,0
19462,policemen,1,1.8364528545823171e-06,1,2.2780963315814773e-06,0,0
19463,overruled,1,1.8364528545823171e-06,1,2.2780963315814773e-06,0,0
19465,resorts,1,1.8364528545823171e-06,1,2.2780963315814773e-06,0,0
19466,emanating,1,1.8364528545823171e-06,1,2.2780963315814773e-06,0,0
19468,non-credible,1,1.8364528545823171e-06,1,2.2780963315814773e-06,0,0
19470,tweeted,1,1.8364528545823171e-06,1,2.2780963315814773e-06,0,0
19471,@marksanford,1,1.8364528545823171e-06,1,2.2780963315814773e-06,0,0
19475,hiking,1,1.8364528545823171e-06,1,2.2780963315814773e-06,0,0
19474,flaming,1,1.8364528545823171e-06,1,2.2780963315814773e-06,0,0
19473,dancer,1,1.8364528545823171e-06,1,2.2780963315814773e-06,0,0
19478,musician,1,1.8364528545823171e-06,1,2.2780963315814773e-06,0,0
19476,anchor@lesterholtnbc,1,1.8364528545823171e-06,1,2.2780963315814773e-06,0,0
19479,@vanjones68,1,1.8364528545823171e-06,1,2.2780963315814773e-06,0,0
19480,unbeknownst,1,1.8364528545823171e-06,1,2.2780963315814773e-06,0,0
19482,defrauding,1,1.8364528545823171e-06,1,2.2780963315814773e-06,0,0
19483,bookeven,1,1.8364528545823171e-06,1,2.2780963315814773e-06,0,0
19484,forecast,1,1.8364528545823171e-06,1,2.2780963315814773e-06,0,0
19485,swapped,1,1.8364528545823171e-06,1,2.2780963315814773e-06,0,0
19486,patrolling,1,1.8364528545823171e-06,1,2.2780963315814773e-06,0,0
19488,@philiprucker,1,1.8364528545823171e-06,1,2.2780963315814773e-06,0,0
19487,@ashleyrparker,1,1.8364528545823171e-06,1,2.2780963315814773e-06,0,0
19489,160th,1,1.8364528545823171e-06,1,2.2780963315814773e-06,0,0
19492,papa,1,1.8364528545823171e-06,1,2.2780963315814773e-06,0,0
19493,hubert,1,1.8364528545823171e-06,1,2.2780963315814773e-06,0,0
19494,minnis,1,1.8364528545823171e-06,1,2.2780963315814773e-06,0,0
19495,stationary,1,1.8364528545823171e-06,1,2.2780963315814773e-06,0,0
19496,inflationfed,1,1.8364528545823171e-06,1,2.2780963315814773e-06,0,0
19498,fixated,1,1.8364528545823171e-06,1,2.2780963315814773e-06,0,0
19497,beginnings,1,1.8364528545823171e-06,1,2.2780963315814773e-06,0,0
19500,maps,1,1.8364528545823171e-06,1,2.2780963315814773e-06,0,0
19502,indicated,1,1.8364528545823171e-06,1,2.2780963315814773e-06,0,0
19503,unsigned,1,1.8364528545823171e-06,1,2.2780963315814773e-06,0,0
19504,hajec,1,1.8364528545823171e-06,1,2.2780963315814773e-06,0,0
19506,recision,1,1.8364528545823171e-06,1,2.2780963315814773e-06,0,0
19505,lawfulness,1,1.8364528545823171e-06,1,2.2780963315814773e-06,0,0
19507,joblessness,1,1.8364528545823171e-06,1,2.2780963315814773e-06,0,0
19508,830am,1,1.8364528545823171e-06,1,2.2780963315814773e-06,0,0
19509,@govkemp,1,1.8364528545823171e-06,1,2.2780963315814773e-06,0,0
19510,ominously,1,1.8364528545823171e-06,1,2.2780963315814773e-06,0,0
19511,greenblatt,1,1.8364528545823171e-06,1,2.2780963315814773e-06,0,0
19513,debra,1,1.8364528545823171e-06,1,2.2780963315814773e-06,0,0
19514,messing,1,1.8364528545823171e-06,1,2.2780963315814773e-06,0,0
19512,blacklist,1,1.8364528545823171e-06,1,2.2780963315814773e-06,0,0
19515,rad,1,1.8364528545823171e-06,1,2.2780963315814773e-06,0,0
19519,terrify,1,1.8364528545823171e-06,1,2.2780963315814773e-06,0,0
19517,stripe,1,1.8364528545823171e-06,1,2.2780963315814773e-06,0,0
19516,dastardly,1,1.8364528545823171e-06,1,2.2780963315814773e-06,0,0
19518,terrified,1,1.8364528545823171e-06,1,2.2780963315814773e-06,0,0
19520,undisputed,1,1.8364528545823171e-06,1,2.2780963315814773e-06,0,0
19522,watch8,1,1.8364528545823171e-06,1,2.2780963315814773e-06,0,0
19521,purest,1,1.8364528545823171e-06,1,2.2780963315814773e-06,0,0
19523,productionbut,1,1.8364528545823171e-06,1,2.2780963315814773e-06,0,0
19525,reductionamerica2,1,1.8364528545823171e-06,1,2.2780963315814773e-06,0,0
19524,china3,1,1.8364528545823171e-06,1,2.2780963315814773e-06,0,0
19526,#fakenewscnn,1,1.8364528545823171e-06,1,2.2780963315814773e-06,0,0
19529,@joekernencnbc,1,1.8364528545823171e-06,1,2.2780963315814773e-06,0,0
19531,rationalization,1,1.8364528545823171e-06,1,2.2780963315814773e-06,0,0
19530,inexplicably,1,1.8364528545823171e-06,1,2.2780963315814773e-06,0,0
19533,unpredictable,1,1.8364528545823171e-06,1,2.2780963315814773e-06,0,0
19535,sadique,1,1.8364528545823171e-06,1,2.2780963315814773e-06,0,0
19538,usa600,1,1.8364528545823171e-06,1,2.2780963315814773e-06,0,0
19536,byear16,1,1.8364528545823171e-06,1,2.2780963315814773e-06,0,0
19537,long-shot,1,1.8364528545823171e-06,1,2.2780963315814773e-06,0,0
19545,@jonkarl,1,1.8364528545823171e-06,1,2.2780963315814773e-06,0,0
19546,@jonathancarl,1,1.8364528545823171e-06,1,2.2780963315814773e-06,0,0
19547,riseand,1,1.8364528545823171e-06,1,2.2780963315814773e-06,0,0
19549,leisure,1,1.8364528545823171e-06,1,2.2780963315814773e-06,0,0
19548,hospitality,1,1.8364528545823171e-06,1,2.2780963315814773e-06,0,0
19550,exorbitant,1,1.8364528545823171e-06,1,2.2780963315814773e-06,0,0
19552,retrain,1,1.8364528545823171e-06,1,2.2780963315814773e-06,0,0
19553,ambro,1,1.8364528545823171e-06,1,2.2780963315814773e-06,0,0
19554,majotity,1,1.8364528545823171e-06,1,2.2780963315814773e-06,0,0
19555,channels,1,1.8364528545823171e-06,1,2.2780963315814773e-06,0,0
19557,nbcs,1,1.8364528545823171e-06,1,2.2780963315814773e-06,0,0
19556,@debramessing,1,1.8364528545823171e-06,1,2.2780963315814773e-06,0,0
19559,upfront,1,1.8364528545823171e-06,1,2.2780963315814773e-06,0,0
19558,thanked,1,1.8364528545823171e-06,1,2.2780963315814773e-06,0,0
19560,redirect,1,1.8364528545823171e-06,1,2.2780963315814773e-06,0,0
19561,discount,1,1.8364528545823171e-06,1,2.2780963315814773e-06,0,0
19564,scolded,1,1.8364528545823171e-06,1,2.2780963315814773e-06,0,0
19566,despised,1,1.8364528545823171e-06,1,2.2780963315814773e-06,0,0
19568,enforceable,1,1.8364528545823171e-06,1,2.2780963315814773e-06,0,0
19569,forgave,1,1.8364528545823171e-06,1,2.2780963315814773e-06,0,0
19570,shoe,1,1.8364528545823171e-06,1,2.2780963315814773e-06,0,0
19571,espionage,1,1.8364528545823171e-06,1,2.2780963315814773e-06,0,0
19573,@noaa,1,1.8364528545823171e-06,1,2.2780963315814773e-06,0,0
19575,@readygov,1,1.8364528545823171e-06,1,2.2780963315814773e-06,0,0
19572,@flsert,1,1.8364528545823171e-06,1,2.2780963315814773e-06,0,0
19576,641,1,1.8364528545823171e-06,1,2.2780963315814773e-06,0,0
19577,recollections,1,1.8364528545823171e-06,1,2.2780963315814773e-06,0,0
19578,fallout,1,1.8364528545823171e-06,1,2.2780963315814773e-06,0,0
19579,igs,1,1.8364528545823171e-06,1,2.2780963315814773e-06,0,0
19581,officialwhen,1,1.8364528545823171e-06,1,2.2780963315814773e-06,0,0
19582,reportthis,1,1.8364528545823171e-06,1,2.2780963315814773e-06,0,0
19583,systematic,1,1.8364528545823171e-06,1,2.2780963315814773e-06,0,0
19580,elect-trump,1,1.8364528545823171e-06,1,2.2780963315814773e-06,0,0
19584,trumpyou,1,1.8364528545823171e-06,1,2.2780963315814773e-06,0,0
19586,safir,1,1.8364528545823171e-06,1,2.2780963315814773e-06,0,0
19588,slv,1,1.8364528545823171e-06,1,2.2780963315814773e-06,0,0
19587,semnan,1,1.8364528545823171e-06,1,2.2780963315814773e-06,0,0
19585,determining,1,1.8364528545823171e-06,1,2.2780963315814773e-06,0,0
19590,smartly,1,1.8364528545823171e-06,1,2.2780963315814773e-06,0,0
19589,managementand,1,1.8364528545823171e-06,1,2.2780963315814773e-06,0,0
19591,advantageand,1,1.8364528545823171e-06,1,2.2780963315814773e-06,0,0
19595,wright,1,1.8364528545823171e-06,1,2.2780963315814773e-06,0,0
19594,officerdem,1,1.8364528545823171e-06,1,2.2780963315814773e-06,0,0
19593,kneecap,1,1.8364528545823171e-06,1,2.2780963315814773e-06,0,0
19592,@fox&fs,1,1.8364528545823171e-06,1,2.2780963315814773e-06,0,0
19597,co-signed,1,1.8364528545823171e-06,1,2.2780963315814773e-06,0,0
19598,vitally,1,1.8364528545823171e-06,1,2.2780963315814773e-06,0,0
19599,anyplace,1,1.8364528545823171e-06,1,2.2780963315814773e-06,0,0
19600,giddy,1,1.8364528545823171e-06,1,2.2780963315814773e-06,0,0
19601,@sandrasmithfox,1,1.8364528545823171e-06,1,2.2780963315814773e-06,0,0
19603,corbyn,1,1.8364528545823171e-06,1,2.2780963315814773e-06,0,0
19602,britains,1,1.8364528545823171e-06,1,2.2780963315814773e-06,0,0
19604,labour,1,1.8364528545823171e-06,1,2.2780963315814773e-06,0,0
19605,no-confidence,1,1.8364528545823171e-06,1,2.2780963315814773e-06,0,0
19606,bedbug,1,1.8364528545823171e-06,1,2.2780963315814773e-06,0,0
19610,geeeee,1,1.8364528545823171e-06,1,2.2780963315814773e-06,0,0
19611,warrens,1,1.8364528545823171e-06,1,2.2780963315814773e-06,0,0
19612,zogby,1,1.8364528545823171e-06,1,2.2780963315814773e-06,0,0
19615,giuseppi,1,1.8364528545823171e-06,1,2.2780963315814773e-06,0,0
19617,france🇺🇸🇫🇷,1,1.8364528545823171e-06,1,2.2780963315814773e-06,0,0
19622,judged,1,1.8364528545823171e-06,1,2.2780963315814773e-06,0,0
19623,emma,1,1.8364528545823171e-06,1,2.2780963315814773e-06,0,0
19624,corn,1,1.8364528545823171e-06,1,2.2780963315814773e-06,0,0
19625,tense,1,1.8364528545823171e-06,1,2.2780963315814773e-06,0,0
19627,emanuel,1,1.8364528545823171e-06,1,2.2780963315814773e-06,0,0
19630,@andrewcuomo,1,1.8364528545823171e-06,1,2.2780963315814773e-06,0,0
19633,subway,1,1.8364528545823171e-06,1,2.2780963315814773e-06,0,0
19629,125th,1,1.8364528545823171e-06,1,2.2780963315814773e-06,0,0
19631,harlem,1,1.8364528545823171e-06,1,2.2780963315814773e-06,0,0
19635,truthand,1,1.8364528545823171e-06,1,2.2780963315814773e-06,0,0
19636,jokingly,1,1.8364528545823171e-06,1,2.2780963315814773e-06,0,0
19637,1977,1,1.8364528545823171e-06,1,2.2780963315814773e-06,0,0
19638,fifties,1,1.8364528545823171e-06,1,2.2780963315814773e-06,0,0
19640,marriott,1,1.8364528545823171e-06,1,2.2780963315814773e-06,0,0
19639,marquis,1,1.8364528545823171e-06,1,2.2780963315814773e-06,0,0
19641,rainforest,1,1.8364528545823171e-06,1,2.2780963315814773e-06,0,0
19642,573,1,1.8364528545823171e-06,1,2.2780963315814773e-06,0,0
19643,moulton,1,1.8364528545823171e-06,1,2.2780963315814773e-06,0,0
19644,carriers,1,1.8364528545823171e-06,1,2.2780963315814773e-06,0,0
19645,ex,1,1.8364528545823171e-06,1,2.2780963315814773e-06,0,0
19646,powel,1,1.8364528545823171e-06,1,2.2780963315814773e-06,0,0
19647,cousy,1,1.8364528545823171e-06,1,2.2780963315814773e-06,0,0
19648,trump-and,1,1.8364528545823171e-06,1,2.2780963315814773e-06,0,0
19651,yields,1,1.8364528545823171e-06,1,2.2780963315814773e-06,0,0
19650,competes,1,1.8364528545823171e-06,1,2.2780963315814773e-06,0,0
19652,@realwayneroot,1,1.8364528545823171e-06,1,2.2780963315814773e-06,0,0
19655,facilitating,1,1.8364528545823171e-06,1,2.2780963315814773e-06,0,0
19654,cancellation,1,1.8364528545823171e-06,1,2.2780963315814773e-06,0,0
19653,25k,1,1.8364528545823171e-06,1,2.2780963315814773e-06,0,0
19656,descendants,1,1.8364528545823171e-06,1,2.2780963315814773e-06,0,0
19657,regulators,1,1.8364528545823171e-06,1,2.2780963315814773e-06,0,0
19658,sloan,1,1.8364528545823171e-06,1,2.2780963315814773e-06,0,0
19660,@amvetshq,1,1.8364528545823171e-06,1,2.2780963315814773e-06,0,0
19659,#amvets75th,1,1.8364528545823171e-06,1,2.2780963315814773e-06,0,0
19661,@charlespayne2nd,1,1.8364528545823171e-06,1,2.2780963315814773e-06,0,0
19663,entries,1,1.8364528545823171e-06,1,2.2780963315814773e-06,0,0
19664,godbut,1,1.8364528545823171e-06,1,2.2780963315814773e-06,0,0
19665,allyn,1,1.8364528545823171e-06,1,2.2780963315814773e-06,0,0
19666,worldand,1,1.8364528545823171e-06,1,2.2780963315814773e-06,0,0
19669,mette,1,1.8364528545823171e-06,1,2.2780963315814773e-06,0,0
19667,frederiksens,1,1.8364528545823171e-06,1,2.2780963315814773e-06,0,0
19670,postponing,1,1.8364528545823171e-06,1,2.2780963315814773e-06,0,0
19674,treading,1,1.8364528545823171e-06,1,2.2780963315814773e-06,0,0
19675,@iowastatefair,1,1.8364528545823171e-06,1,2.2780963315814773e-06,0,0
19676,us-uk,1,1.8364528545823171e-06,1,2.2780963315814773e-06,0,0
19677,kashmir,1,1.8364528545823171e-06,1,2.2780963315814773e-06,0,0
19679,snhu,1,1.8364528545823171e-06,1,2.2780963315814773e-06,0,0
19680,enhanced-good,1,1.8364528545823171e-06,1,2.2780963315814773e-06,0,0
19684,cohesion,1,1.8364528545823171e-06,1,2.2780963315814773e-06,0,0
19685,shellaced,1,1.8364528545823171e-06,1,2.2780963315814773e-06,0,0
19687,jokebut,1,1.8364528545823171e-06,1,2.2780963315814773e-06,0,0
19686,#crookedjournalism,1,1.8364528545823171e-06,1,2.2780963315814773e-06,0,0
19688,portrayals,1,1.8364528545823171e-06,1,2.2780963315814773e-06,0,0
19689,ramblinghalf-empty,1,1.8364528545823171e-06,1,2.2780963315814773e-06,0,0
19690,@cleared37joseph,1,1.8364528545823171e-06,1,2.2780963315814773e-06,0,0
19693,🇺🇸&🌍peace,1,1.8364528545823171e-06,1,2.2780963315814773e-06,0,0
19692,we🇺🇸45th,1,1.8364528545823171e-06,1,2.2780963315814773e-06,0,0
19694,🇺🇸@potus,1,1.8364528545823171e-06,1,2.2780963315814773e-06,0,0
19691,saf,1,1.8364528545823171e-06,1,2.2780963315814773e-06,0,0
19695,@fullmeasurenews,1,1.8364528545823171e-06,1,2.2780963315814773e-06,0,0
19697,heightened,1,1.8364528545823171e-06,1,2.2780963315814773e-06,0,0
19696,ele,1,1.8364528545823171e-06,1,2.2780963315814773e-06,0,0
19698,deplorablein,1,1.8364528545823171e-06,1,2.2780963315814773e-06,0,0
19700,russiansin,1,1.8364528545823171e-06,1,2.2780963315814773e-06,0,0
19699,nazisin,1,1.8364528545823171e-06,1,2.2780963315814773e-06,0,0
19701,trum,1,1.8364528545823171e-06,1,2.2780963315814773e-06,0,0
19702,@jtp236,1,1.8364528545823171e-06,1,2.2780963315814773e-06,0,0
19703,beatles,1,1.8364528545823171e-06,1,2.2780963315814773e-06,0,0
19704,@newschug,1,1.8364528545823171e-06,1,2.2780963315814773e-06,0,0
19705,@narrowp,1,1.8364528545823171e-06,1,2.2780963315814773e-06,0,0
19708,fuming,1,1.8364528545823171e-06,1,2.2780963315814773e-06,0,0
19710,obnoxiously,1,1.8364528545823171e-06,1,2.2780963315814773e-06,0,0
19713,rashida,1,1.8364528545823171e-06,1,2.2780963315814773e-06,0,0
19711,grandstanded,1,1.8364528545823171e-06,1,2.2780963315814773e-06,0,0
19712,proclaimed,1,1.8364528545823171e-06,1,2.2780963315814773e-06,0,0
19714,yoes,1,1.8364528545823171e-06,1,2.2780963315814773e-06,0,0
19715,canterbury,1,1.8364528545823171e-06,1,2.2780963315814773e-06,0,0
19717,elton,1,1.8364528545823171e-06,1,2.2780963315814773e-06,0,0
19716,#snhuarena,1,1.8364528545823171e-06,1,2.2780963315814773e-06,0,0
19718,disinvestment,1,1.8364528545823171e-06,1,2.2780963315814773e-06,0,0
19719,@jaysekulow,1,1.8364528545823171e-06,1,2.2780963315814773e-06,0,0
19720,falter,1,1.8364528545823171e-06,1,2.2780963315814773e-06,0,0
19721,enlightened,1,1.8364528545823171e-06,1,2.2780963315814773e-06,0,0
19722,reptlaib,1,1.8364528545823171e-06,1,2.2780963315814773e-06,0,0
19723,speculate,1,1.8364528545823171e-06,1,2.2780963315814773e-06,0,0
19724,envelope,1,1.8364528545823171e-06,1,2.2780963315814773e-06,0,0
19726,entertainers,1,1.8364528545823171e-06,1,2.2780963315814773e-06,0,0
19728,deferral,1,1.8364528545823171e-06,1,2.2780963315814773e-06,0,0
19730,reciprocated,1,1.8364528545823171e-06,1,2.2780963315814773e-06,0,0
19731,inverted,1,1.8364528545823171e-06,1,2.2780963315814773e-06,0,0
19732,reaping,1,1.8364528545823171e-06,1,2.2780963315814773e-06,0,0
19733,mid,1,1.8364528545823171e-06,1,2.2780963315814773e-06,0,0
19734,economy&,1,1.8364528545823171e-06,1,2.2780963315814773e-06,0,0
19735,vitiello,1,1.8364528545823171e-06,1,2.2780963315814773e-06,0,0
19738,@dualtech,1,1.8364528545823171e-06,1,2.2780963315814773e-06,0,0
19736,#voterfraud,1,1.8364528545823171e-06,1,2.2780963315814773e-06,0,0
19737,#voterid,1,1.8364528545823171e-06,1,2.2780963315814773e-06,0,0
19739,uninterested,1,1.8364528545823171e-06,1,2.2780963315814773e-06,0,0
19740,cursing,1,1.8364528545823171e-06,1,2.2780963315814773e-06,0,0
19742,@surabees,1,1.8364528545823171e-06,1,2.2780963315814773e-06,0,0
19741,@chriscuomo,1,1.8364528545823171e-06,1,2.2780963315814773e-06,0,0
19745,skyfall,1,1.8364528545823171e-06,1,2.2780963315814773e-06,0,0
19747,gaffe-filled,1,1.8364528545823171e-06,1,2.2780963315814773e-06,0,0
19748,negop,1,1.8364528545823171e-06,1,2.2780963315814773e-06,0,0
19751,humiliation,1,1.8364528545823171e-06,1,2.2780963315814773e-06,0,0
19749,ambition,1,1.8364528545823171e-06,1,2.2780963315814773e-06,0,0
19755,deutsch,1,1.8364528545823171e-06,1,2.2780963315814773e-06,0,0
19754,bug,1,1.8364528545823171e-06,1,2.2780963315814773e-06,0,0
19756,@breakingnlive,1,1.8364528545823171e-06,1,2.2780963315814773e-06,0,0
19757,unsealed,1,1.8364528545823171e-06,1,2.2780963315814773e-06,0,0
19758,thatand,1,1.8364528545823171e-06,1,2.2780963315814773e-06,0,0
19759,mahers,1,1.8364528545823171e-06,1,2.2780963315814773e-06,0,0
19761,ussouth,1,1.8364528545823171e-06,1,2.2780963315814773e-06,0,0
19762,annoyed,1,1.8364528545823171e-06,1,2.2780963315814773e-06,0,0
19764,racists,1,1.8364528545823171e-06,1,2.2780963315814773e-06,0,0
19765,revises,1,1.8364528545823171e-06,1,2.2780963315814773e-06,0,0
19767,@nytwhy,1,1.8364528545823171e-06,1,2.2780963315814773e-06,0,0
19768,nyt,1,1.8364528545823171e-06,1,2.2780963315814773e-06,0,0
19766,#soundcloud,1,1.8364528545823171e-06,1,2.2780963315814773e-06,0,0
19769,commuting,1,1.8364528545823171e-06,1,2.2780963315814773e-06,0,0
19770,commanded,1,1.8364528545823171e-06,1,2.2780963315814773e-06,0,0
19772,coincides,1,1.8364528545823171e-06,1,2.2780963315814773e-06,0,0
19774,deere,1,1.8364528545823171e-06,1,2.2780963315814773e-06,0,0
19775,caterpillar,1,1.8364528545823171e-06,1,2.2780963315814773e-06,0,0
19777,depress,1,1.8364528545823171e-06,1,2.2780963315814773e-06,0,0
19782,misrepresenting,1,1.8364528545823171e-06,1,2.2780963315814773e-06,0,0
19783,resemblance,1,1.8364528545823171e-06,1,2.2780963315814773e-06,0,0
19781,amazingo,1,1.8364528545823171e-06,1,2.2780963315814773e-06,0,0
19784,sherrod,1,1.8364528545823171e-06,1,2.2780963315814773e-06,0,0
19785,whaley,1,1.8364528545823171e-06,1,2.2780963315814773e-06,0,0
19786,clicks,1,1.8364528545823171e-06,1,2.2780963315814773e-06,0,0
19788,samurai,1,1.8364528545823171e-06,1,2.2780963315814773e-06,0,0
19787,merkels,1,1.8364528545823171e-06,1,2.2780963315814773e-06,0,0
19789,assailing,1,1.8364528545823171e-06,1,2.2780963315814773e-06,0,0
19790,990000000,1,1.8364528545823171e-06,1,2.2780963315814773e-06,0,0
19795,@kevinolearytv,1,1.8364528545823171e-06,1,2.2780963315814773e-06,0,0
19796,ttump,1,1.8364528545823171e-06,1,2.2780963315814773e-06,0,0
19800,marrying,1,1.8364528545823171e-06,1,2.2780963315814773e-06,0,0
19801,@usatoday,1,1.8364528545823171e-06,1,2.2780963315814773e-06,0,0
19802,colby,1,1.8364528545823171e-06,1,2.2780963315814773e-06,0,0
19803,elpaso,1,1.8364528545823171e-06,1,2.2780963315814773e-06,0,0
19804,devaluations,1,1.8364528545823171e-06,1,2.2780963315814773e-06,0,0
19806,nipple-height,1,1.8364528545823171e-06,1,2.2780963315814773e-06,0,0
19805,londonistan,1,1.8364528545823171e-06,1,2.2780963315814773e-06,0,0
19807,stab-city,1,1.8364528545823171e-06,1,2.2780963315814773e-06,0,0
19808,pupils,1,1.8364528545823171e-06,1,2.2780963315814773e-06,0,0
19811,chariman,1,1.8364528545823171e-06,1,2.2780963315814773e-06,0,0
19812,uns,1,1.8364528545823171e-06,1,2.2780963315814773e-06,0,0
19813,shook,1,1.8364528545823171e-06,1,2.2780963315814773e-06,0,0
19815,@americanewsroom,1,1.8364528545823171e-06,1,2.2780963315814773e-06,0,0
19816,#kentucky,1,1.8364528545823171e-06,1,2.2780963315814773e-06,0,0
19817,admirably,1,1.8364528545823171e-06,1,2.2780963315814773e-06,0,0
19818,bullard,1,1.8364528545823171e-06,1,2.2780963315814773e-06,0,0
19819,drug-infested,1,1.8364528545823171e-06,1,2.2780963315814773e-06,0,0
19820,rate-cutting,1,1.8364528545823171e-06,1,2.2780963315814773e-06,0,0
19823,msnbcs,1,1.8364528545823171e-06,1,2.2780963315814773e-06,0,0
19824,insinuated,1,1.8364528545823171e-06,1,2.2780963315814773e-06,0,0
19825,neutral,1,1.8364528545823171e-06,1,2.2780963315814773e-06,0,0
19826,@govofco,1,1.8364528545823171e-06,1,2.2780963315814773e-06,0,0
19827,recessiondepression,1,1.8364528545823171e-06,1,2.2780963315814773e-06,0,0
19828,sinkhole,1,1.8364528545823171e-06,1,2.2780963315814773e-06,0,0
19829,wikileaks,1,1.8364528545823171e-06,1,2.2780963315814773e-06,0,0
19830,@lynntho06607841,1,1.8364528545823171e-06,1,2.2780963315814773e-06,0,0
19832,🤨,1,1.8364528545823171e-06,1,2.2780963315814773e-06,0,0
19831,strongl,1,1.8364528545823171e-06,1,2.2780963315814773e-06,0,0
19833,@voteridplease,1,1.8364528545823171e-06,1,2.2780963315814773e-06,0,0
19834,sanctity,1,1.8364528545823171e-06,1,2.2780963315814773e-06,0,0
19836,uncomfortable,1,1.8364528545823171e-06,1,2.2780963315814773e-06,0,0
19837,preside,1,1.8364528545823171e-06,1,2.2780963315814773e-06,0,0
19838,truedoes,1,1.8364528545823171e-06,1,2.2780963315814773e-06,0,0
19839,juice,1,1.8364528545823171e-06,1,2.2780963315814773e-06,0,0
19840,nowor,1,1.8364528545823171e-06,1,2.2780963315814773e-06,0,0
19841,stiffs,1,1.8364528545823171e-06,1,2.2780963315814773e-06,0,0
19842,assumed,1,1.8364528545823171e-06,1,2.2780963315814773e-06,0,0
19843,lawsthey,1,1.8364528545823171e-06,1,2.2780963315814773e-06,0,0
19846,somali,1,1.8364528545823171e-06,1,2.2780963315814773e-06,0,0
19844,arresed,1,1.8364528545823171e-06,1,2.2780963315814773e-06,0,0
19845,posing,1,1.8364528545823171e-06,1,2.2780963315814773e-06,0,0
19847,baltimores,1,1.8364528545823171e-06,1,2.2780963315814773e-06,0,0
19848,pumped,1,1.8364528545823171e-06,1,2.2780963315814773e-06,0,0
19849,congresses,1,1.8364528545823171e-06,1,2.2780963315814773e-06,0,0
19850,@djaycameron,1,1.8364528545823171e-06,1,2.2780963315814773e-06,0,0
19851,formedand,1,1.8364528545823171e-06,1,2.2780963315814773e-06,0,0
19852,pickens,1,1.8364528545823171e-06,1,2.2780963315814773e-06,0,0
19853,measured,1,1.8364528545823171e-06,1,2.2780963315814773e-06,0,0
19854,equated,1,1.8364528545823171e-06,1,2.2780963315814773e-06,0,0
19855,sharpton,1,1.8364528545823171e-06,1,2.2780963315814773e-06,0,0
19856,tt,1,1.8364528545823171e-06,1,2.2780963315814773e-06,0,0
19857,elijahs,1,1.8364528545823171e-06,1,2.2780963315814773e-06,0,0
19858,bullnext,1,1.8364528545823171e-06,1,2.2780963315814773e-06,0,0
19859,favors,1,1.8364528545823171e-06,1,2.2780963315814773e-06,0,0
19860,troublemaker,1,1.8364528545823171e-06,1,2.2780963315814773e-06,0,0
19861,gilroy,1,1.8364528545823171e-06,1,2.2780963315814773e-06,0,0
19864,homicide,1,1.8364528545823171e-06,1,2.2780963315814773e-06,0,0
19863,@baltimorepolice,1,1.8364528545823171e-06,1,2.2780963315814773e-06,0,0
19865,stre,1,1.8364528545823171e-06,1,2.2780963315814773e-06,0,0
19866,recognizeable,1,1.8364528545823171e-06,1,2.2780963315814773e-06,0,0
19867,trade@jessebwatters,1,1.8364528545823171e-06,1,2.2780963315814773e-06,0,0
19868,steeleand,1,1.8364528545823171e-06,1,2.2780963315814773e-06,0,0
19871,misty,1,1.8364528545823171e-06,1,2.2780963315814773e-06,0,0
19870,marris,1,1.8364528545823171e-06,1,2.2780963315814773e-06,0,0
19872,#blacksfortrump2020,1,1.8364528545823171e-06,1,2.2780963315814773e-06,0,0
19873,crimecrimecrime,1,1.8364528545823171e-06,1,2.2780963315814773e-06,0,0
19876,irrevocably,1,1.8364528545823171e-06,1,2.2780963315814773e-06,0,0
19875,halls,1,1.8364528545823171e-06,1,2.2780963315814773e-06,0,0
19877,non-fighters,1,1.8364528545823171e-06,1,2.2780963315814773e-06,0,0
19878,cumming,1,1.8364528545823171e-06,1,2.2780963315814773e-06,0,0
19879,rodent,1,1.8364528545823171e-06,1,2.2780963315814773e-06,0,0
19880,bully,1,1.8364528545823171e-06,1,2.2780963315814773e-06,0,0
19882,overturns,1,1.8364528545823171e-06,1,2.2780963315814773e-06,0,0
19881,injunction,1,1.8364528545823171e-06,1,2.2780963315814773e-06,0,0
19883,@dhsmcaleenan,1,1.8364528545823171e-06,1,2.2780963315814773e-06,0,0
19884,guatemalan,1,1.8364528545823171e-06,1,2.2780963315814773e-06,0,0
19885,@chrisplanteshow,1,1.8364528545823171e-06,1,2.2780963315814773e-06,0,0
19886,macrons,1,1.8364528545823171e-06,1,2.2780963315814773e-06,0,0
19888,q2,1,1.8364528545823171e-06,1,2.2780963315814773e-06,0,0
19887,neck,1,1.8364528545823171e-06,1,2.2780963315814773e-06,0,0
19889,wavers,1,1.8364528545823171e-06,1,2.2780963315814773e-06,0,0
19890,sincerely,1,1.8364528545823171e-06,1,2.2780963315814773e-06,0,0
19892,gianno,1,1.8364528545823171e-06,1,2.2780963315814773e-06,0,0
19893,284-149,1,1.8364528545823171e-06,1,2.2780963315814773e-06,0,0
19898,rooted,1,1.8364528545823171e-06,1,2.2780963315814773e-06,0,0
19901,over@terrymoran,1,1.8364528545823171e-06,1,2.2780963315814773e-06,0,0
19900,@abcpolitics,1,1.8364528545823171e-06,1,2.2780963315814773e-06,0,0
19902,nature,1,1.8364528545823171e-06,1,2.2780963315814773e-06,0,0
19903,#shiftyschiff,1,1.8364528545823171e-06,1,2.2780963315814773e-06,0,0
19904,pinning,1,1.8364528545823171e-06,1,2.2780963315814773e-06,0,0
19906,reclaiming,1,1.8364528545823171e-06,1,2.2780963315814773e-06,0,0
19907,pill,1,1.8364528545823171e-06,1,2.2780963315814773e-06,0,0
19908,athletic,1,1.8364528545823171e-06,1,2.2780963315814773e-06,0,0
19910,remittance,1,1.8364528545823171e-06,1,2.2780963315814773e-06,0,0
19911,dilapidated,1,1.8364528545823171e-06,1,2.2780963315814773e-06,0,0
19913,inexperienced,1,1.8364528545823171e-06,1,2.2780963315814773e-06,0,0
19912,borderand,1,1.8364528545823171e-06,1,2.2780963315814773e-06,0,0
19914,themthis,1,1.8364528545823171e-06,1,2.2780963315814773e-06,0,0
19916,manipulate,1,1.8364528545823171e-06,1,2.2780963315814773e-06,0,0
19918,needlessly,1,1.8364528545823171e-06,1,2.2780963315814773e-06,0,0
19917,misguided,1,1.8364528545823171e-06,1,2.2780963315814773e-06,0,0
19919,wildly,1,1.8364528545823171e-06,1,2.2780963315814773e-06,0,0
19921,mendoza,1,1.8364528545823171e-06,1,2.2780963315814773e-06,0,0
19922,@swedishpm,1,1.8364528545823171e-06,1,2.2780963315814773e-06,0,0
19923,vouch,1,1.8364528545823171e-06,1,2.2780963315814773e-06,0,0
19924,leavetrump,1,1.8364528545823171e-06,1,2.2780963315814773e-06,0,0
19925,binary,1,1.8364528545823171e-06,1,2.2780963315814773e-06,0,0
19926,@kanyewest,1,1.8364528545823171e-06,1,2.2780963315814773e-06,0,0
19927,rockys,1,1.8364528545823171e-06,1,2.2780963315814773e-06,0,0
19929,chin,1,1.8364528545823171e-06,1,2.2780963315814773e-06,0,0
19932,carrie,1,1.8364528545823171e-06,1,2.2780963315814773e-06,0,0
19933,severino,1,1.8364528545823171e-06,1,2.2780963315814773e-06,0,0
19935,scalia,1,1.8364528545823171e-06,1,2.2780963315814773e-06,0,0
19939,@worldgamesad,1,1.8364528545823171e-06,1,2.2780963315814773e-06,0,0
19938,@specialolyusa,1,1.8364528545823171e-06,1,2.2780963315814773e-06,0,0
19936,#cheer4usa,1,1.8364528545823171e-06,1,2.2780963315814773e-06,0,0
19942,apprise,1,1.8364528545823171e-06,1,2.2780963315814773e-06,0,0
19945,strait,1,1.8364528545823171e-06,1,2.2780963315814773e-06,0,0
19944,hormuz,1,1.8364528545823171e-06,1,2.2780963315814773e-06,0,0
19940,#ussboxer,1,1.8364528545823171e-06,1,2.2780963315814773e-06,0,0
19941,amphibious,1,1.8364528545823171e-06,1,2.2780963315814773e-06,0,0
19943,boxer,1,1.8364528545823171e-06,1,2.2780963315814773e-06,0,0
19946,boomerang,1,1.8364528545823171e-06,1,2.2780963315814773e-06,0,0
19950,circumstance,1,1.8364528545823171e-06,1,2.2780963315814773e-06,0,0
19951,indictedand,1,1.8364528545823171e-06,1,2.2780963315814773e-06,0,0
19952,@jjmyriteload,1,1.8364528545823171e-06,1,2.2780963315814773e-06,0,0
19954,332-95-1,1,1.8364528545823171e-06,1,2.2780963315814773e-06,0,0
19957,mastermind,1,1.8364528545823171e-06,1,2.2780963315814773e-06,0,0
19956,exerted,1,1.8364528545823171e-06,1,2.2780963315814773e-06,0,0
19959,horsewomen,1,1.8364528545823171e-06,1,2.2780963315814773e-06,0,0
19958,apocalypse,1,1.8364528545823171e-06,1,2.2780963315814773e-06,0,0
19961,cranks,1,1.8364528545823171e-06,1,2.2780963315814773e-06,0,0
19962,shampoo,1,1.8364528545823171e-06,1,2.2780963315814773e-06,0,0
19960,bottle,1,1.8364528545823171e-06,1,2.2780963315814773e-06,0,0
19964,bitterness,1,1.8364528545823171e-06,1,2.2780963315814773e-06,0,0
19963,187-4,1,1.8364528545823171e-06,1,2.2780963315814773e-06,0,0
19967,bone,1,1.8364528545823171e-06,1,2.2780963315814773e-06,0,0
19968,jasons,1,1.8364528545823171e-06,1,2.2780963315814773e-06,0,0
19969,thiel,1,1.8364528545823171e-06,1,2.2780963315814773e-06,0,0
19970,fword,1,1.8364528545823171e-06,1,2.2780963315814773e-06,0,0
19971,pro-terrorist,1,1.8364528545823171e-06,1,2.2780963315814773e-06,0,0
19972,progressives,1,1.8364528545823171e-06,1,2.2780963315814773e-06,0,0
19975,al-qaeda,1,1.8364528545823171e-06,1,2.2780963315814773e-06,0,0
19976,criminalization,1,1.8364528545823171e-06,1,2.2780963315814773e-06,0,0
19977,anti-america,1,1.8364528545823171e-06,1,2.2780963315814773e-06,0,0
19978,accuse,1,1.8364528545823171e-06,1,2.2780963315814773e-06,0,0
19979,benjamins,1,1.8364528545823171e-06,1,2.2780963315814773e-06,0,0
19981,spewed,1,1.8364528545823171e-06,1,2.2780963315814773e-06,0,0
19982,unrepresentative,1,1.8364528545823171e-06,1,2.2780963315814773e-06,0,0
19983,antiquated,1,1.8364528545823171e-06,1,2.2780963315814773e-06,0,0
19985,unbridled,1,1.8364528545823171e-06,1,2.2780963315814773e-06,0,0
19984,adversaries,1,1.8364528545823171e-06,1,2.2780963315814773e-06,0,0
19986,@blondenevadan,1,1.8364528545823171e-06,1,2.2780963315814773e-06,0,0
19988,bulb,1,1.8364528545823171e-06,1,2.2780963315814773e-06,0,0
19987,brandons,1,1.8364528545823171e-06,1,2.2780963315814773e-06,0,0
19989,@bamilan6,1,1.8364528545823171e-06,1,2.2780963315814773e-06,0,0
19990,frm,1,1.8364528545823171e-06,1,2.2780963315814773e-06,0,0
19991,zimbabwe,1,1.8364528545823171e-06,1,2.2780963315814773e-06,0,0
19993,pauls,1,1.8364528545823171e-06,1,2.2780963315814773e-06,0,0
19994,@duffy4wisconsin,1,1.8364528545823171e-06,1,2.2780963315814773e-06,0,0
19995,hagerty,1,1.8364528545823171e-06,1,2.2780963315814773e-06,0,0
19996,victoy,1,1.8364528545823171e-06,1,2.2780963315814773e-06,0,0
19998,derco,1,1.8364528545823171e-06,1,2.2780963315814773e-06,0,0
20001,tabas,1,1.8364528545823171e-06,1,2.2780963315814773e-06,0,0
20000,bernadette,1,1.8364528545823171e-06,1,2.2780963315814773e-06,0,0
19999,@pagop,1,1.8364528545823171e-06,1,2.2780963315814773e-06,0,0
20002,pizzella,1,1.8364528545823171e-06,1,2.2780963315814773e-06,0,0
20003,drumbeat,1,1.8364528545823171e-06,1,2.2780963315814773e-06,0,0
20004,graciously,1,1.8364528545823171e-06,1,2.2780963315814773e-06,0,0
20005,tendered,1,1.8364528545823171e-06,1,2.2780963315814773e-06,0,0
20009,@sebgorka,1,1.8364528545823171e-06,1,2.2780963315814773e-06,0,0
20011,jessie,1,1.8364528545823171e-06,1,2.2780963315814773e-06,0,0
20012,lurch,1,1.8364528545823171e-06,1,2.2780963315814773e-06,0,0
20013,seizure,1,1.8364528545823171e-06,1,2.2780963315814773e-06,0,0
20015,censors,1,1.8364528545823171e-06,1,2.2780963315814773e-06,0,0
20016,dependable,1,1.8364528545823171e-06,1,2.2780963315814773e-06,0,0
20020,similarly,1,1.8364528545823171e-06,1,2.2780963315814773e-06,0,0
20019,libras,1,1.8364528545823171e-06,1,2.2780963315814773e-06,0,0
20018,dependability,1,1.8364528545823171e-06,1,2.2780963315814773e-06,0,0
20021,bitcoin,1,1.8364528545823171e-06,1,2.2780963315814773e-06,0,0
20023,cryptocurrencies,1,1.8364528545823171e-06,1,2.2780963315814773e-06,0,0
20025,volatile,1,1.8364528545823171e-06,1,2.2780963315814773e-06,0,0
20024,unregulated,1,1.8364528545823171e-06,1,2.2780963315814773e-06,0,0
20022,crypto,1,1.8364528545823171e-06,1,2.2780963315814773e-06,0,0
20026,explore,1,1.8364528545823171e-06,1,2.2780963315814773e-06,0,0
20027,11024th,1,1.8364528545823171e-06,1,2.2780963315814773e-06,0,0
20030,brits,1,1.8364528545823171e-06,1,2.2780963315814773e-06,0,0
20031,germans,1,1.8364528545823171e-06,1,2.2780963315814773e-06,0,0
20034,inhumane,1,1.8364528545823171e-06,1,2.2780963315814773e-06,0,0
20036,maligned,1,1.8364528545823171e-06,1,2.2780963315814773e-06,0,0
20035,deutsche,1,1.8364528545823171e-06,1,2.2780963315814773e-06,0,0
20037,prestigious,1,1.8364528545823171e-06,1,2.2780963315814773e-06,0,0
20039,minorities,1,1.8364528545823171e-06,1,2.2780963315814773e-06,0,0
20038,hovered,1,1.8364528545823171e-06,1,2.2780963315814773e-06,0,0
20040,disloyalty,1,1.8364528545823171e-06,1,2.2780963315814773e-06,0,0
20041,100024th,1,1.8364528545823171e-06,1,2.2780963315814773e-06,0,0
20042,@alfredeneuman99,1,1.8364528545823171e-06,1,2.2780963315814773e-06,0,0
20044,god-willing,1,1.8364528545823171e-06,1,2.2780963315814773e-06,0,0
20045,jihadi-failing,1,1.8364528545823171e-06,1,2.2780963315814773e-06,0,0
20043,10netanyahu,1,1.8364528545823171e-06,1,2.2780963315814773e-06,0,0
20048,humming,1,1.8364528545823171e-06,1,2.2780963315814773e-06,0,0
20050,@drgregmurphy1,1,1.8364528545823171e-06,1,2.2780963315814773e-06,0,0
20051,#usmcanow,1,1.8364528545823171e-06,1,2.2780963315814773e-06,0,0
20053,induced,1,1.8364528545823171e-06,1,2.2780963315814773e-06,0,0
20054,hydromatic,1,1.8364528545823171e-06,1,2.2780963315814773e-06,0,0
20055,flagged,1,1.8364528545823171e-06,1,2.2780963315814773e-06,0,0
20057,@tamimbinhamad,1,1.8364528545823171e-06,1,2.2780963315814773e-06,0,0
20060,estuaries,1,1.8364528545823171e-06,1,2.2780963315814773e-06,0,0
20061,hrobak,1,1.8364528545823171e-06,1,2.2780963315814773e-06,0,0
20062,doocy,1,1.8364528545823171e-06,1,2.2780963315814773e-06,0,0
20063,strongerthank,1,1.8364528545823171e-06,1,2.2780963315814773e-06,0,0
20064,way-was,1,1.8364528545823171e-06,1,2.2780963315814773e-06,0,0
20065,foisted,1,1.8364528545823171e-06,1,2.2780963315814773e-06,0,0
20066,earthquakes,1,1.8364528545823171e-06,1,2.2780963315814773e-06,0,0
20068,nbcmsnbc,1,1.8364528545823171e-06,1,2.2780963315814773e-06,0,0
20069,slim,1,1.8364528545823171e-06,1,2.2780963315814773e-06,0,0
20070,segregationists,1,1.8364528545823171e-06,1,2.2780963315814773e-06,0,0
20071,reclamation,1,1.8364528545823171e-06,1,2.2780963315814773e-06,0,0
20072,salvageable,1,1.8364528545823171e-06,1,2.2780963315814773e-06,0,0
20073,cline,1,1.8364528545823171e-06,1,2.2780963315814773e-06,0,0
20074,kameron,1,1.8364528545823171e-06,1,2.2780963315814773e-06,0,0
20075,157005000,1,1.8364528545823171e-06,1,2.2780963315814773e-06,0,0
20077,#july4th,1,1.8364528545823171e-06,1,2.2780963315814773e-06,0,0
20078,bands,1,1.8364528545823171e-06,1,2.2780963315814773e-06,0,0
20083,104th,1,1.8364528545823171e-06,1,2.2780963315814773e-06,0,0
20084,bitten,1,1.8364528545823171e-06,1,2.2780963315814773e-06,0,0
20086,refitted,1,1.8364528545823171e-06,1,2.2780963315814773e-06,0,0
20085,detentions,1,1.8364528545823171e-06,1,2.2780963315814773e-06,0,0
20087,aghast,1,1.8364528545823171e-06,1,2.2780963315814773e-06,0,0
20088,andrea,1,1.8364528545823171e-06,1,2.2780963315814773e-06,0,0
20089,tanks,1,1.8364528545823171e-06,1,2.2780963315814773e-06,0,0
20090,dummies,1,1.8364528545823171e-06,1,2.2780963315814773e-06,0,0
20091,breached,1,1.8364528545823171e-06,1,2.2780963315814773e-06,0,0
20092,thursdays,1,1.8364528545823171e-06,1,2.2780963315814773e-06,0,0
20099,waller,1,1.8364528545823171e-06,1,2.2780963315814773e-06,0,0
20101,phantom,1,1.8364528545823171e-06,1,2.2780963315814773e-06,0,0
20102,zoldan,1,1.8364528545823171e-06,1,2.2780963315814773e-06,0,0
20104,modulated,1,1.8364528545823171e-06,1,2.2780963315814773e-06,0,0
20106,conspicuously,1,1.8364528545823171e-06,1,2.2780963315814773e-06,0,0
20108,indemnify,1,1.8364528545823171e-06,1,2.2780963315814773e-06,0,0
20109,persistent,1,1.8364528545823171e-06,1,2.2780963315814773e-06,0,0
20110,@mercedesschlapp,1,1.8364528545823171e-06,1,2.2780963315814773e-06,0,0
20111,mercedes,1,1.8364528545823171e-06,1,2.2780963315814773e-06,0,0
20112,harassing,1,1.8364528545823171e-06,1,2.2780963315814773e-06,0,0
20113,bludgeoning,1,1.8364528545823171e-06,1,2.2780963315814773e-06,0,0
20114,kazianis,1,1.8364528545823171e-06,1,2.2780963315814773e-06,0,0
20115,patience-they,1,1.8364528545823171e-06,1,2.2780963315814773e-06,0,0
20122,borderdmz,1,1.8364528545823171e-06,1,2.2780963315814773e-06,0,0
20123,credited,1,1.8364528545823171e-06,1,2.2780963315814773e-06,0,0
20124,today🇺🇸🇨🇦,1,1.8364528545823171e-06,1,2.2780963315814773e-06,0,0
20125,unprofessional,1,1.8364528545823171e-06,1,2.2780963315814773e-06,0,0
20126,depict,1,1.8364528545823171e-06,1,2.2780963315814773e-06,0,0
20127,#demdebate,1,1.8364528545823171e-06,1,2.2780963315814773e-06,0,0
20130,@teamtrump,1,1.8364528545823171e-06,1,2.2780963315814773e-06,0,0
20132,@trumpwarroom,1,1.8364528545823171e-06,1,2.2780963315814773e-06,0,0
20131,@timmurtaugh,1,1.8364528545823171e-06,1,2.2780963315814773e-06,0,0
20128,@marclotter,1,1.8364528545823171e-06,1,2.2780963315814773e-06,0,0
20133,84-8,1,1.8364528545823171e-06,1,2.2780963315814773e-06,0,0
20134,dax,1,1.8364528545823171e-06,1,2.2780963315814773e-06,0,0
20137,#g20,1,1.8364528545823171e-06,1,2.2780963315814773e-06,0,0
20140,#rtm2019,1,1.8364528545823171e-06,1,2.2780963315814773e-06,0,0
20142,@mpinoe,1,1.8364528545823171e-06,1,2.2780963315814773e-06,0,0
20144,@meganrapino,1,1.8364528545823171e-06,1,2.2780963315814773e-06,0,0
20145,815,1,1.8364528545823171e-06,1,2.2780963315814773e-06,0,0
20146,#breaking,1,1.8364528545823171e-06,1,2.2780963315814773e-06,0,0
20149,sandersstephanie,1,1.8364528545823171e-06,1,2.2780963315814773e-06,0,0
20148,grisham,1,1.8364528545823171e-06,1,2.2780963315814773e-06,0,0
20147,communicat,1,1.8364528545823171e-06,1,2.2780963315814773e-06,0,0
20150,nailno,1,1.8364528545823171e-06,1,2.2780963315814773e-06,0,0
20152,mightiest,1,1.8364528545823171e-06,1,2.2780963315814773e-06,0,0
20154,fallujah,1,1.8364528545823171e-06,1,2.2780963315814773e-06,0,0
20153,#moh,1,1.8364528545823171e-06,1,2.2780963315814773e-06,0,0
20156,ieds,1,1.8364528545823171e-06,1,2.2780963315814773e-06,0,0
20155,efps,1,1.8364528545823171e-06,1,2.2780963315814773e-06,0,0
20157,#keepamericagreat,1,1.8364528545823171e-06,1,2.2780963315814773e-06,0,0
20161,ecb,1,1.8364528545823171e-06,1,2.2780963315814773e-06,0,0
20162,sponsoring,1,1.8364528545823171e-06,1,2.2780963315814773e-06,0,0
20163,deportations,1,1.8364528545823171e-06,1,2.2780963315814773e-06,0,0
20164,proportionate,1,1.8364528545823171e-06,1,2.2780963315814773e-06,0,0
20166,cocked,1,1.8364528545823171e-06,1,2.2780963315814773e-06,0,0
20167,retaliate,1,1.8364528545823171e-06,1,2.2780963315814773e-06,0,0
20168,ratified,1,1.8364528545823171e-06,1,2.2780963315814773e-06,0,0
20169,i8,1,1.8364528545823171e-06,1,2.2780963315814773e-06,0,0
20170,yelled,1,1.8364528545823171e-06,1,2.2780963315814773e-06,0,0
20171,compliant,1,1.8364528545823171e-06,1,2.2780963315814773e-06,0,0
20172,5000000,1,1.8364528545823171e-06,1,2.2780963315814773e-06,0,0
20173,ratify,1,1.8364528545823171e-06,1,2.2780963315814773e-06,0,0
20174,#rigged,1,1.8364528545823171e-06,1,2.2780963315814773e-06,0,0
20176,spine,1,1.8364528545823171e-06,1,2.2780963315814773e-06,0,0
20177,reprehensible,1,1.8364528545823171e-06,1,2.2780963315814773e-06,0,0
20178,guitar,1,1.8364528545823171e-06,1,2.2780963315814773e-06,0,0
20179,incidents,1,1.8364528545823171e-06,1,2.2780963315814773e-06,0,0
20180,escalating,1,1.8364528545823171e-06,1,2.2780963315814773e-06,0,0
20181,russias,1,1.8364528545823171e-06,1,2.2780963315814773e-06,0,0
20182,safe-third,1,1.8364528545823171e-06,1,2.2780963315814773e-06,0,0
20183,illicitly,1,1.8364528545823171e-06,1,2.2780963315814773e-06,0,0
20184,defy,1,1.8364528545823171e-06,1,2.2780963315814773e-06,0,0
20185,motley,1,1.8364528545823171e-06,1,2.2780963315814773e-06,0,0
20187,woodland,1,1.8364528545823171e-06,1,2.2780963315814773e-06,0,0
20186,garys,1,1.8364528545823171e-06,1,2.2780963315814773e-06,0,0
20189,honor🇺🇸🇮🇱,1,1.8364528545823171e-06,1,2.2780963315814773e-06,0,0
20190,deceitful,1,1.8364528545823171e-06,1,2.2780963315814773e-06,0,0
20191,@jedediahbila,1,1.8364528545823171e-06,1,2.2780963315814773e-06,0,0
20192,counter-protester,1,1.8364528545823171e-06,1,2.2780963315814773e-06,0,0
20193,lehighvalleylive,1,1.8364528545823171e-06,1,2.2780963315814773e-06,0,0
20195,jenny,1,1.8364528545823171e-06,1,2.2780963315814773e-06,0,0
20197,prohibits,1,1.8364528545823171e-06,1,2.2780963315814773e-06,0,0
20196,immigrants@foxnews,1,1.8364528545823171e-06,1,2.2780963315814773e-06,0,0
20198,slightest,1,1.8364528545823171e-06,1,2.2780963315814773e-06,0,0
20200,gohowever,1,1.8364528545823171e-06,1,2.2780963315814773e-06,0,0
20201,lockhead,1,1.8364528545823171e-06,1,2.2780963315814773e-06,0,0
20202,@lockheedmartin,1,1.8364528545823171e-06,1,2.2780963315814773e-06,0,0
20203,@sikorsky,1,1.8364528545823171e-06,1,2.2780963315814773e-06,0,0
20204,advisement,1,1.8364528545823171e-06,1,2.2780963315814773e-06,0,0
20206,ridiclious,1,1.8364528545823171e-06,1,2.2780963315814773e-06,0,0
20207,hrasbig,1,1.8364528545823171e-06,1,2.2780963315814773e-06,0,0
20208,#armybday,1,1.8364528545823171e-06,1,2.2780963315814773e-06,0,0
20209,#potusinjapan🇺🇸🇯🇵,1,1.8364528545823171e-06,1,2.2780963315814773e-06,0,0
20210,harp,1,1.8364528545823171e-06,1,2.2780963315814773e-06,0,0
20211,crime-free,1,1.8364528545823171e-06,1,2.2780963315814773e-06,0,0
20212,oman@statedept,1,1.8364528545823171e-06,1,2.2780963315814773e-06,0,0
20215,@repadamschiff,1,1.8364528545823171e-06,1,2.2780963315814773e-06,0,0
20216,@markwarnerva,1,1.8364528545823171e-06,1,2.2780963315814773e-06,0,0
20217,wales,1,1.8364528545823171e-06,1,2.2780963315814773e-06,0,0
20218,whales,1,1.8364528545823171e-06,1,2.2780963315814773e-06,0,0
20219,loco,1,1.8364528545823171e-06,1,2.2780963315814773e-06,0,0
20220,permissable,1,1.8364528545823171e-06,1,2.2780963315814773e-06,0,0
20221,argued,1,1.8364528545823171e-06,1,2.2780963315814773e-06,0,0
20222,thread,1,1.8364528545823171e-06,1,2.2780963315814773e-06,0,0
20223,issuance,1,1.8364528545823171e-06,1,2.2780963315814773e-06,0,0
20225,properity,1,1.8364528545823171e-06,1,2.2780963315814773e-06,0,0
20226,d&s,1,1.8364528545823171e-06,1,2.2780963315814773e-06,0,0
20228,whatley,1,1.8364528545823171e-06,1,2.2780963315814773e-06,0,0
20227,@ncgop,1,1.8364528545823171e-06,1,2.2780963315814773e-06,0,0
20229,agata,1,1.8364528545823171e-06,1,2.2780963315814773e-06,0,0
20231,kornhauser-duda,1,1.8364528545823171e-06,1,2.2780963315814773e-06,0,0
20232,us-poland,1,1.8364528545823171e-06,1,2.2780963315814773e-06,0,0
20230,exemplary,1,1.8364528545823171e-06,1,2.2780963315814773e-06,0,0
20234,e15,1,1.8364528545823171e-06,1,2.2780963315814773e-06,0,0
20235,dagan,1,1.8364528545823171e-06,1,2.2780963315814773e-06,0,0
20236,@bopinion,1,1.8364528545823171e-06,1,2.2780963315814773e-06,0,0
20237,landmarks,1,1.8364528545823171e-06,1,2.2780963315814773e-06,0,0
20238,harden,1,1.8364528545823171e-06,1,2.2780963315814773e-06,0,0
20239,assure,1,1.8364528545823171e-06,1,2.2780963315814773e-06,0,0
20240,bashing,1,1.8364528545823171e-06,1,2.2780963315814773e-06,0,0
20244,sorial,1,1.8364528545823171e-06,1,2.2780963315814773e-06,0,0
20243,damian,1,1.8364528545823171e-06,1,2.2780963315814773e-06,0,0
20242,bates,1,1.8364528545823171e-06,1,2.2780963315814773e-06,0,0
20245,@ims,1,1.8364528545823171e-06,1,2.2780963315814773e-06,0,0
20247,@simonpagenaud,1,1.8364528545823171e-06,1,2.2780963315814773e-06,0,0
20246,@indycar🏆🏁,1,1.8364528545823171e-06,1,2.2780963315814773e-06,0,0
20250,borderswhich,1,1.8364528545823171e-06,1,2.2780963315814773e-06,0,0
20251,illigal,1,1.8364528545823171e-06,1,2.2780963315814773e-06,0,0
20253,electiondemocrats,1,1.8364528545823171e-06,1,2.2780963315814773e-06,0,0
20254,ittrump,1,1.8364528545823171e-06,1,2.2780963315814773e-06,0,0
20255,recordsdemocrats,1,1.8364528545823171e-06,1,2.2780963315814773e-06,0,0
20252,di,1,1.8364528545823171e-06,1,2.2780963315814773e-06,0,0
20256,shockingly,1,1.8364528545823171e-06,1,2.2780963315814773e-06,0,0
20257,hailing,1,1.8364528545823171e-06,1,2.2780963315814773e-06,0,0
20258,@donnydeutsch,1,1.8364528545823171e-06,1,2.2780963315814773e-06,0,0
20260,shoebiz,1,1.8364528545823171e-06,1,2.2780963315814773e-06,0,0
20259,episodes,1,1.8364528545823171e-06,1,2.2780963315814773e-06,0,0
20261,@rick24barry,1,1.8364528545823171e-06,1,2.2780963315814773e-06,0,0
20263,@rickbarry44,1,1.8364528545823171e-06,1,2.2780963315814773e-06,0,0
20264,backetball,1,1.8364528545823171e-06,1,2.2780963315814773e-06,0,0
20265,ebrard,1,1.8364528545823171e-06,1,2.2780963315814773e-06,0,0
20269,omissions,1,1.8364528545823171e-06,1,2.2780963315814773e-06,0,0
20270,ne,1,1.8364528545823171e-06,1,2.2780963315814773e-06,0,0
20271,cadets,1,1.8364528545823171e-06,1,2.2780963315814773e-06,0,0
20272,promotes,1,1.8364528545823171e-06,1,2.2780963315814773e-06,0,0
20273,133000,1,1.8364528545823171e-06,1,2.2780963315814773e-06,0,0
20274,corrective,1,1.8364528545823171e-06,1,2.2780963315814773e-06,0,0
20276,reuven,1,1.8364528545823171e-06,1,2.2780963315814773e-06,0,0
20275,nechama,1,1.8364528545823171e-06,1,2.2780963315814773e-06,0,0
20278,stature,1,1.8364528545823171e-06,1,2.2780963315814773e-06,0,0
20279,corrup,1,1.8364528545823171e-06,1,2.2780963315814773e-06,0,0
20280,flops,1,1.8364528545823171e-06,1,2.2780963315814773e-06,0,0
20281,plagiarism,1,1.8364528545823171e-06,1,2.2780963315814773e-06,0,0
20283,@bettemidler,1,1.8364528545823171e-06,1,2.2780963315814773e-06,0,0
20284,scammer,1,1.8364528545823171e-06,1,2.2780963315814773e-06,0,0
20285,bluffing,1,1.8364528545823171e-06,1,2.2780963315814773e-06,0,0
20286,@theresamay🇺🇸🇬🇧,1,1.8364528545823171e-06,1,2.2780963315814773e-06,0,0
20287,shackles,1,1.8364528545823171e-06,1,2.2780963315814773e-06,0,0
20288,wishers,1,1.8364528545823171e-06,1,2.2780963315814773e-06,0,0
20289,subscribing,1,1.8364528545823171e-06,1,2.2780963315814773e-06,0,0
20290,@sadiqkhan,1,1.8364528545823171e-06,1,2.2780963315814773e-06,0,0
20291,shipment,1,1.8364528545823171e-06,1,2.2780963315814773e-06,0,0
20292,hassett,1,1.8364528545823171e-06,1,2.2780963315814773e-06,0,0
20293,butchery,1,1.8364528545823171e-06,1,2.2780963315814773e-06,0,0
20294,desired,1,1.8364528545823171e-06,1,2.2780963315814773e-06,0,0
20295,simplistic,1,1.8364528545823171e-06,1,2.2780963315814773e-06,0,0
20296,markle,1,1.8364528545823171e-06,1,2.2780963315814773e-06,0,0
20297,rivkin,1,1.8364528545823171e-06,1,2.2780963315814773e-06,0,0
20300,taxation,1,1.8364528545823171e-06,1,2.2780963315814773e-06,0,0
20301,abuser,1,1.8364528545823171e-06,1,2.2780963315814773e-06,0,0
20302,@senjoemanchin,1,1.8364528545823171e-06,1,2.2780963315814773e-06,0,0
20303,@frankl,1,1.8364528545823171e-06,1,2.2780963315814773e-06,0,0
20305,meander,1,1.8364528545823171e-06,1,2.2780963315814773e-06,0,0
20306,bd,1,1.8364528545823171e-06,1,2.2780963315814773e-06,0,0
20307,@nayibbukele,1,1.8364528545823171e-06,1,2.2780963315814773e-06,0,0
20309,@ralphnortham,1,1.8364528545823171e-06,1,2.2780963315814773e-06,0,0
20310,amway,1,1.8364528545823171e-06,1,2.2780963315814773e-06,0,0
20311,decriminalize,1,1.8364528545823171e-06,1,2.2780963315814773e-06,0,0
20312,homosexuality,1,1.8364528545823171e-06,1,2.2780963315814773e-06,0,0
20313,imprison,1,1.8364528545823171e-06,1,2.2780963315814773e-06,0,0
20314,pinto,1,1.8364528545823171e-06,1,2.2780963315814773e-06,0,0
20315,talker,1,1.8364528545823171e-06,1,2.2780963315814773e-06,0,0
20316,80000,1,1.8364528545823171e-06,1,2.2780963315814773e-06,0,0
20317,gradually,1,1.8364528545823171e-06,1,2.2780963315814773e-06,0,0
20318,disclaimer,1,1.8364528545823171e-06,1,2.2780963315814773e-06,0,0
20319,1036,1,1.8364528545823171e-06,1,2.2780963315814773e-06,0,0
20320,4am,1,1.8364528545823171e-06,1,2.2780963315814773e-06,0,0
20323,acquisition,1,1.8364528545823171e-06,1,2.2780963315814773e-06,0,0
20324,devastatingjudges,1,1.8364528545823171e-06,1,2.2780963315814773e-06,0,0
20325,softer,1,1.8364528545823171e-06,1,2.2780963315814773e-06,0,0
20326,@govmikedewine,1,1.8364528545823171e-06,1,2.2780963315814773e-06,0,0
20328,empress,1,1.8364528545823171e-06,1,2.2780963315814773e-06,0,0
20329,ble,1,1.8364528545823171e-06,1,2.2780963315814773e-06,0,0
20331,@ianbremmer,1,1.8364528545823171e-06,1,2.2780963315814773e-06,0,0
20333,ludicrous,1,1.8364528545823171e-06,1,2.2780963315814773e-06,0,0
20332,attributing,1,1.8364528545823171e-06,1,2.2780963315814773e-06,0,0
20334,penske,1,1.8364528545823171e-06,1,2.2780963315814773e-06,0,0
20335,simon,1,1.8364528545823171e-06,1,2.2780963315814773e-06,0,0
20339,ryōgoku,1,1.8364528545823171e-06,1,2.2780963315814773e-06,0,0
20338,kokugikan,1,1.8364528545823171e-06,1,2.2780963315814773e-06,0,0
20340,sumo,1,1.8364528545823171e-06,1,2.2780963315814773e-06,0,0
20337,asanoyama,1,1.8364528545823171e-06,1,2.2780963315814773e-06,0,0
20342,mobara,1,1.8364528545823171e-06,1,2.2780963315814773e-06,0,0
20341,chiba,1,1.8364528545823171e-06,1,2.2780963315814773e-06,0,0
20346,@philmickelson,1,1.8364528545823171e-06,1,2.2780963315814773e-06,0,0
20347,bidan,1,1.8364528545823171e-06,1,2.2780963315814773e-06,0,0
20349,soon🇺🇸🇯🇵,1,1.8364528545823171e-06,1,2.2780963315814773e-06,0,0
20350,jokester,1,1.8364528545823171e-06,1,2.2780963315814773e-06,0,0
20351,107,1,1.8364528545823171e-06,1,2.2780963315814773e-06,0,0
20353,cotton,1,1.8364528545823171e-06,1,2.2780963315814773e-06,0,0
20354,soliders,1,1.8364528545823171e-06,1,2.2780963315814773e-06,0,0
20355,toms,1,1.8364528545823171e-06,1,2.2780963315814773e-06,0,0
20356,stammers,1,1.8364528545823171e-06,1,2.2780963315814773e-06,0,0
20357,predicate,1,1.8364528545823171e-06,1,2.2780963315814773e-06,0,0
20358,delegated,1,1.8364528545823171e-06,1,2.2780963315814773e-06,0,0
20359,long-established,1,1.8364528545823171e-06,1,2.2780963315814773e-06,0,0
20360,#flagsin,1,1.8364528545823171e-06,1,2.2780963315814773e-06,0,0
20361,bjp,1,1.8364528545823171e-06,1,2.2780963315814773e-06,0,0
20362,us-india,1,1.8364528545823171e-06,1,2.2780963315814773e-06,0,0
20363,assess,1,1.8364528545823171e-06,1,2.2780963315814773e-06,0,0
20364,refinish,1,1.8364528545823171e-06,1,2.2780963315814773e-06,0,0
20365,out-prepared,1,1.8364528545823171e-06,1,2.2780963315814773e-06,0,0
20366,geared,1,1.8364528545823171e-06,1,2.2780963315814773e-06,0,0
20367,squander,1,1.8364528545823171e-06,1,2.2780963315814773e-06,0,0
20368,do-overs,1,1.8364528545823171e-06,1,2.2780963315814773e-06,0,0
20369,polite,1,1.8364528545823171e-06,1,2.2780963315814773e-06,0,0
20373,forgiven,1,1.8364528545823171e-06,1,2.2780963315814773e-06,0,0
20374,pseudo-impeachment,1,1.8364528545823171e-06,1,2.2780963315814773e-06,0,0
20372,boardtoday,1,1.8364528545823171e-06,1,2.2780963315814773e-06,0,0
20375,copious,1,1.8364528545823171e-06,1,2.2780963315814773e-06,0,0
20378,irrelevant,1,1.8364528545823171e-06,1,2.2780963315814773e-06,0,0
20377,chases,1,1.8364528545823171e-06,1,2.2780963315814773e-06,0,0
20376,@newyorkpost,1,1.8364528545823171e-06,1,2.2780963315814773e-06,0,0
20379,footings,1,1.8364528545823171e-06,1,2.2780963315814773e-06,0,0
20381,nothin,1,1.8364528545823171e-06,1,2.2780963315814773e-06,0,0
20383,way-so,1,1.8364528545823171e-06,1,2.2780963315814773e-06,0,0
20384,shahira,1,1.8364528545823171e-06,1,2.2780963315814773e-06,0,0
20385,levins,1,1.8364528545823171e-06,1,2.2780963315814773e-06,0,0
20386,johnny,1,1.8364528545823171e-06,1,2.2780963315814773e-06,0,0
20387,trump-hating,1,1.8364528545823171e-06,1,2.2780963315814773e-06,0,0
20388,#flyfightwin,1,1.8364528545823171e-06,1,2.2780963315814773e-06,0,0
20390,wthis,1,1.8364528545823171e-06,1,2.2780963315814773e-06,0,0
20392,venezuelans,1,1.8364528545823171e-06,1,2.2780963315814773e-06,0,0
20393,heap,1,1.8364528545823171e-06,1,2.2780963315814773e-06,0,0
20394,batch,1,1.8364528545823171e-06,1,2.2780963315814773e-06,0,0
20396,elsewherethere,1,1.8364528545823171e-06,1,2.2780963315814773e-06,0,0
20398,thereand,1,1.8364528545823171e-06,1,2.2780963315814773e-06,0,0
20397,deutschebank,1,1.8364528545823171e-06,1,2.2780963315814773e-06,0,0
20401,substancefascinating,1,1.8364528545823171e-06,1,2.2780963315814773e-06,0,0
20400,biography,1,1.8364528545823171e-06,1,2.2780963315814773e-06,0,0
20399,betterand,1,1.8364528545823171e-06,1,2.2780963315814773e-06,0,0
20402,coastal,1,1.8364528545823171e-06,1,2.2780963315814773e-06,0,0
20403,obstructionanyway,1,1.8364528545823171e-06,1,2.2780963315814773e-06,0,0
20404,@justinamash,1,1.8364528545823171e-06,1,2.2780963315814773e-06,0,0
20405,realtors,1,1.8364528545823171e-06,1,2.2780963315814773e-06,0,0
20406,scattershot,1,1.8364528545823171e-06,1,2.2780963315814773e-06,0,0
20407,sourced,1,1.8364528545823171e-06,1,2.2780963315814773e-06,0,0
20409,hombres,1,1.8364528545823171e-06,1,2.2780963315814773e-06,0,0
20410,telease,1,1.8364528545823171e-06,1,2.2780963315814773e-06,0,0
20412,unveil,1,1.8364528545823171e-06,1,2.2780963315814773e-06,0,0
20411,adopted,1,1.8364528545823171e-06,1,2.2780963315814773e-06,0,0
20413,brain,1,1.8364528545823171e-06,1,2.2780963315814773e-06,0,0
20414,sempra,1,1.8364528545823171e-06,1,2.2780963315814773e-06,0,0
20415,wealthier,1,1.8364528545823171e-06,1,2.2780963315814773e-06,0,0
20416,hackberry,1,1.8364528545823171e-06,1,2.2780963315814773e-06,0,0
20417,amputee,1,1.8364528545823171e-06,1,2.2780963315814773e-06,0,0
20419,transplant,1,1.8364528545823171e-06,1,2.2780963315814773e-06,0,0
20420,hip,1,1.8364528545823171e-06,1,2.2780963315814773e-06,0,0
20423,shin,1,1.8364528545823171e-06,1,2.2780963315814773e-06,0,0
20421,lotte,1,1.8364528545823171e-06,1,2.2780963315814773e-06,0,0
20422,louisiana-biggest,1,1.8364528545823171e-06,1,2.2780963315814773e-06,0,0
20424,intergovernmental,1,1.8364528545823171e-06,1,2.2780963315814773e-06,0,0
20425,watershed,1,1.8364528545823171e-06,1,2.2780963315814773e-06,0,0
20427,insensitive,1,1.8364528545823171e-06,1,2.2780963315814773e-06,0,0
20429,illustrated,1,1.8364528545823171e-06,1,2.2780963315814773e-06,0,0
20430,unexpectedly,1,1.8364528545823171e-06,1,2.2780963315814773e-06,0,0
20431,misuse,1,1.8364528545823171e-06,1,2.2780963315814773e-06,0,0
20433,committee-the,1,1.8364528545823171e-06,1,2.2780963315814773e-06,0,0
20432,apparatus-has,1,1.8364528545823171e-06,1,2.2780963315814773e-06,0,0
20434,gangthat,1,1.8364528545823171e-06,1,2.2780963315814773e-06,0,0
20435,baton,1,1.8364528545823171e-06,1,2.2780963315814773e-06,0,0
20436,testimonies,1,1.8364528545823171e-06,1,2.2780963315814773e-06,0,0
20437,@lisamei62,1,1.8364528545823171e-06,1,2.2780963315814773e-06,0,0
20438,yielded,1,1.8364528545823171e-06,1,2.2780963315814773e-06,0,0
20439,relitigate,1,1.8364528545823171e-06,1,2.2780963315814773e-06,0,0
20442,@johncatsjr,1,1.8364528545823171e-06,1,2.2780963315814773e-06,0,0
20445,economymanufacturing,1,1.8364528545823171e-06,1,2.2780963315814773e-06,0,0
20443,createdtrump,1,1.8364528545823171e-06,1,2.2780963315814773e-06,0,0
20441,470000obama,1,1.8364528545823171e-06,1,2.2780963315814773e-06,0,0
20440,-206000under,1,1.8364528545823171e-06,1,2.2780963315814773e-06,0,0
20444,decli,1,1.8364528545823171e-06,1,2.2780963315814773e-06,0,0
20446,@politichatter,1,1.8364528545823171e-06,1,2.2780963315814773e-06,0,0
20447,@wesupport45,1,1.8364528545823171e-06,1,2.2780963315814773e-06,0,0
20448,explanati,1,1.8364528545823171e-06,1,2.2780963315814773e-06,0,0
20449,admirable,1,1.8364528545823171e-06,1,2.2780963315814773e-06,0,0
20450,reneged,1,1.8364528545823171e-06,1,2.2780963315814773e-06,0,0
20451,sleepycreepy,1,1.8364528545823171e-06,1,2.2780963315814773e-06,0,0
20452,soared,1,1.8364528545823171e-06,1,2.2780963315814773e-06,0,0
20456,hannity,1,1.8364528545823171e-06,1,2.2780963315814773e-06,0,0
20455,disregard,1,1.8364528545823171e-06,1,2.2780963315814773e-06,0,0
20457,supplemental,1,1.8364528545823171e-06,1,2.2780963315814773e-06,0,0
20458,gilead,1,1.8364528545823171e-06,1,2.2780963315814773e-06,0,0
20459,priceslower,1,1.8364528545823171e-06,1,2.2780963315814773e-06,0,0
20460,usitc,1,1.8364528545823171e-06,1,2.2780963315814773e-06,0,0
20461,grieves,1,1.8364528545823171e-06,1,2.2780963315814773e-06,0,0
20464,workhorse,1,1.8364528545823171e-06,1,2.2780963315814773e-06,0,0
20463,700000000,1,1.8364528545823171e-06,1,2.2780963315814773e-06,0,0
20465,trace,1,1.8364528545823171e-06,1,2.2780963315814773e-06,0,0
20466,@steveforbesceo,1,1.8364528545823171e-06,1,2.2780963315814773e-06,0,0
20467,r-ohio,1,1.8364528545823171e-06,1,2.2780963315814773e-06,0,0
20469,vice-premier,1,1.8364528545823171e-06,1,2.2780963315814773e-06,0,0
20468,coffersgreat,1,1.8364528545823171e-06,1,2.2780963315814773e-06,0,0
20470,pullback,1,1.8364528545823171e-06,1,2.2780963315814773e-06,0,0
20472,purposesalmost,1,1.8364528545823171e-06,1,2.2780963315814773e-06,0,0
20473,offs,1,1.8364528545823171e-06,1,2.2780963315814773e-06,0,0
20474,trophyfor,1,1.8364528545823171e-06,1,2.2780963315814773e-06,0,0
20476,gazan,1,1.8364528545823171e-06,1,2.2780963315814773e-06,0,0
20477,hamas,1,1.8364528545823171e-06,1,2.2780963315814773e-06,0,0
20478,jihad,1,1.8364528545823171e-06,1,2.2780963315814773e-06,0,0
20479,albence,1,1.8364528545823171e-06,1,2.2780963315814773e-06,0,0
20480,stollen,1,1.8364528545823171e-06,1,2.2780963315814773e-06,0,0
20481,comeyesque,1,1.8364528545823171e-06,1,2.2780963315814773e-06,0,0
20483,untaxed,1,1.8364528545823171e-06,1,2.2780963315814773e-06,0,0
20482,borne,1,1.8364528545823171e-06,1,2.2780963315814773e-06,0,0
20486,kentuky,1,1.8364528545823171e-06,1,2.2780963315814773e-06,0,0
20487,#thankafirefighter,1,1.8364528545823171e-06,1,2.2780963315814773e-06,0,0
20488,@anshulblp1996,1,1.8364528545823171e-06,1,2.2780963315814773e-06,0,0
20489,goodgreat,1,1.8364528545823171e-06,1,2.2780963315814773e-06,0,0
20490,@laurensouthern,1,1.8364528545823171e-06,1,2.2780963315814773e-06,0,0
20491,lmao,1,1.8364528545823171e-06,1,2.2780963315814773e-06,0,0
20492,thos,1,1.8364528545823171e-06,1,2.2780963315814773e-06,0,0
20493,papadopoulos,1,1.8364528545823171e-06,1,2.2780963315814773e-06,0,0
20494,@govparsonmo,1,1.8364528545823171e-06,1,2.2780963315814773e-06,0,0
20495,@govpritzker,1,1.8364528545823171e-06,1,2.2780963315814773e-06,0,0
20497,watson,1,1.8364528545823171e-06,1,2.2780963315814773e-06,0,0
20498,rebelling,1,1.8364528545823171e-06,1,2.2780963315814773e-06,0,0
20499,263000,1,1.8364528545823171e-06,1,2.2780963315814773e-06,0,0
20500,jobsjobs,1,1.8364528545823171e-06,1,2.2780963315814773e-06,0,0
20501,prosperoussecure,1,1.8364528545823171e-06,1,2.2780963315814773e-06,0,0
20502,wondrous,1,1.8364528545823171e-06,1,2.2780963315814773e-06,0,0
20503,non-inflationary,1,1.8364528545823171e-06,1,2.2780963315814773e-06,0,0
20504,jt,1,1.8364528545823171e-06,1,2.2780963315814773e-06,0,0
20505,@michi83,1,1.8364528545823171e-06,1,2.2780963315814773e-06,0,0
20507,nobarr,1,1.8364528545823171e-06,1,2.2780963315814773e-06,0,0
20508,con-job,1,1.8364528545823171e-06,1,2.2780963315814773e-06,0,0
20511,overriding,1,1.8364528545823171e-06,1,2.2780963315814773e-06,0,0
20510,decommission,1,1.8364528545823171e-06,1,2.2780963315814773e-06,0,0
20512,grips,1,1.8364528545823171e-06,1,2.2780963315814773e-06,0,0
20513,@tomlewi86961554,1,1.8364528545823171e-06,1,2.2780963315814773e-06,0,0
20515,yuge,1,1.8364528545823171e-06,1,2.2780963315814773e-06,0,0
20514,iaff,1,1.8364528545823171e-06,1,2.2780963315814773e-06,0,0
20516,@proudtexanbrew,1,1.8364528545823171e-06,1,2.2780963315814773e-06,0,0
20519,@gr84u2c,1,1.8364528545823171e-06,1,2.2780963315814773e-06,0,0
20518,@debbieb1230,1,1.8364528545823171e-06,1,2.2780963315814773e-06,0,0
20520,@kshaferus,1,1.8364528545823171e-06,1,2.2780963315814773e-06,0,0
20522,othersliberal,1,1.8364528545823171e-06,1,2.2780963315814773e-06,0,0
20521,candidat,1,1.8364528545823171e-06,1,2.2780963315814773e-06,0,0
20523,@giamourizes,1,1.8364528545823171e-06,1,2.2780963315814773e-06,0,0
20524,@jcryptoseed,1,1.8364528545823171e-06,1,2.2780963315814773e-06,0,0
20526,@broncolee70,1,1.8364528545823171e-06,1,2.2780963315814773e-06,0,0
20527,@kurtschlichter,1,1.8364528545823171e-06,1,2.2780963315814773e-06,0,0
20528,iffa,1,1.8364528545823171e-06,1,2.2780963315814773e-06,0,0
20529,@kimberl40855897,1,1.8364528545823171e-06,1,2.2780963315814773e-06,0,0
20530,@hikeamerica440,1,1.8364528545823171e-06,1,2.2780963315814773e-06,0,0
20531,@wargs8,1,1.8364528545823171e-06,1,2.2780963315814773e-06,0,0
20532,@jeffreykstewart,1,1.8364528545823171e-06,1,2.2780963315814773e-06,0,0
20533,applies,1,1.8364528545823171e-06,1,2.2780963315814773e-06,0,0
20534,@daniel4scboone,1,1.8364528545823171e-06,1,2.2780963315814773e-06,0,0
20535,@joellepalombo,1,1.8364528545823171e-06,1,2.2780963315814773e-06,0,0
20536,@quaglianojohn,1,1.8364528545823171e-06,1,2.2780963315814773e-06,0,0
20537,thatfirefighters,1,1.8364528545823171e-06,1,2.2780963315814773e-06,0,0
20538,@jimmymac233,1,1.8364528545823171e-06,1,2.2780963315814773e-06,0,0
20539,fd,1,1.8364528545823171e-06,1,2.2780963315814773e-06,0,0
20540,inions,1,1.8364528545823171e-06,1,2.2780963315814773e-06,0,0
20541,peep,1,1.8364528545823171e-06,1,2.2780963315814773e-06,0,0
20542,@mitchraider60,1,1.8364528545823171e-06,1,2.2780963315814773e-06,0,0
20543,diblasio,1,1.8364528545823171e-06,1,2.2780963315814773e-06,0,0
20544,g2,1,1.8364528545823171e-06,1,2.2780963315814773e-06,0,0
20545,@thekevinnash61,1,1.8364528545823171e-06,1,2.2780963315814773e-06,0,0
20546,firepac,1,1.8364528545823171e-06,1,2.2780963315814773e-06,0,0
20547,@icemantom,1,1.8364528545823171e-06,1,2.2780963315814773e-06,0,0
20550,embargo,1,1.8364528545823171e-06,1,2.2780963315814773e-06,0,0
20551,highest-level,1,1.8364528545823171e-06,1,2.2780963315814773e-06,0,0
20552,militia,1,1.8364528545823171e-06,1,2.2780963315814773e-06,0,0
20553,wonderfully,1,1.8364528545823171e-06,1,2.2780963315814773e-06,0,0
20554,incessantly,1,1.8364528545823171e-06,1,2.2780963315814773e-06,0,0
20555,1970s,1,1.8364528545823171e-06,1,2.2780963315814773e-06,0,0
20557,cartoon,1,1.8364528545823171e-06,1,2.2780963315814773e-06,0,0
20561,rabbi,1,1.8364528545823171e-06,1,2.2780963315814773e-06,0,0
20562,yisroel,1,1.8364528545823171e-06,1,2.2780963315814773e-06,0,0
20559,goldstein,1,1.8364528545823171e-06,1,2.2780963315814773e-06,0,0
20558,chabad,1,1.8364528545823171e-06,1,2.2780963315814773e-06,0,0
20563,indignation,1,1.8364528545823171e-06,1,2.2780963315814773e-06,0,0
20564,pal,1,1.8364528545823171e-06,1,2.2780963315814773e-06,0,0
20565,sincerest,1,1.8364528545823171e-06,1,2.2780963315814773e-06,0,0
20566,potomac,1,1.8364528545823171e-06,1,2.2780963315814773e-06,0,0
20567,bosa,1,1.8364528545823171e-06,1,2.2780963315814773e-06,0,0
20568,#nraam,1,1.8364528545823171e-06,1,2.2780963315814773e-06,0,0
20569,q1,1,1.8364528545823171e-06,1,2.2780963315814773e-06,0,0
20571,cheif,1,1.8364528545823171e-06,1,2.2780963315814773e-06,0,0
20573,terroist,1,1.8364528545823171e-06,1,2.2780963315814773e-06,0,0
20574,adverse,1,1.8364528545823171e-06,1,2.2780963315814773e-06,0,0
20576,@senmikelee,1,1.8364528545823171e-06,1,2.2780963315814773e-06,0,0
20578,@rxsummit,1,1.8364528545823171e-06,1,2.2780963315814773e-06,0,0
20579,occasio-cortez,1,1.8364528545823171e-06,1,2.2780963315814773e-06,0,0
20580,costa,1,1.8364528545823171e-06,1,2.2780963315814773e-06,0,0
20581,418000,1,1.8364528545823171e-06,1,2.2780963315814773e-06,0,0
20583,glove,1,1.8364528545823171e-06,1,2.2780963315814773e-06,0,0
20585,@jack,1,1.8364528545823171e-06,1,2.2780963315814773e-06,0,0
20589,fdn,1,1.8364528545823171e-06,1,2.2780963315814773e-06,0,0
20588,#nationalautismawarenessmonth,1,1.8364528545823171e-06,1,2.2780963315814773e-06,0,0
20590,names-over,1,1.8364528545823171e-06,1,2.2780963315814773e-06,0,0
20591,offset,1,1.8364528545823171e-06,1,2.2780963315814773e-06,0,0
20592,reciprocate,1,1.8364528545823171e-06,1,2.2780963315814773e-06,0,0
20593,nosedived,1,1.8364528545823171e-06,1,2.2780963315814773e-06,0,0
20594,forgiveness-they,1,1.8364528545823171e-06,1,2.2780963315814773e-06,0,0
20596,closest,1,1.8364528545823171e-06,1,2.2780963315814773e-06,0,0
20597,exculpatory,1,1.8364528545823171e-06,1,2.2780963315814773e-06,0,0
20599,ranil,1,1.8364528545823171e-06,1,2.2780963315814773e-06,0,0
20601,wickremesinghe,1,1.8364528545823171e-06,1,2.2780963315814773e-06,0,0
20602,maithripala,1,1.8364528545823171e-06,1,2.2780963315814773e-06,0,0
20603,sirisena,1,1.8364528545823171e-06,1,2.2780963315814773e-06,0,0
20605,commentary,1,1.8364528545823171e-06,1,2.2780963315814773e-06,0,0
20606,nastily,1,1.8364528545823171e-06,1,2.2780963315814773e-06,0,0
20607,👇,1,1.8364528545823171e-06,1,2.2780963315814773e-06,0,0
20608,liedmany,1,1.8364528545823171e-06,1,2.2780963315814773e-06,0,0
20609,wil,1,1.8364528545823171e-06,1,2.2780963315814773e-06,0,0
20611,dncthe,1,1.8364528545823171e-06,1,2.2780963315814773e-06,0,0
20612,gaslight,1,1.8364528545823171e-06,1,2.2780963315814773e-06,0,0
20613,dossiers,1,1.8364528545823171e-06,1,2.2780963315814773e-06,0,0
20614,icc,1,1.8364528545823171e-06,1,2.2780963315814773e-06,0,0
20615,realclearpolitics,1,1.8364528545823171e-06,1,2.2780963315814773e-06,0,0
20616,finalists,1,1.8364528545823171e-06,1,2.2780963315814773e-06,0,0
20618,bethlehem,1,1.8364528545823171e-06,1,2.2780963315814773e-06,0,0
20619,in-stuffed,1,1.8364528545823171e-06,1,2.2780963315814773e-06,0,0
20621,formalize,1,1.8364528545823171e-06,1,2.2780963315814773e-06,0,0
20620,contingency,1,1.8364528545823171e-06,1,2.2780963315814773e-06,0,0
20622,smiley,1,1.8364528545823171e-06,1,2.2780963315814773e-06,0,0
20624,devils,1,1.8364528545823171e-06,1,2.2780963315814773e-06,0,0
20623,concocted,1,1.8364528545823171e-06,1,2.2780963315814773e-06,0,0
20626,@cher,1,1.8364528545823171e-06,1,2.2780963315814773e-06,0,0
20628,branding,1,1.8364528545823171e-06,1,2.2780963315814773e-06,0,0
20630,rebrand,1,1.8364528545823171e-06,1,2.2780963315814773e-06,0,0
20629,nameno,1,1.8364528545823171e-06,1,2.2780963315814773e-06,0,0
20631,telecom,1,1.8364528545823171e-06,1,2.2780963315814773e-06,0,0
20632,populist,1,1.8364528545823171e-06,1,2.2780963315814773e-06,0,0
20635,puff,1,1.8364528545823171e-06,1,2.2780963315814773e-06,0,0
20634,instigated,1,1.8364528545823171e-06,1,2.2780963315814773e-06,0,0
20633,discussed-and,1,1.8364528545823171e-06,1,2.2780963315814773e-06,0,0
20636,3with,1,1.8364528545823171e-06,1,2.2780963315814773e-06,0,0
20637,citiesimmigration,1,1.8364528545823171e-06,1,2.2780963315814773e-06,0,0
20638,countrty,1,1.8364528545823171e-06,1,2.2780963315814773e-06,0,0
20639,retry,1,1.8364528545823171e-06,1,2.2780963315814773e-06,0,0
20640,riches,1,1.8364528545823171e-06,1,2.2780963315814773e-06,0,0
20641,securiy,1,1.8364528545823171e-06,1,2.2780963315814773e-06,0,0
20642,wsjs,1,1.8364528545823171e-06,1,2.2780963315814773e-06,0,0
20643,legislating,1,1.8364528545823171e-06,1,2.2780963315814773e-06,0,0
20645,gregory,1,1.8364528545823171e-06,1,2.2780963315814773e-06,0,0
20644,craig,1,1.8364528545823171e-06,1,2.2780963315814773e-06,0,0
20646,reeling,1,1.8364528545823171e-06,1,2.2780963315814773e-06,0,0
20647,@tedlieu,1,1.8364528545823171e-06,1,2.2780963315814773e-06,0,0
20648,breathe,1,1.8364528545823171e-06,1,2.2780963315814773e-06,0,0
20649,crosby,1,1.8364528545823171e-06,1,2.2780963315814773e-06,0,0
20650,waived,1,1.8364528545823171e-06,1,2.2780963315814773e-06,0,0
20651,assaulting,1,1.8364528545823171e-06,1,2.2780963315814773e-06,0,0
20654,congesswoman,1,1.8364528545823171e-06,1,2.2780963315814773e-06,0,0
20656,airbus,1,1.8364528545823171e-06,1,2.2780963315814773e-06,0,0
20655,adversely,1,1.8364528545823171e-06,1,2.2780963315814773e-06,0,0
20657,baylor,1,1.8364528545823171e-06,1,2.2780963315814773e-06,0,0
20658,kidnappers,1,1.8364528545823171e-06,1,2.2780963315814773e-06,0,0
20661,apprehensions,1,1.8364528545823171e-06,1,2.2780963315814773e-06,0,0
20662,capturesat,1,1.8364528545823171e-06,1,2.2780963315814773e-06,0,0
20663,kirstjen,1,1.8364528545823171e-06,1,2.2780963315814773e-06,0,0
20664,abducted,1,1.8364528545823171e-06,1,2.2780963315814773e-06,0,0
20666,origin,1,1.8364528545823171e-06,1,2.2780963315814773e-06,0,0
20665,cleans,1,1.8364528545823171e-06,1,2.2780963315814773e-06,0,0
20667,redeployed,1,1.8364528545823171e-06,1,2.2780963315814773e-06,0,0
20668,trump-haters,1,1.8364528545823171e-06,1,2.2780963315814773e-06,0,0
20669,perpetrators,1,1.8364528545823171e-06,1,2.2780963315814773e-06,0,0
20670,#trumpatrjc,1,1.8364528545823171e-06,1,2.2780963315814773e-06,0,0
20672,@frankluntz,1,1.8364528545823171e-06,1,2.2780963315814773e-06,0,0
20674,1951,1,1.8364528545823171e-06,1,2.2780963315814773e-06,0,0
20677,magnificence,1,1.8364528545823171e-06,1,2.2780963315814773e-06,0,0
20676,2yrs,1,1.8364528545823171e-06,1,2.2780963315814773e-06,0,0
20678,196000,1,1.8364528545823171e-06,1,2.2780963315814773e-06,0,0
20680,supersede,1,1.8364528545823171e-06,1,2.2780963315814773e-06,0,0
20681,meaningfully,1,1.8364528545823171e-06,1,2.2780963315814773e-06,0,0
20683,trolling,1,1.8364528545823171e-06,1,2.2780963315814773e-06,0,0
20682,@wsjopinion,1,1.8364528545823171e-06,1,2.2780963315814773e-06,0,0
20684,carranza,1,1.8364528545823171e-06,1,2.2780963315814773e-06,0,0
20685,mcmahon,1,1.8364528545823171e-06,1,2.2780963315814773e-06,0,0
20686,breakthroughs,1,1.8364528545823171e-06,1,2.2780963315814773e-06,0,0
20687,@jensstoltenberg,1,1.8364528545823171e-06,1,2.2780963315814773e-06,0,0
20688,asd,1,1.8364528545823171e-06,1,2.2780963315814773e-06,0,0
20691,overcapacity,1,1.8364528545823171e-06,1,2.2780963315814773e-06,0,0
20690,del,1,1.8364528545823171e-06,1,2.2780963315814773e-06,0,0
20689,cueto,1,1.8364528545823171e-06,1,2.2780963315814773e-06,0,0
20692,god-like,1,1.8364528545823171e-06,1,2.2780963315814773e-06,0,0
20694,significance,1,1.8364528545823171e-06,1,2.2780963315814773e-06,0,0
20693,@httweets,1,1.8364528545823171e-06,1,2.2780963315814773e-06,0,0
20695,repjerry,1,1.8364528545823171e-06,1,2.2780963315814773e-06,0,0
20696,corruptly,1,1.8364528545823171e-06,1,2.2780963315814773e-06,0,0
20697,healtcare,1,1.8364528545823171e-06,1,2.2780963315814773e-06,0,0
20698,usable,1,1.8364528545823171e-06,1,2.2780963315814773e-06,0,0
20699,perdues,1,1.8364528545823171e-06,1,2.2780963315814773e-06,0,0
20701,othershave,1,1.8364528545823171e-06,1,2.2780963315814773e-06,0,0
20702,pre-witch,1,1.8364528545823171e-06,1,2.2780963315814773e-06,0,0
20703,mainstay,1,1.8364528545823171e-06,1,2.2780963315814773e-06,0,0
20704,foreign-policy,1,1.8364528545823171e-06,1,2.2780963315814773e-06,0,0
20705,#eddiegallagher,1,1.8364528545823171e-06,1,2.2780963315814773e-06,0,0
20706,@repralphnorman,1,1.8364528545823171e-06,1,2.2780963315814773e-06,0,0
20707,@heathernauert,1,1.8364528545823171e-06,1,2.2780963315814773e-06,0,0
20708,fulbright,1,1.8364528545823171e-06,1,2.2780963315814773e-06,0,0
20709,timed,1,1.8364528545823171e-06,1,2.2780963315814773e-06,0,0
20710,throug,1,1.8364528545823171e-06,1,2.2780963315814773e-06,0,0
20711,amend,1,1.8364528545823171e-06,1,2.2780963315814773e-06,0,0
20712,legislatively,1,1.8364528545823171e-06,1,2.2780963315814773e-06,0,0
20713,unlawfully,1,1.8364528545823171e-06,1,2.2780963315814773e-06,0,0
20714,jussie,1,1.8364528545823171e-06,1,2.2780963315814773e-06,0,0
20717,one-on-one,1,1.8364528545823171e-06,1,2.2780963315814773e-06,0,0
20716,coll,1,1.8364528545823171e-06,1,2.2780963315814773e-06,0,0
20719,travis,1,1.8364528545823171e-06,1,2.2780963315814773e-06,0,0
20718,atkins,1,1.8364528545823171e-06,1,2.2780963315814773e-06,0,0
20720,dirtiest,1,1.8364528545823171e-06,1,2.2780963315814773e-06,0,0
20722,screwup,1,1.8364528545823171e-06,1,2.2780963315814773e-06,0,0
20721,overstate,1,1.8364528545823171e-06,1,2.2780963315814773e-06,0,0
20724,russian-affiliated,1,1.8364528545823171e-06,1,2.2780963315814773e-06,0,0
20725,loyalties,1,1.8364528545823171e-06,1,2.2780963315814773e-06,0,0
20726,dominican,1,1.8364528545823171e-06,1,2.2780963315814773e-06,0,0
20727,lucia,1,1.8364528545823171e-06,1,2.2780963315814773e-06,0,0
20729,glimmer,1,1.8364528545823171e-06,1,2.2780963315814773e-06,0,0
20728,breathing,1,1.8364528545823171e-06,1,2.2780963315814773e-06,0,0
20730,susceptible,1,1.8364528545823171e-06,1,2.2780963315814773e-06,0,0
20731,caves,1,1.8364528545823171e-06,1,2.2780963315814773e-06,0,0
20732,testament,1,1.8364528545823171e-06,1,2.2780963315814773e-06,0,0
20733,#worlddownsyndromeday,1,1.8364528545823171e-06,1,2.2780963315814773e-06,0,0
20734,fades,1,1.8364528545823171e-06,1,2.2780963315814773e-06,0,0
20735,@kennedynation,1,1.8364528545823171e-06,1,2.2780963315814773e-06,0,0
20736,lima,1,1.8364528545823171e-06,1,2.2780963315814773e-06,0,0
20737,northwest,1,1.8364528545823171e-06,1,2.2780963315814773e-06,0,0
20738,dash,1,1.8364528545823171e-06,1,2.2780963315814773e-06,0,0
20739,amazingly,1,1.8364528545823171e-06,1,2.2780963315814773e-06,0,0
20740,dispel,1,1.8364528545823171e-06,1,2.2780963315814773e-06,0,0
20741,250m,1,1.8364528545823171e-06,1,2.2780963315814773e-06,0,0
20743,defamation,1,1.8364528545823171e-06,1,2.2780963315814773e-06,0,0
20742,@thedailybeast,1,1.8364528545823171e-06,1,2.2780963315814773e-06,0,0
20744,overthinking,1,1.8364528545823171e-06,1,2.2780963315814773e-06,0,0
20745,securityno,1,1.8364528545823171e-06,1,2.2780963315814773e-06,0,0
20747,suffolkusa,1,1.8364528545823171e-06,1,2.2780963315814773e-06,0,0
20749,tongue,1,1.8364528545823171e-06,1,2.2780963315814773e-06,0,0
20750,septemberoctober,1,1.8364528545823171e-06,1,2.2780963315814773e-06,0,0
20751,@lonewolfnduke,1,1.8364528545823171e-06,1,2.2780963315814773e-06,0,0
20752,@lrihendry,1,1.8364528545823171e-06,1,2.2780963315814773e-06,0,0
20753,uniformly,1,1.8364528545823171e-06,1,2.2780963315814773e-06,0,0
20754,@arthelneville,1,1.8364528545823171e-06,1,2.2780963315814773e-06,0,0
20755,1112,1,1.8364528545823171e-06,1,2.2780963315814773e-06,0,0
20756,platter,1,1.8364528545823171e-06,1,2.2780963315814773e-06,0,0
20757,vigor,1,1.8364528545823171e-06,1,2.2780963315814773e-06,0,0
20758,☘️,1,1.8364528545823171e-06,1,2.2780963315814773e-06,0,0
20760,funnyno,1,1.8364528545823171e-06,1,2.2780963315814773e-06,0,0
20759,advertisement,1,1.8364528545823171e-06,1,2.2780963315814773e-06,0,0
20762,vest,1,1.8364528545823171e-06,1,2.2780963315814773e-06,0,0
20761,lists,1,1.8364528545823171e-06,1,2.2780963315814773e-06,0,0
20763,trumpand,1,1.8364528545823171e-06,1,2.2780963315814773e-06,0,0
20764,stains,1,1.8364528545823171e-06,1,2.2780963315814773e-06,0,0
20765,thumbs,1,1.8364528545823171e-06,1,2.2780963315814773e-06,0,0
20766,res,1,1.8364528545823171e-06,1,2.2780963315814773e-06,0,0
20768,non-binding,1,1.8364528545823171e-06,1,2.2780963315814773e-06,0,0
20767,420-0,1,1.8364528545823171e-06,1,2.2780963315814773e-06,0,0
20769,@govricketts,1,1.8364528545823171e-06,1,2.2780963315814773e-06,0,0
20771,jacinda,1,1.8364528545823171e-06,1,2.2780963315814773e-06,0,0
20770,ardern,1,1.8364528545823171e-06,1,2.2780963315814773e-06,0,0
20772,strzoks,1,1.8364528545823171e-06,1,2.2780963315814773e-06,0,0
20774,mosques,1,1.8364528545823171e-06,1,2.2780963315814773e-06,0,0
20775,vetoing,1,1.8364528545823171e-06,1,2.2780963315814773e-06,0,0
20776,expressly,1,1.8364528545823171e-06,1,2.2780963315814773e-06,0,0
20778,scraps,1,1.8364528545823171e-06,1,2.2780963315814773e-06,0,0
20777,loftus,1,1.8364528545823171e-06,1,2.2780963315814773e-06,0,0
20779,frantic,1,1.8364528545823171e-06,1,2.2780963315814773e-06,0,0
20780,unproven,1,1.8364528545823171e-06,1,2.2780963315814773e-06,0,0
20781,propelled,1,1.8364528545823171e-06,1,2.2780963315814773e-06,0,0
20782,executions,1,1.8364528545823171e-06,1,2.2780963315814773e-06,0,0
20783,comedy,1,1.8364528545823171e-06,1,2.2780963315814773e-06,0,0
20784,coumo,1,1.8364528545823171e-06,1,2.2780963315814773e-06,0,0
20786,vendetta,1,1.8364528545823171e-06,1,2.2780963315814773e-06,0,0
20785,@realdonaldt,1,1.8364528545823171e-06,1,2.2780963315814773e-06,0,0
20787,harassers,1,1.8364528545823171e-06,1,2.2780963315814773e-06,0,0
20789,complexity,1,1.8364528545823171e-06,1,2.2780963315814773e-06,0,0
20788,albert,1,1.8364528545823171e-06,1,2.2780963315814773e-06,0,0
20790,einstein,1,1.8364528545823171e-06,1,2.2780963315814773e-06,0,0
20791,mit,1,1.8364528545823171e-06,1,2.2780963315814773e-06,0,0
20793,greenpeace,1,1.8364528545823171e-06,1,2.2780963315814773e-06,0,0
20792,dioxide,1,1.8364528545823171e-06,1,2.2780963315814773e-06,0,0
20794,anti,1,1.8364528545823171e-06,1,2.2780963315814773e-06,0,0
20796,worsts,1,1.8364528545823171e-06,1,2.2780963315814773e-06,0,0
20795,pipko,1,1.8364528545823171e-06,1,2.2780963315814773e-06,0,0
20799,timapple,1,1.8364528545823171e-06,1,2.2780963315814773e-06,0,0
20798,disparagingly,1,1.8364528545823171e-06,1,2.2780963315814773e-06,0,0
20800,158000000,1,1.8364528545823171e-06,1,2.2780963315814773e-06,0,0
20801,@anncoulter,1,1.8364528545823171e-06,1,2.2780963315814773e-06,0,0
20802,finalist,1,1.8364528545823171e-06,1,2.2780963315814773e-06,0,0
20804,substantiate,1,1.8364528545823171e-06,1,2.2780963315814773e-06,0,0
20805,punctuation,1,1.8364528545823171e-06,1,2.2780963315814773e-06,0,0
20807,hans,1,1.8364528545823171e-06,1,2.2780963315814773e-06,0,0
20809,von,1,1.8364528545823171e-06,1,2.2780963315814773e-06,0,0
20808,spakovsky,1,1.8364528545823171e-06,1,2.2780963315814773e-06,0,0
20806,copying,1,1.8364528545823171e-06,1,2.2780963315814773e-06,0,0
20810,aw-shucks,1,1.8364528545823171e-06,1,2.2780963315814773e-06,0,0
20811,sorely,1,1.8364528545823171e-06,1,2.2780963315814773e-06,0,0
20812,gottlieb,1,1.8364528545823171e-06,1,2.2780963315814773e-06,0,0
20813,veterani,1,1.8364528545823171e-06,1,2.2780963315814773e-06,0,0
20814,@ericbolling,1,1.8364528545823171e-06,1,2.2780963315814773e-06,0,0
20815,@westgatevegas,1,1.8364528545823171e-06,1,2.2780963315814773e-06,0,0
20816,overreach,1,1.8364528545823171e-06,1,2.2780963315814773e-06,0,0
20817,cured,1,1.8364528545823171e-06,1,2.2780963315814773e-06,0,0
20819,@starparker,1,1.8364528545823171e-06,1,2.2780963315814773e-06,0,0
20818,@lauraingram,1,1.8364528545823171e-06,1,2.2780963315814773e-06,0,0
20820,ilhan,1,1.8364528545823171e-06,1,2.2780963315814773e-06,0,0
20823,mccarthyismwhich,1,1.8364528545823171e-06,1,2.2780963315814773e-06,0,0
20826,mccathyismwhich,1,1.8364528545823171e-06,1,2.2780963315814773e-06,0,0
20828,extinct,1,1.8364528545823171e-06,1,2.2780963315814773e-06,0,0
20827,degraded,1,1.8364528545823171e-06,1,2.2780963315814773e-06,0,0
20829,unregistered,1,1.8364528545823171e-06,1,2.2780963315814773e-06,0,0
20831,nkfake,1,1.8364528545823171e-06,1,2.2780963315814773e-06,0,0
20832,@govivey,1,1.8364528545823171e-06,1,2.2780963315814773e-06,0,0
20833,#t,1,1.8364528545823171e-06,1,2.2780963315814773e-06,0,0
20834,usaand,1,1.8364528545823171e-06,1,2.2780963315814773e-06,0,0
20835,anythingthey,1,1.8364528545823171e-06,1,2.2780963315814773e-06,0,0
20836,r-tn,1,1.8364528545823171e-06,1,2.2780963315814773e-06,0,0
20838,diary,1,1.8364528545823171e-06,1,2.2780963315814773e-06,0,0
20839,furthers,1,1.8364528545823171e-06,1,2.2780963315814773e-06,0,0
20840,traunch,1,1.8364528545823171e-06,1,2.2780963315814773e-06,0,0
20842,ottos,1,1.8364528545823171e-06,1,2.2780963315814773e-06,0,0
20841,mistreatment,1,1.8364528545823171e-06,1,2.2780963315814773e-06,0,0
20843,misinterpreted,1,1.8364528545823171e-06,1,2.2780963315814773e-06,0,0
20846,publishers,1,1.8364528545823171e-06,1,2.2780963315814773e-06,0,0
20845,contradictions,1,1.8364528545823171e-06,1,2.2780963315814773e-06,0,0
20847,substantive,1,1.8364528545823171e-06,1,2.2780963315814773e-06,0,0
20848,elmendorf-richardson,1,1.8364528545823171e-06,1,2.2780963315814773e-06,0,0
20850,trong,1,1.8364528545823171e-06,1,2.2780963315814773e-06,0,0
20849,phuc,1,1.8364528545823171e-06,1,2.2780963315814773e-06,0,0
20851,#hanoisummit,1,1.8364528545823171e-06,1,2.2780963315814773e-06,0,0
20852,resuming,1,1.8364528545823171e-06,1,2.2780963315814773e-06,0,0
20853,guessing,1,1.8364528545823171e-06,1,2.2780963315814773e-06,0,0
20854,disbarred,1,1.8364528545823171e-06,1,2.2780963315814773e-06,0,0
20855,vietnamese,1,1.8364528545823171e-06,1,2.2780963315814773e-06,0,0
20857,newborn,1,1.8364528545823171e-06,1,2.2780963315814773e-06,0,0
20856,infant,1,1.8364528545823171e-06,1,2.2780963315814773e-06,0,0
20860,recovering,1,1.8364528545823171e-06,1,2.2780963315814773e-06,0,0
20858,captives,1,1.8364528545823171e-06,1,2.2780963315814773e-06,0,0
20861,accomplishwe,1,1.8364528545823171e-06,1,2.2780963315814773e-06,0,0
20862,burch,1,1.8364528545823171e-06,1,2.2780963315814773e-06,0,0
20863,pga,1,1.8364528545823171e-06,1,2.2780963315814773e-06,0,0
20864,relax,1,1.8364528545823171e-06,1,2.2780963315814773e-06,0,0
20865,cutsetc,1,1.8364528545823171e-06,1,2.2780963315814773e-06,0,0
20866,committeeand,1,1.8364528545823171e-06,1,2.2780963315814773e-06,0,0
20867,hallberg,1,1.8364528545823171e-06,1,2.2780963315814773e-06,0,0
20868,ledger,1,1.8364528545823171e-06,1,2.2780963315814773e-06,0,0
20869,visionaries,1,1.8364528545823171e-06,1,2.2780963315814773e-06,0,0
20870,cornyn,1,1.8364528545823171e-06,1,2.2780963315814773e-06,0,0
20871,@jussiesmollett,1,1.8364528545823171e-06,1,2.2780963315814773e-06,0,0
20872,6g,1,1.8364528545823171e-06,1,2.2780963315814773e-06,0,0
20873,lagging,1,1.8364528545823171e-06,1,2.2780963315814773e-06,0,0
20874,hoda,1,1.8364528545823171e-06,1,2.2780963315814773e-06,0,0
20875,muthana,1,1.8364528545823171e-06,1,2.2780963315814773e-06,0,0
20876,#finishthewall,1,1.8364528545823171e-06,1,2.2780963315814773e-06,0,0
20877,shortening,1,1.8364528545823171e-06,1,2.2780963315814773e-06,0,0
20878,tantamount,1,1.8364528545823171e-06,1,2.2780963315814773e-06,0,0
20880,well-known,1,1.8364528545823171e-06,1,2.2780963315814773e-06,0,0
20882,bathroom,1,1.8364528545823171e-06,1,2.2780963315814773e-06,0,0
20883,dictatorship,1,1.8364528545823171e-06,1,2.2780963315814773e-06,0,0
20885,hunger,1,1.8364528545823171e-06,1,2.2780963315814773e-06,0,0
20886,reborn,1,1.8364528545823171e-06,1,2.2780963315814773e-06,0,0
20887,dilanian,1,1.8364528545823171e-06,1,2.2780963315814773e-06,0,0
20888,infusion,1,1.8364528545823171e-06,1,2.2780963315814773e-06,0,0
20889,permeate,1,1.8364528545823171e-06,1,2.2780963315814773e-06,0,0
20890,circumvent,1,1.8364528545823171e-06,1,2.2780963315814773e-06,0,0
20891,grabbingwhich,1,1.8364528545823171e-06,1,2.2780963315814773e-06,0,0
20892,obey,1,1.8364528545823171e-06,1,2.2780963315814773e-06,0,0
20893,brass,1,1.8364528545823171e-06,1,2.2780963315814773e-06,0,0
20895,@mjrcitieschiefs,1,1.8364528545823171e-06,1,2.2780963315814773e-06,0,0
20894,@mcsheriffs,1,1.8364528545823171e-06,1,2.2780963315814773e-06,0,0
20896,69,1,1.8364528545823171e-06,1,2.2780963315814773e-06,0,0
20897,@planetepics,1,1.8364528545823171e-06,1,2.2780963315814773e-06,0,0
20898,❤️❤️❤️❤️,1,1.8364528545823171e-06,1,2.2780963315814773e-06,0,0
20900,parameters,1,1.8364528545823171e-06,1,2.2780963315814773e-06,0,0
20901,shelby,1,1.8364528545823171e-06,1,2.2780963315814773e-06,0,0
20899,hooked,1,1.8364528545823171e-06,1,2.2780963315814773e-06,0,0
20902,backgrounds,1,1.8364528545823171e-06,1,2.2780963315814773e-06,0,0
20903,birthplace,1,1.8364528545823171e-06,1,2.2780963315814773e-06,0,0
20905,@tvanews,1,1.8364528545823171e-06,1,2.2780963315814773e-06,0,0
20906,factors,1,1.8364528545823171e-06,1,2.2780963315814773e-06,0,0
20907,paradise,1,1.8364528545823171e-06,1,2.2780963315814773e-06,0,0
20904,#3,1,1.8364528545823171e-06,1,2.2780963315814773e-06,0,0
20918,فساد,1,1.8364528545823171e-06,1,2.2780963315814773e-06,0,0
20916,سرکوب,1,1.8364528545823171e-06,1,2.2780963315814773e-06,0,0
20910,ترور,1,1.8364528545823171e-06,1,2.2780963315814773e-06,0,0
20914,رژیم,1,1.8364528545823171e-06,1,2.2780963315814773e-06,0,0
20919,فقط,1,1.8364528545823171e-06,1,2.2780963315814773e-06,0,0
20921,موجب,1,1.8364528545823171e-06,1,2.2780963315814773e-06,0,0
20908,#چهلسالشکست,1,1.8364528545823171e-06,1,2.2780963315814773e-06,0,0
20920,مدتهاست,1,1.8364528545823171e-06,1,2.2780963315814773e-06,0,0
20912,رنجند,1,1.8364528545823171e-06,1,2.2780963315814773e-06,0,0
20917,شایسته,1,1.8364528545823171e-06,1,2.2780963315814773e-06,0,0
20909,آینده,1,1.8364528545823171e-06,1,2.2780963315814773e-06,0,0
20913,روشن,1,1.8364528545823171e-06,1,2.2780963315814773e-06,0,0
20911,تری,1,1.8364528545823171e-06,1,2.2780963315814773e-06,0,0
20923,#40yearsoffailure,1,1.8364528545823171e-06,1,2.2780963315814773e-06,0,0
20924,righteous,1,1.8364528545823171e-06,1,2.2780963315814773e-06,0,0
20927,klobuchar,1,1.8364528545823171e-06,1,2.2780963315814773e-06,0,0
20925,blizzard,1,1.8364528545823171e-06,1,2.2780963315814773e-06,0,0
20926,freezing,1,1.8364528545823171e-06,1,2.2780963315814773e-06,0,0
20928,snowmanwoman,1,1.8364528545823171e-06,1,2.2780963315814773e-06,0,0
20930,muderers,1,1.8364528545823171e-06,1,2.2780963315814773e-06,0,0
20932,emergencies,1,1.8364528545823171e-06,1,2.2780963315814773e-06,0,0
20931,1976,1,1.8364528545823171e-06,1,2.2780963315814773e-06,0,0
20933,roadblocks,1,1.8364528545823171e-06,1,2.2780963315814773e-06,0,0
20934,legitimately,1,1.8364528545823171e-06,1,2.2780963315814773e-06,0,0
20935,recoverer,1,1.8364528545823171e-06,1,2.2780963315814773e-06,0,0
20936,@thehill,1,1.8364528545823171e-06,1,2.2780963315814773e-06,0,0
20937,astronaut,1,1.8364528545823171e-06,1,2.2780963315814773e-06,0,0
20938,strived,1,1.8364528545823171e-06,1,2.2780963315814773e-06,0,0
20939,#wgdp,1,1.8364528545823171e-06,1,2.2780963315814773e-06,0,0
20940,displays,1,1.8364528545823171e-06,1,2.2780963315814773e-06,0,0
20941,festivals,1,1.8364528545823171e-06,1,2.2780963315814773e-06,0,0
20942,non-event,1,1.8364528545823171e-06,1,2.2780963315814773e-06,0,0
20943,bernhardt,1,1.8364528545823171e-06,1,2.2780963315814773e-06,0,0
20944,dimensions,1,1.8364528545823171e-06,1,2.2780963315814773e-06,0,0
20946,putted,1,1.8364528545823171e-06,1,2.2780963315814773e-06,0,0
20945,fantastically,1,1.8364528545823171e-06,1,2.2780963315814773e-06,0,0
20947,dereliction,1,1.8364528545823171e-06,1,2.2780963315814773e-06,0,0
20948,unforgivable,1,1.8364528545823171e-06,1,2.2780963315814773e-06,0,0
20951,rediscover,1,1.8364528545823171e-06,1,2.2780963315814773e-06,0,0
20950,gifts,1,1.8364528545823171e-06,1,2.2780963315814773e-06,0,0
20949,bestowed,1,1.8364528545823171e-06,1,2.2780963315814773e-06,0,0
20952,gou,1,1.8364528545823171e-06,1,2.2780963315814773e-06,0,0
20953,ousted,1,1.8364528545823171e-06,1,2.2780963315814773e-06,0,0
20954,mysterious,1,1.8364528545823171e-06,1,2.2780963315814773e-06,0,0
20955,mischaracterized,1,1.8364528545823171e-06,1,2.2780963315814773e-06,0,0
20956,inflicting,1,1.8364528545823171e-06,1,2.2780963315814773e-06,0,0
20958,unresolved,1,1.8364528545823171e-06,1,2.2780963315814773e-06,0,0
20959,assumption,1,1.8364528545823171e-06,1,2.2780963315814773e-06,0,0
20961,reinforced,1,1.8364528545823171e-06,1,2.2780963315814773e-06,0,0
20962,venezuelas,1,1.8364528545823171e-06,1,2.2780963315814773e-06,0,0
20963,contemplating,1,1.8364528545823171e-06,1,2.2780963315814773e-06,0,0
20964,made-big,1,1.8364528545823171e-06,1,2.2780963315814773e-06,0,0
20966,sims,1,1.8364528545823171e-06,1,2.2780963315814773e-06,0,0
20965,gofer,1,1.8364528545823171e-06,1,2.2780963315814773e-06,0,0
20969,windchill,1,1.8364528545823171e-06,1,2.2780963315814773e-06,0,0
20967,colder,1,1.8364528545823171e-06,1,2.2780963315814773e-06,0,0
20968,waming,1,1.8364528545823171e-06,1,2.2780963315814773e-06,0,0
20971,headwinds,1,1.8364528545823171e-06,1,2.2780963315814773e-06,0,0
20973,howard,1,1.8364528545823171e-06,1,2.2780963315814773e-06,0,0
20974,starbucks,1,1.8364528545823171e-06,1,2.2780963315814773e-06,0,0
20975,literacy,1,1.8364528545823171e-06,1,2.2780963315814773e-06,0,0
20976,@gillianhturner,1,1.8364528545823171e-06,1,2.2780963315814773e-06,0,0
20977,#holocaustmemorialday,1,1.8364528545823171e-06,1,2.2780963315814773e-06,0,0
20978,brit,1,1.8364528545823171e-06,1,2.2780963315814773e-06,0,0
20979,jens,1,1.8364528545823171e-06,1,2.2780963315814773e-06,0,0
20980,stoltenberg,1,1.8364528545823171e-06,1,2.2780963315814773e-06,0,0
20982,18959495168,1,1.8364528545823171e-06,1,2.2780963315814773e-06,0,0
20984,603331392,1,1.8364528545823171e-06,1,2.2780963315814773e-06,0,0
20983,25772342,1,1.8364528545823171e-06,1,2.2780963315814773e-06,0,0
20985,58000,1,1.8364528545823171e-06,1,2.2780963315814773e-06,0,0
20986,95000,1,1.8364528545823171e-06,1,2.2780963315814773e-06,0,0
20987,iceberg,1,1.8364528545823171e-06,1,2.2780963315814773e-06,0,0
20988,conjob,1,1.8364528545823171e-06,1,2.2780963315814773e-06,0,0
20989,ax,1,1.8364528545823171e-06,1,2.2780963315814773e-06,0,0
20991,huffpost,1,1.8364528545823171e-06,1,2.2780963315814773e-06,0,0
20990,downturn,1,1.8364528545823171e-06,1,2.2780963315814773e-06,0,0
20992,dug,1,1.8364528545823171e-06,1,2.2780963315814773e-06,0,0
20993,acu,1,1.8364528545823171e-06,1,2.2780963315814773e-06,0,0
20994,wieners,1,1.8364528545823171e-06,1,2.2780963315814773e-06,0,0
20995,concession,1,1.8364528545823171e-06,1,2.2780963315814773e-06,0,0
20996,dantonio,1,1.8364528545823171e-06,1,2.2780963315814773e-06,0,0
20998,lbj,1,1.8364528545823171e-06,1,2.2780963315814773e-06,0,0
20997,@dougwead,1,1.8364528545823171e-06,1,2.2780963315814773e-06,0,0
20999,thorns,1,1.8364528545823171e-06,1,2.2780963315814773e-06,0,0
21000,sotu,1,1.8364528545823171e-06,1,2.2780963315814773e-06,0,0
21001,prerogative,1,1.8364528545823171e-06,1,2.2780963315814773e-06,0,0
21002,stoppable,1,1.8364528545823171e-06,1,2.2780963315814773e-06,0,0
21003,exporting,1,1.8364528545823171e-06,1,2.2780963315814773e-06,0,0
21007,mariano,1,1.8364528545823171e-06,1,2.2780963315814773e-06,0,0
21009,rivera,1,1.8364528545823171e-06,1,2.2780963315814773e-06,0,0
21008,marianos,1,1.8364528545823171e-06,1,2.2780963315814773e-06,0,0
21006,@fitnessgov,1,1.8364528545823171e-06,1,2.2780963315814773e-06,0,0
21004,#entersandman,1,1.8364528545823171e-06,1,2.2780963315814773e-06,0,0
21005,#hof2019💯,1,1.8364528545823171e-06,1,2.2780963315814773e-06,0,0
21012,sussmann,1,1.8364528545823171e-06,1,2.2780963315814773e-06,0,0
21011,oppo,1,1.8364528545823171e-06,1,2.2780963315814773e-06,0,0
21010,inquiries,1,1.8364528545823171e-06,1,2.2780963315814773e-06,0,0
21013,rudely,1,1.8364528545823171e-06,1,2.2780963315814773e-06,0,0
21014,maristnprpbs,1,1.8364528545823171e-06,1,2.2780963315814773e-06,0,0
21016,sandmann,1,1.8364528545823171e-06,1,2.2780963315814773e-06,0,0
21015,captivated,1,1.8364528545823171e-06,1,2.2780963315814773e-06,0,0
21017,judgements,1,1.8364528545823171e-06,1,2.2780963315814773e-06,0,0
21018,smeared,1,1.8364528545823171e-06,1,2.2780963315814773e-06,0,0
21019,teens,1,1.8364528545823171e-06,1,2.2780963315814773e-06,0,0
21020,strangers,1,1.8364528545823171e-06,1,2.2780963315814773e-06,0,0
21021,1990,1,1.8364528545823171e-06,1,2.2780963315814773e-06,0,0
21022,#2020takebackthehouse,1,1.8364528545823171e-06,1,2.2780963315814773e-06,0,0
21023,self-evident,1,1.8364528545823171e-06,1,2.2780963315814773e-06,0,0
21024,skin,1,1.8364528545823171e-06,1,2.2780963315814773e-06,0,0
21025,controland,1,1.8364528545823171e-06,1,2.2780963315814773e-06,0,0
21026,illegally-but,1,1.8364528545823171e-06,1,2.2780963315814773e-06,0,0
21028,lead-up,1,1.8364528545823171e-06,1,2.2780963315814773e-06,0,0
21027,highlighted,1,1.8364528545823171e-06,1,2.2780963315814773e-06,0,0
21031,@lindasuhler,1,1.8364528545823171e-06,1,2.2780963315814773e-06,0,0
21032,godthank,1,1.8364528545823171e-06,1,2.2780963315814773e-06,0,0
21033,prayersa,1,1.8364528545823171e-06,1,2.2780963315814773e-06,0,0
21029,#godblessamerica🇺🇸,1,1.8364528545823171e-06,1,2.2780963315814773e-06,0,0
21030,#presidenttrump,1,1.8364528545823171e-06,1,2.2780963315814773e-06,0,0
21034,corke,1,1.8364528545823171e-06,1,2.2780963315814773e-06,0,0
21035,excursion,1,1.8364528545823171e-06,1,2.2780963315814773e-06,0,0
21036,grapes,1,1.8364528545823171e-06,1,2.2780963315814773e-06,0,0
21037,rugs,1,1.8364528545823171e-06,1,2.2780963315814773e-06,0,0
21038,maccallumand,1,1.8364528545823171e-06,1,2.2780963315814773e-06,0,0
21040,hamburgers,1,1.8364528545823171e-06,1,2.2780963315814773e-06,0,0
21041,hamberders,1,1.8364528545823171e-06,1,2.2780963315814773e-06,0,0
21042,volkswagen,1,1.8364528545823171e-06,1,2.2780963315814773e-06,0,0
21043,#afbf100,1,1.8364528545823171e-06,1,2.2780963315814773e-06,0,0
21044,qb,1,1.8364528545823171e-06,1,2.2780963315814773e-06,0,0
21045,disunity,1,1.8364528545823171e-06,1,2.2780963315814773e-06,0,0
21046,rested,1,1.8364528545823171e-06,1,2.2780963315814773e-06,0,0
21047,deregulated,1,1.8364528545823171e-06,1,2.2780963315814773e-06,0,0
21050,militarized,1,1.8364528545823171e-06,1,2.2780963315814773e-06,0,0
21049,existand,1,1.8364528545823171e-06,1,2.2780963315814773e-06,0,0
21048,buchanan,1,1.8364528545823171e-06,1,2.2780963315814773e-06,0,0
21052,unsustainable,1,1.8364528545823171e-06,1,2.2780963315814773e-06,0,0
21051,266000,1,1.8364528545823171e-06,1,2.2780963315814773e-06,0,0
21055,bozo,1,1.8364528545823171e-06,1,2.2780963315814773e-06,0,0
21057,territorial,1,1.8364528545823171e-06,1,2.2780963315814773e-06,0,0
21056,devastate,1,1.8364528545823171e-06,1,2.2780963315814773e-06,0,0
21058,lawns,1,1.8364528545823171e-06,1,2.2780963315814773e-06,0,0
21059,fakes,1,1.8364528545823171e-06,1,2.2780963315814773e-06,0,0
21060,congresswomanman,1,1.8364528545823171e-06,1,2.2780963315814773e-06,0,0
21061,292000,1,1.8364528545823171e-06,1,2.2780963315814773e-06,0,0
21064,539,1,1.8364528545823171e-06,1,2.2780963315814773e-06,0,0
21062,32000,1,1.8364528545823171e-06,1,2.2780963315814773e-06,0,0
21063,3426,1,1.8364528545823171e-06,1,2.2780963315814773e-06,0,0
21065,usurpation,1,1.8364528545823171e-06,1,2.2780963315814773e-06,0,0
21066,botched,1,1.8364528545823171e-06,1,2.2780963315814773e-06,0,0
21067,@kusinews,1,1.8364528545823171e-06,1,2.2780963315814773e-06,0,0
21068,anti-climbing,1,1.8364528545823171e-06,1,2.2780963315814773e-06,0,0
21069,feature,1,1.8364528545823171e-06,1,2.2780963315814773e-06,0,0
21070,h1-b,1,1.8364528545823171e-06,1,2.2780963315814773e-06,0,0
21071,holders,1,1.8364528545823171e-06,1,2.2780963315814773e-06,0,0
21072,simplicity,1,1.8364528545823171e-06,1,2.2780963315814773e-06,0,0
21073,skilled,1,1.8364528545823171e-06,1,2.2780963315814773e-06,0,0
21074,variation,1,1.8364528545823171e-06,1,2.2780963315814773e-06,0,0
21075,drastically,1,1.8364528545823171e-06,1,2.2780963315814773e-06,0,0
21076,intransigence,1,1.8364528545823171e-06,1,2.2780963315814773e-06,0,0
21077,overdrive,1,1.8364528545823171e-06,1,2.2780963315814773e-06,0,0
21079,slamming,1,1.8364528545823171e-06,1,2.2780963315814773e-06,0,0
21080,glyptis,1,1.8364528545823171e-06,1,2.2780963315814773e-06,0,0
21081,normalized,1,1.8364528545823171e-06,1,2.2780963315814773e-06,0,0
21082,prudent,1,1.8364528545823171e-06,1,2.2780963315814773e-06,0,0
21083,obtrusive,1,1.8364528545823171e-06,1,2.2780963315814773e-06,0,0
21085,jamal,1,1.8364528545823171e-06,1,2.2780963315814773e-06,0,0
21084,al-badawi,1,1.8364528545823171e-06,1,2.2780963315814773e-06,0,0
21086,el-sisi,1,1.8364528545823171e-06,1,2.2780963315814773e-06,0,0
21087,inclusive,1,1.8364528545823171e-06,1,2.2780963315814773e-06,0,0
21088,undetected,1,1.8364528545823171e-06,1,2.2780963315814773e-06,0,0
21089,ap-norc,1,1.8364528545823171e-06,1,2.2780963315814773e-06,0,0
21091,trump-era,1,1.8364528545823171e-06,1,2.2780963315814773e-06,0,0
21090,cns,1,1.8364528545823171e-06,1,2.2780963315814773e-06,0,0
21092,makers,1,1.8364528545823171e-06,1,2.2780963315814773e-06,0,0
21095,unmistakably,1,1.8364528545823171e-06,1,2.2780963315814773e-06,0,0
21094,biasms,1,1.8364528545823171e-06,1,2.2780963315814773e-06,0,0
21099,q,1,1.8364528545823171e-06,1,2.2780963315814773e-06,0,0
21098,houlton,1,1.8364528545823171e-06,1,2.2780963315814773e-06,0,0
21096,@spoxdhs,1,1.8364528545823171e-06,1,2.2780963315814773e-06,0,0
21097,@tsa,1,1.8364528545823171e-06,1,2.2780963315814773e-06,0,0
21100,narcotics,1,1.8364528545823171e-06,1,2.2780963315814773e-06,0,0
21101,webb,1,1.8364528545823171e-06,1,2.2780963315814773e-06,0,0
21103,pillsbury,1,1.8364528545823171e-06,1,2.2780963315814773e-06,0,0
21102,motive,1,1.8364528545823171e-06,1,2.2780963315814773e-06,0,0
21104,portrayed,1,1.8364528545823171e-06,1,2.2780963315814773e-06,0,0
21105,payback,1,1.8364528545823171e-06,1,2.2780963315814773e-06,0,0
21106,years-historic,1,1.8364528545823171e-06,1,2.2780963315814773e-06,0,0
21107,pbs,1,1.8364528545823171e-06,1,2.2780963315814773e-06,0,0
21108,possesses,1,1.8364528545823171e-06,1,2.2780963315814773e-06,0,0
21110,mcchrystal,1,1.8364528545823171e-06,1,2.2780963315814773e-06,0,0
21109,assignment,1,1.8364528545823171e-06,1,2.2780963315814773e-06,0,0
21111,imaginative,1,1.8364528545823171e-06,1,2.2780963315814773e-06,0,0
21112,wheels,1,1.8364528545823171e-06,1,2.2780963315814773e-06,0,0
21113,409ks,1,1.8364528545823171e-06,1,2.2780963315814773e-06,0,0
21114,nade,1,1.8364528545823171e-06,1,2.2780963315814773e-06,0,0
21115,ustaxpayer,1,1.8364528545823171e-06,1,2.2780963315814773e-06,0,0
21116,wasq,1,1.8364528545823171e-06,1,2.2780963315814773e-06,0,0
21117,lite,1,1.8364528545823171e-06,1,2.2780963315814773e-06,0,0
